《伤科补要》药酒方	《伤科补要》药酒方――（跌打损伤）<br>（《伤科补要》）<br>【配方】参三七、红花、生地黄、川芎、当归身、乌药、落得打、乳香、五加皮、防风、川牛膝、干姜、牡丹皮、肉桂、延胡索、姜黄、海桐皮各15克，好酒2.5公斤。<br>【制法】将上药适当粉碎，盛绢袋，浸于酒中，容器封固，隔水加热，煮1.5小时，取出放凉，再浸泡数日即可饮用。<br>【主治】跌打损伤，气滞血瘀，筋骨疼痛，活动受限等症。<br>【用法】适量饮用，每日2次。
《太平圣惠方》	（《太平圣惠方》）――（祛黧黑斑）<br>黧黑班又名“面　　”、“黧黑　　”。多由于肾亏火旺，血虚不荣，火燥结滞或肝郁气所致。好发于面部，女性多见。皮损呈黄褐或淡黑色斑块，形状大小不一，枯暗无光泽，境界清楚，不高出皮肤。与今之黄褐斑、黑肤黑变病相似。以下介绍治疗本病的两种药酒。<br>治面　　黑肤色粗陋皮厚状丑酒方<br>【配方】杏仁。<br>【制法】用杏仁酒浸，皮脱捣碎，绢袋盛。<br>【主治】治面　　黑，肤色粗陋，皮厚状丑。亦治面　。<br>【用法】夜取拭面。<br>说明：又方，用酒浸鸡子三枚，密封四七日成。敷面如白雪。
阿胶酒	阿胶酒<br>【来源】《圣济总录》<br>【原料】阿胶400克，黄酒1.5升。<br>【制作】把阿胶捣碎，置于黄酒中，上火慢熬，令其烊化后，装瓶备用。<br>【功效】阴虚咳嗽，眩晕心悸，虚劳咳血，吐血，崩漏下血。久患咳嗽，痰黄或挟血丝，肺结核等证。<br>【用法】每日3次，每次10-30毫升。<br>【宜忌】<br>【注释】阿胶又名傅致胶、盆复胶、驴皮胶，系用马科动物驴的皮支毛后熬至而成，因其原产于山东省东阿县而得名。《水经注》对此有记载："东阿县有大井，其巨若轮，深六七丈，岁常煮胶，《本草》所谓阿胶也"。东阿县现今之阳谷县，其井称"古阿井"，此井之水含有丰富的钙、钾、镁、钠等矿物质，色绿质量，每担古阿胶井水比普通井水约重1.5千克。阿胶之所以被誉为道地药材，与其利用阿井水熬制的阿胶品质优良，为在代帝王常用的滋补佳品，故又名"贡阿胶"。阿胶味甘性平，入肺、肝、肾诸经，《本草纲目》称其"和血滋阴，除风润燥，化痰清肺，利小便，调大肠"。目前临床上主要是作为滋阴、补血、润肺止血药使用。
阿胶酒方	阿胶酒方――（妊娠出血）<br><br>（《普济方》）<br>【配方】阿胶二两。<br>【制法】以酒一升半，煮胶消。<br>【主治】治妊娠无故卒下血不绝方。<br>【用法】分三服，连并服之。
艾蒿酒方	艾蒿酒方――（骨鲠）<br>骨鲠咽喉，以鱼刺为多。细柔的鱼鲠痛可用单方及以下药酒试治，硬骨及较粗鱼骨，梗塞咽喉，服药及药酒治疗无效时，则应施以手术取出。<br>（《圣济总录》）<br>【配方】艾蒿（切）一握。<br>【制法】上一味，以水酒各一盏，煎至八分，去滓。<br>【主治】治诸鱼骨鲠在喉中。<br>【用法】分温二服。<br>说明：民间用艾蒿一把，细切，用水、酒各一小杯，同药煎数沸，去渣，分两次温服，治诸鱼骨鲠在喉中。
艾叶酒（二）	艾叶酒（二）――（妊娠出血）<br><br>（《妇人大全良方》）<br>【配方】生艾叶（研，冬用茎，干者亦得）一斤。<br>【制法】上以酒五升，煮取二升。<br>【主治】疗妊娠卒下血及子淋。<br>【用法】分三服。
艾叶酒（一）	艾叶酒（一）――（妊娠出血）<br><br>（《普济方》）<br>【配方】艾叶如鸡子大。<br>【制法】上以酒三升，煮取二升，去滓分两服。<br>【主治】治妊娠卒下血不止及治子淋；亦治妊娠忽胎动不安，但腰痛，忽胎转抢心；或下血不止。<br>【用法】不拘时温服。
艾叶酒方	艾叶酒方――（癞病）<br>（《圣济总录》）<br>【配方】干艾叶（浓煮取汁），每一斗米曲用艾叶五两。<br>【制法】上一味，随曲米多少，用煎浓汁拌浸，酝如常法。<br>【主治】治白癞。<br>【用法】酒熟不拘时稍稍饮之，常令酒势相接醺醺然。<br>说明：《普济方》注出“肘后方”，同上。
CA子酒	CA子酒――（产后瘀血）<br><br>（《普济方》）<br>【配方】CA子一斤，桃仁（浸去皮尖双仁麸炒）二斤，大麻仁一斤。<br>【制法】上用好酒三斗同入黄瓷中密封已，以糠火养半日久。<br>【主治】治产后风冷，留血不去停结，月水闭塞。<br>【用法】每日空心温服一中盏，午时食前再服。<br>说明：《普济方》注出《太平圣惠方》。
CA子酒方	CA子酒方――（闭经）<br><br>（《普济方》）<br>【配方】CA子一升，桃花（汤浸去皮尖双仁）二升。<br>【制法】上药都捣令碎，于磁瓶内以酒二斗浸，密封头五日。<br>【主治】治妇人夙有风冷，留血结聚，月水不通。<br>【用法】每服暖饮三合，渐加至五合，日三服。<br>说明：《普济方》注出《太平圣惠方》）。
八珍酒	八珍酒<br>【来源】《万病回春》<br>【原料】全当归26g炒白芍18g生地黄15g云茯苓20g炙甘草20g五加皮25g肥红枣36g胡桃肉36g白术26g川芎10g人参15g白酒1500ml。<br>【制作】1将所有的药用水洗净后研成粗末；2装进用三层纱布缝制的袋中，将口系紧；3浸泡在白酒坛中，封口，在火上煮1小时；<br>4药冷却后，埋人净土中，五天后取出来；5再过三至七天，开启，去掉药渣包将酒装入瓶中备用。<br>【功效】滋补气血，调理脾胃，悦颜色。<br>【用法】每次10～30ml，每日服3次，饭前将酒温热服用。<br>【药材功效解析】方中人参、白术、茯苓、甘草：补脾益气。当归、白芍、地黄、川芎：滋养心肝，补血而理气。川芎：可使地黄、当归补而不腻。<br>五加皮：祛除风湿，强壮筋骨。胡桃肉：润肺补肾，乌须发，强记忆。大枣：健脾而调和诸药。此酒可以起到气血双补的功效，用以治疗因气血亏损而引起的面黄肌瘦，心悸怔忡，精神萎靡，脾虚食欲不振，气短懒言，劳累倦怠，头晕目眩等症。<br>【宜忌】
巴戟酒方（二）	巴戟酒方（二）――（痹证）<br>（《圣济总录》）<br>【配方】生巴戟天（去心）、生牛膝（去苗）、生石斛（去根）各二两，蜀椒（去目并闭口炒出汗）、生姜、羌活（去芦头）、当归各三两。<br>【制法】上七味，口父咀，如麻豆大，以生绢袋盛，用酒一斗五升浸。<br>【主治】风痹脚弱急痛，行履不能。<br>【用法】每日三度暖服，随性多少旋添酒，候药味薄即止。
巴戟酒方（一）	巴戟酒方（一）――（痹证）<br>（《圣济总录》）<br>【配方】巴戟天（去心）二两，羌活（去芦头）二两，当归（切焙）三两，牛膝二两，蜀椒（去目及闭口者炒出汗）半两，石斛（去根）二两，生姜（洗）三两。<br>【制法】上七味，各细v，用酒五升，瓷瓶内浸密封，以重汤煮一二时辰，取出候冷开封。<br>【主治】风冷或寒湿伤著腰脚冷痹，或疼痛。<br>【用法】每服一盏服，常令如醉。<br>说明：《普济方》、《太平圣惠方》均同上。
巴戟熟地酒	巴戟熟地酒――（阳萎）<br>（验方）<br>【配方】巴戟天（去心）60克，熟地黄45克，枸杞子30克，制附子20克，甘菊花60克，蜀椒（去目并闭口者，炒出汗）30克，醇酒1.5公斤。<br>【制法】将上药共捣碎，盛于净瓶中，注酒浸之，封口，5日后去渣备用。<br>【主治】肾阳久虚，阳萎早泄，腰膝酸软。<br>【用法】每次空心温饮1-2小杯，每日早、晚各1次。
巴戟天浸酒方	巴戟天浸酒方――（筋骨诸病）<br>（《太平圣惠方》）<br>【配方】巴戟、羌活、石斛（去根）各二两，当归三两，牛膝（去苗）一（三）两，川椒半两（去目及闭口者微炒去汗），生姜二（三）两。<br>【制法】上件药，细v，生绢袋盛，以酒一斗五升浸，密封七日开。<br>【主治】筋骨疼痛。<br>【用法】每于食前，缓一小盏服之。
巴戟天酒	巴戟天酒――（阳萎）<br>（《备急千金要方》）<br>【配方】巴戟天、牛膝各三斤，枸杞根皮、麦门冬、地黄、防风各二斤。<br>【制法】上六味并生用，无，可得用干者亦各，口父咀，以酒一石四斗浸七日。患冷者加干姜、桂心各一斤；好忘加远志一斤，虚劳加黄耆一斤；大虚劳加五味子，苁蓉各一斤；阴下湿加五加根皮一斤，有石斛加一斤佳；常加甘草十两佳。每加一斤药则加酒七升。此酒每年入九朋中旬即合，入十月上旬即服。滓暴干捣末。<br>【主治】虚赢阳道不举，五劳七伤等病，能食下气。<br>【用法】温服，常令酒气相及，勿至醉吐，慎生冷猪鱼油蒜。春六日，秋冬二七，夏勿服。<br>说明：《普济方》巴戟天、牛膝用量为各三两，余均同上。
菝葜酒	菝葜酒――（脚气）<br>（《普济方》）<br>【配方】菝葜（v碎以水一石五斗煮取七斗五升去滓澄清用）五斗，白糯米一石，曲（捣碎将药汁减去二五升浸曲二日沸起）十斤。。<br>【制法】上将糯米净淘，控干炊饭，候干倾出，如人体冷暖，人前药汁五斗并曲末拌匀，瓮中盛之，春夏五七日，秋冬十余日，候熟。<br>【主治】治脚气屈弱，积年腰脊挛，及腹内坚结者。<br>【用法】量人性饮之，日五六服，常令酒力相续，不过三五剂，皆平复。<br>说明：①《圣济总录》同上。②《本草纲目》同上。
白艾蒿酿酒方	白艾蒿酿酒方――（癞病）<br>（《太平圣惠方》）<br>【配方】用白艾蒿十束，每束如。<br>【制法】粗v，以水一硕，煮取汁五斜，以曲十五斤，糯米一硕，如常法酿酒，熟。<br>【主治】治大风癞，身体面目有疮。<br>【用法】即每服暖一中盏，服，日三服。<br>说明：原出《圣济总录》同上。
白花丹参酒	白花丹参酒――（血栓闭塞性脉管炎）<br>《山东中医学院学报》）<br>【配方】白花丹参，白酒（55度）。<br>【制法】将上药切碎或制成粗末，浸于酒中泡15天，制成5-10%的药酒。<br>【主治】血栓闭塞性脉管炎。适用于气血瘀滞型，症见患肢紫红或青紫，足背动脉搏动消失等。<br>【用法】每次饮用20-30毫升，日3。
白花蛇酒	白花蛇酒――（疥癣病）<br>（《本草纲目》）<br>【配方】白花蛇1条，曲、糯适量。<br>【制法】将白花蛇肉，袋盛，同曲置于缸底，糯饭盖之，3-7日酒成，滤过，瓶贮。可将白花蛇肉用好酒500克，浸泡数日亦可。<br>【主治】风湿疥癞，骨节疼痛，半身不遂，口眼歪斜，语言謇涩，肌肉麻痹，破伤风，小儿惊风。<br>【用法】每日早、晚各饮1-2杯。
白花蛇造酒方	白花蛇造酒方――（癞病）<br>（《普济方》）<br>【配方】白花蛇一条。<br>【制法】每白花蛇一条，蒸米一斗，缸底先用酒曲，次将蛇用绢袋盛之，顿于曲上，用纸封缸口，候三七日，开缸取酒，将蛇去皮骨为末。<br>【主治】大风。<br>【用法】每酒一盏温服，蛇末少许，仍将酒脚并糟作饼食之，尤佳。<br>说明：《普济方》注出“瑞竹堂”。
白菊花酒	白菊花酒――（眩晕）<br>（《本草纲目》）<br>【配方】白菊软苗。<br>【制法】春末夏初，收白菊软苗，阴干捣末，和无灰酒服之。<br>【主治】治丈夫妇人久患头风眩闷，头发干落，胸中痰壅，每发即头旋眼昏，不觉欲倒者，是其候也。<br>【用法】先炙两风池各二七壮，空腹取白菊末一方寸匕和无灰酒服之，日再服，渐加三方寸匕。若不饮酒者，但和羹粥汁服，亦得。<br>说明：注另用“秋八月合花收暴干，切取大斤，以生绢袋盛盛，贮三大斗酒中，经七日服之，日三次，常令酒气相续为佳。”上出《本草纲目》卷十五菊条引苏颂图经。
白蜜酒方	白蜜酒方――（风瘾疹）<br>（《圣济总录》）<br>【配方】白蜜一合，酒二合。<br>【制法】上二味，相和煎暖。<br>【主治】治风瘾疹瘙痒不止。<br>【用法】食前服。
白蛇浸酒	白蛇浸酒――（痹证）<br>（《永乐大典》）<br>【配方】白花蛇一条（半斤重者），虎胫骨一条，当归、川芎二味各一两半，附子、桂心、熟地黄、山茱萸、萆　、石斛、细辛、黄芪、天麻各二两，独活三两，枳壳一两，肉苁蓉二两半。<br>【制法】上细v，生绢袋盛，好酒三斗于瓷瓮子内密封，浸七日后开。<br>【主治】风痹，骨髓及腰脚疼痛，行步稍难，兼风毒走注，皮肤痒痛不知方。<br>【用法】随性暖饮，常令醺醺，勿令大醉，其酒旋添。酒味薄即换药。<br>说明：《永乐大典》注出“可用方”。
白石英浸酒方	白石英浸酒方――（痹证）<br>（《圣济总录》）<br>【配方】白石英（碎如大麻粒）、磁石（火煅令赤醋淬如此五遍捣）各五两。<br>【制法】上二味，粗捣筛，生绢囊贮，以酒一升浸，经五六日。<br>【主治】风湿周痹，肢节中痛，不可持物，行动无力，耳聋及肾脏虚损，益精髓，保神守中。<br>【用法】每服不计时，随性温服，服将尽，可更添酒浸之。<br>说明：《普济方》同上。
白石英酒（二）	白石英酒（二）――（痹证）<br>（《本草纲目》）<br>【配方】白石英（醋淬）、磁石（醋淬）各160克，白酒2000毫升。<br>【制法】将上药装绢袋内，扎紧口，入酒内浸泡7日，即可服用。<br>【主治】风湿周痹，肢节中痛，肾虚耳聋。<br>【用法】每服20-30毫升，日服2次。温饮，酒少更添之。
白石英酒（一）	白石英酒（一）――（痹证）<br>（《本草纲目》）<br>【配方】白石英、磁石各五两。<br>【制法】上二味煅，醋淬七次，绢袋盛，浸酒一升中，五六日。<br>【主治】风湿周痹，肢节中痛，及肾虚耳聋。<br>【用法】温饮，酒少更添之。<br>说明：本方见《本草纲目》卷二十五附诸药酒条引圣济总录。
白术酒（八）	白术酒（八）――（湿温）<br>（《奇效良方》）<br>【配方】白术一两，酒三盏。<br>【制法】上药　咀，作一服，用酒煎至一盏。<br>【主治】中湿，口噤不知人。<br>【用法】缓服，不饮酒者，水煎亦可。
白术酒（六）	白术酒（六）――（子痫）<br><br>（《妇人大全良方》）<br>【配方】白术一两半，独活一两，黑豆（炒）一合。<br>【制法】上细v，以酒三升，煎取一升半，去滓。<br>【主治】治妊娠中风，口噤，语言不得。<br>【用法】温分四服，口噤者，拗口灌之，得汗即愈。<br>说明：①《普济方》曰“一方无黑豆，一方有防风”，“亦治通身冷直”，余同上。②《医部全录》同上。
白术酒（七）	白术酒（七）――（关节疼痛）<br>（《医门法律》）<br>【配方】白术一两，酒三盏。<br>【制法】上件酒煎一盏。<br>【主治】中湿骨节疼痛。<br>【用法】不拘时频服。<br>说明：《三因方》同上。
白术酒（三）	白术酒（三）――（乌须黑发）<br>（《千金翼方》）<br>【配方】白术二十五斤。<br>【制法】上一味，口父咀，以东流水两石五斗不津器中渍之，二十日去滓，内汁大分中，夜候流星过时，抄已姓名置盆中，如是五夜，汁当变如血，取以渍曲，如家酝法。<br>【主治】除万病，令白发反黑，齿落更生，面有光泽，久服长年。<br>【用法】酒熟取清，任性服之。<br>说明：《饮馔服食谱》同上。
白术酒（四）	白术酒（四）――（产后风痉）<br><br>（《普济方》）<br>【配方】白术（为细散）。<br>【制法】用温酒调。一方用白术四两切细，酒三升，煮取一升顿服效。<br>【主治】治产后风痉，偏身冷直，口噤，不识人，兼治中风。<br>【用法】温酒调下二钱。
白术酒（五）	白术酒（五）――（中湿口噤）<br>中湿口噤为类中风中湿中的一种证候，多因嗜食肥甘，或醇酒乳酪，湿从内受；或山岚瘴气，久雨阴晦，坐卧湿地，湿从外受，以致生痰生热生风，而为中湿口噤。<br>本病较急，使用药酒治疗者较少。这里选录一方，以健脾祛湿为主，可供临床参考。<br>（《普济方》）<br>【配方】白术半两（去芦）。<br>【制法】以酒三盏，煎一盏。<br>【主治】中湿，口噤不知人。<br>【用法】顿服，不能饮酒以水代，日三服，夜一服。（《三因极一病证方论》同上）鲍氏方云，湿喜中脾则膨胀，四肢痛，久则肿喘，挟风则眩晕，挟寒则挛拳，不可大发汗，不可灼艾泄泻，当利小便，大汗大下皆死。
白术酒（一）	白术酒（一）――（胎动不安）<br><br>（《备急千金要方》）<br>【配方】白术60克。<br>【制法】将上药为细末，每用6克，黄酒50毫升，同煎数沸，候温顿服。<br>【主治】妊娠脾虚气弱，胎气不安。<br>【用法】每日早、午、晚各1次。
白术酒方（二）	白术酒方（二）――（子痫）<br><br>（《太平圣惠方》）<br>【配方】白术、独活各一两。<br>【制法】上诸药，捣粗罗为散，以酒二大盏，煎至一（大）盏，去滓。<br>【主治】治妊娠中风痉，通身强直，口噤不开。<br>【用法】分温二服，拗开口灌之。
白术酒方（一）	白术酒方（一）――（背强口噤）<br>背强指项背强直，甚时如角弓反张；口噤指牙关紧闭，口不能开。背强口噤常见于痉病、破伤风等诸般中于风邪之疾，药酒治疗常用白术、黑豆、附子、当归、麻黄、独活、细辛、防风、荆芥、茄子根、恶实根、枸杞子、桔梗、牛膝、石菖蒲等药，口噤者需拗开口灌之，现少用，下列药酒方仅供参考。<br>（《太平圣惠方》）<br>【配方】白术（捣碎）三两，黑豆（炒令熟）三两。<br>【制法】上诸药以酒四升，煎至二升，去滓。<br>【主治】妇人中风口噤，言语不得。<br>【用法】分温四服，拗开口灌之。<br>说明：《普济方》同上。
白术酝酒方	白术酝酒方――（手足不遂）<br>（《圣济总录》）<br>【配方】白术（生用切）、地骨皮、荆实（生用）各五升，菊花（末开者生用）三升。<br>【制法】上四味，粗捣筛，以水三石同煮取一石五斗，去滓澄清取汁酿黍米二石，用曲如常酝法。酒熟压去糟滓，取清酒于瓷器中收密封。<br>【主治】治中风手足不遂，神识冒昧，补心定气。<br>【用法】每服三至五合，继续饮之。有能饮者，常令半醉，但勿至吐。凡心风虚寒者，亦宜服此酒，后炙心俞两边各一寸五分，并五十壮。<br>说明：《普济方》菊花用五升，余同上。
白头翁酒方	白头翁酒方――（关节疼痛）<br>（《圣济总录》）<br>【配方】白头翁草一握。<br>【制法】上一味，烂研，以醇酒投之。<br>【主治】诸风痛攻四肢百节。<br>【用法】顿服。<br>［备注］又方：黑豆（炒去皮）半升，威灵仙二两，桑根白皮（v）一两。上三味，用醇酒一升半，煎取八合，去滓顿服。
白杨皮酒（二）	白杨皮酒（二）――（脚气）<br>（《本草纲目》）<br>【配方】白杨皮50克，白酒500毫升。<br>【制法】将白杨皮切片，浸泡干酒内，3日可服用。<br>【主治】风毒脚气，腹中痰癖如石者。<br>【用法】晨起服之，每服20-30毫升。
白杨皮酒（三）	白杨皮酒（三）――（瘿瘤）<br>（《医部全录》）<br>【配方】圆叶白杨皮十两，秫米三斗。<br>【制法】将白杨皮，勿令见风切，水五升，煮取二升，渍曲末五两，以米如常酿酒。<br>【主治】瘿瘤。<br>【用法】每旦一盏，日再服。
白杨皮酒（四）	白杨皮酒（四）――（脚气）<br>（《普济方》）<br>【配方】白杨皮（东南西向北去地三尺者，白杨皮白色者佳，不要近墓者）。<br>【制法】上取一斤半，勿令见风，去皮细v，熬令黄赤，以清酒一斗，内不津器中渍之，密封头，勿令泄气，冬月二七日，春夏七日开取。<br>【主治】治风毒脚气，手足拘挛。<br>【用法】饮量以人酒性量多少服之，日五六服，常令酒力相续取差为度。
白杨皮酒（一）	白杨皮酒（一）――（脚气）<br>（《本草纲目》）<br>【配方】白杨皮（切片）。<br>【制法】上浸酒起饮。<br>【主治】治风毒脚气，腹中痰癖如石。<br>【用法】饮之。<br>说明：本方见《本草纲目》卷二十五附诸药酒条下。
白药酒	白药酒<br>【来源】《良朋汇集》<br>【原料】白茯苓、白术、天花粉、山药、芡实、牛膝、薏苡仁各15克，白豆蔻9克，白酒5千克。<br>【制作】上药入酒中，浸泡7日后取用。<br>【功效】补脾益胃，化气生血。脾胃虚弱所致的食少纳差、食后腹满，或积谷不化、小便不利、大便溏薄、形体消瘦诸症。<br>【用法】每次20毫升，每日3次。<br>【宜忌】<br>【注释】脾胃为后天之本，气血生化之源，主水谷运化之职。如脾胃虚弱，水谷运化功能减弱，则气血生化乏源，形体五脏失养而变生诸症。本酒方以补益脾胃之药为主，脾胃强健，运化正常，则气血化生有源，故本方是一个间接补益气血的酒方。本酒所选药物皆质白而洁，故名白药酒。其酒醇清纯正，色泽美观，是把杯之佳酿。
百部根浸酒	百部根浸酒――（疥癣病）<br>（《普济方》）<br>【配方】百部根。<br>【制法】上味火炙浸酒。<br>【主治】治疥癣。<br>【用法】空腹饮之。<br>说明：《普济方》注出“本草方”。
百灵藤酒	百灵藤酒――（眩晕）<br>（《太平圣惠方》）<br>【配方】百灵藤十斤，水一石，糯米三斗。<br>【制法】将药和水煎汁取三斗，入糯米作饭候冷，拌神曲炒末九两，同入瓮中，如常酿酒，经三五日，更炊糯米冷投之，待熟澄清。<br>【主治】头风脑痛。<br>【用法】每温饮一小盏，服后浑身汗出为效。
百灵藤酿酒方	百灵藤酿酒方――（风疾诸病）<br>（《太平圣惠方》）<br>【配方】百灵藤十斤以水一石煎取三斗，神曲（微炒黄色捣末）九两，糯米三斗炊作饭。<br>【制法】上候饭冷，即熟揉曲末入饭中，并药汁，同入瓮中，即熟澄清，更三日后，每日不计早晚温饮。<br>【主治】治风疾。<br>【用法】每日不计早晚，温饮一小盏，服后，觉浑身汗出为效。
柏叶酒	柏叶酒――（关节疼痛）<br>（《本草纲目》）<br>【配方】东向侧柏叶。<br>【制法】上煮汁，同曲、米酿酒。<br>【主治】风痹历节作痛。<br>【用法】饮。
柏脂酝酒方	柏脂酝酒方――（癞病）<br>（《圣济总录》）<br>【配方】炼成柏脂（研为末炼如松脂法）十斤，糯米一石，细曲十五斤，石灰一石。<br>【制法】上四味，先炒石灰，以木札著灰中试之，火出为度。以地骨皮v五斗，以水一石五斗，煮取九斗半去滓。以淋石灰三遍澄，以灰汁和曲与柏脂粉拌米，用汁米曲柏脂粉多少，一如常酝法，次于净器，著曲米汁粉在内，密封四七日。<br>【主治】治大风癞，生发坚眉鬓。<br>【用法】开压去滓取清酒，每服五合至七合，常令酒气相接取效。忌触外风冷。其米泔及糟，不得令豕畜食之。
柏子仁酒方	柏子仁酒方――（失音）<br>失音是指声音不出的一种病症。中医将声音嘶哑而不能成音者，称为“暗”；完全不能出声者，称为“失音”；孕妇因胎气原因所致失音者，称为“子音”。本病主要与“肺气虚损”有关，此外肝脏虚寒，患中风、历风等病，也可造成失音不语。由喉部疾患所致之失音，称为喉喑。以下介绍5种药酒，可针对不同原因选用。<br>（《圣济总录》）<br>【配方】柏子仁（生研）二两，鸡粪白（炒）二两，生姜（不去皮切）一两。<br>【制法】上四味，粗捣筛，共炒令焦色，乘热投酒六升，候冷滤去渣。<br>【主治】治中风失音不语。<br>【用法】每服一七分盏，空心日午夜卧服。<br>说明：《普济方》鸡粪白用三两，另有桂心（去粗皮）二两，注“一方有黑豆无生姜”。
斑蝥酒	斑蝥酒――（疗斑秃）<br>斑秃中医又称“油风”。是头发在短期内成片状脱落而头皮平滑泽的一种病症。多因血虚生风，或风盛血燥，使发失濡养所致。症状严重者可见多处呈斑块状脱发，甚至使头发很快脱光。通常除脱发外，无自觉症状，有的患者脱发部位的皮肤发红而痒。恢复期头发细嫩柔软，色淡黄或淡白，以后逐渐转正常。以下介绍斑蝥酒治疗斑秃，为外搽剂。<br>（验方）<br>【配方】斑蝥（去头足翅）15只，酒200毫升。<br>【制法】将上药粗碎，置瓶中，用酒浸之，5日后即可取用。<br>【主治】斑秃。<br>【用法】用脂脱棉球，浸药酒适量，轻涂擦患处，每日2次。<br>说明：有毒，勿内服。
板粟酒	板粟酒<br>【来源】民间验方<br>【原料】板栗120克，白酒500克。<br>【制作】将板栗洗净，拍碎，装放净瓶中，倒入白酒，加盖密封，置阳凉处，经常摇动，10日后静置澄明即成。<br>【功效】补肾助阳。阳痿，滑精，精神不振，不思饮食，体倦等症。<br>【用法】每日早、晚各1次，每次空腹饮用10-25毫升。<br>【宜忌】<br>【注释】方中板栗补肾，助阳，益脾胃。制成酒剂，借酒力而行药势，效力益佳。板栗为寻常服食之品，制成酒剂，则是一个较好的食疗方，体弱之人可长期服用，有益寿延年的作用。
半夏酒方	半夏酒方――（舌肿）<br>舌肿又名“舌胀”、“舌胀大”。症见舌渐肿大满口，坚硬疼痛，影响呼吸、言语；暴肿者又名“舌”。本病主要因七情郁结，心经火盛血壅，以致与痰浊滞于舌间所致，故又称“紫胀舌”。以下半夏酒即可治本病。因本病能堵塞咽喉致死，必要时可同时配合其它方法使用。<br>（《圣济总录》）<br>【配方】半夏十枚。<br>【制法】上一味，以苦酒一升，煮取八合。<br>【主治】治舌肿满口，气息不通，经臾杀人，急以手指刺破，溃去恶血，亦可用微针决破，次用半夏酒方。<br>【用法】稍稍漱口，热含冷吐。半夏动人咽喉，以姜汁解之。<br>说明：《普济方》用半夏十二枚，余同上。
半夏人参酒	半夏人参酒――（痞证）<br>痞证多指心下痞塞，胸膈满闷，触之无形而不痛之证。常因痰气壅寒、脾胃失调、邪气内结、情志失和等原因造成。酒能厚肠胃，健脾气，宣痹，故用消痞散结之品制成药酒，可以治疗痞证。<br>（《伤寒论》）<br>【配方】半夏、黄芩各30克，干姜、人参、炙甘草各20克，黄连6克，大枣10克，酒750克。<br>【制法】将上药共捣碎，布包，用酒浸于净器中，5日后，再加冷白开水500克和匀，去渣备用。<br>【主治】胃气不和，寒热互结，心下痞硬，呕恶上逆，肠鸣下胜，不思饮食，体倦乏力。<br>【用法】每次饮20毫升，每早、晚各1次。
北地太守酒	北地太守酒――（蛊毒）<br>蛊毒名出《肘后方》，多因感染变惑于气，或中蛊毒所致，症情复杂，变化不一，病情较重，可见于一些危重病证、恙虫病、急慢性血吸虫病、重症肝炎、肝硬化、重症菌痢及阿米巴痢等病，《诸病源候论》根据临床表现将其分成九候，现多不沿用，有待研究。以下药酒方列以供参。<br>（《普济方》）<br>【配方】乌头、甘草、芎、黄芩、桂心、藜芦、附子各四两，白敛、桔梗、半夏、柏子仁、前胡、麦门冬各六两。<br>【制法】上七月曲十b，秫米一斛，如酿酒法，药以绢袋盛之，沉以瓮底，酒热去糟，还取药滓，以青布袋盛，沉著酒底泥头，秋七日、夏五日、冬十日。<br>【主治】万病蛊毒，风热寒热方。<br>【用法】空腹一合，日三服，以之为度，药有小毒，故以毒布盛之，断勿中止。二十日，大有病出，其状如漆，五十日病悉愈。<br>说明：《普济方》注一名乌头酒。
必效酒	必效酒――（破伤风）<br>（《普济方》）<br>【配方】蒜瓣（破去心顶）一升。<br>【制法】以无灰酒四升，煮烂。<br>【主治】治金疮中风，角弓反张者。<br>【用法】并渣每五合顿服之。须臾得汗即瘥。
必效酒方	必效酒方――（破伤风）<br>（《圣济总录》）<br>【配方】蒜瓣（四破去心顶）一升。<br>【制法】上一味，以无灰酒四升，煮蒜令极烂。<br>【主治】治金疮中风。<br>【用法】每服取五合，并滓顿服之。
萆杜仲酒	萆　杜仲酒――（痹证）<br>（《圣济总录》）<br>【配方】杜仲、炮姜、萆、羌活、制附子、蜀椒（去目闭口者炒出汗）、肉桂、川芎、防风、秦艽、炙甘草各30克，细辛、五加皮、石斛续断、地骨皮各15克，桔梗35克，酒1.5公斤。<br>【制法】将上药共捣碎细，用酒浸于瓷瓶内，密封口，煮2时辰，取下候冷开封待用。<br>【主治】肾脏虚冷，或感受寒湿，腰脚冷痹，足胫疼痛。<br>【用法】每次温饮1杯，不拘时候，随量，常令有酒气。
蓖麻酒方	蓖麻酒方――（风疾诸病）<br>（《圣济总录》）<br>【配方】蓖麻子油一升，酒一斗。<br>【制法】上二味，同于银石器中盛，搅令匀，重汤煮一日，不住搅，候熟。<br>【主治】治风^腿，肢体不收，失音不语。<br>【用法】每服三合，空心、日午、夜卧各一服，初服吐风涎，勿怪。不吐即涎不出。<br>说明：《普济方》同上。
鳖甲常山酒方	鳖甲常山酒方――（疟疾）<br>（《圣济总录》）<br>【配方】鳖甲（去裙醋炙）一分，淡竹叶一两，常山、甘草（炙　）各三分。<br>【制法】上四味，粗捣筛，每服五钱匕，酒半盏浸药，盖于地上一宿，次日添水一盏，煎至七分去滓。<br>【主治】治疟先寒战，寒解即壮热。<br>【用法】未发前温服，得吐为验。
鳖甲浸酒方	鳖甲浸酒方――（瘰疠）<br>（《普济方》）<br>【配方】鳖甲（炙）。<br>【制法】上以烧酒浸。<br>【主治】治瘰疬瘘疮及风顽疥癣。<br>【用法】服之。<br>说明：原书无方名，据所用药物命名。《普济方》注出“本草单方”。
鳖甲酒	鳖甲酒――（疟疾）<br>（《普济方》）<br>【配方】鳖甲二两（炙令黄），常山三两，蜀漆二两，附子一两，乌贼鱼骨一两（炙），知母二两，椒一两（微炒去汁）。<br>【制法】上切以酒三升渍一宿。<br>【主治】劳疟。<br>【用法】平旦服一合，稍稍加至二合，日三四服。忌苋菜、生葱、生菜、猪肉。
鳖甲酒方（二）	鳖甲酒方（二）――（疟疾）<br>（《圣济总录》）<br>【配方】鳖甲（去裙醋炙）半两，乌贼、鱼骨（去甲）、附子（炮裂去皮脐切）、甘草（炙）、常山各一两。<br>【制法】上五味，捣罗为末，每服五钱匕，酒一盏半，煎十数沸留一宿。<br>【主治】治寒疟。<br>【用法】次日以酒先涂手足并背上，如不发即止，如发即饮此酒一盏。
鳖甲酒方（三）	鳖甲酒方（三）――（疟疾）<br>（《圣济总录》）<br>【配方】鳖甲（去裙醋浸炙令黄色）一分，升麻一分，附子（炮裂去皮脐）一分，常山三分，乌贼鱼骨（去甲）一分。<br>【制法】上五味，如麻豆大，用生绢袋盛，以酒三升渍之，渐令近火，一宿药成。<br>【主治】治疟久不差。<br>【用法】初服半盏，比至发时，可数服，快吐即瘥。
鳖甲酒方（一）	鳖甲酒方（一）――（疟疾）<br>（《太平圣惠方》）<br>【配方】鳖甲（涂醋炙令黄去裙）一两，恒山（）三分（两），川升麻一两，附子（炮裂去皮脐）一两，乌贼鱼骨一两。<br>【制法】上诸药细，以绢袋盛，用酒六升，浸三五日。<br>【主治】治劳疟痰滞，发歇不定。<br>【用法】每服一中盏，令温，空心服之，或吐即差，未吐再服。
鳖甲渍酒方	鳖甲渍酒方――（疟疾）<br>（《圣济总录》）<br>【配方】鳖甲（醋炙）半两，乌贼鱼骨（去甲）、常山各二两，附子（炮裂去皮脐）、甘草（炙）各一两。<br>【制法】上五味，如麻豆，每服五钱匕，以酒一盏半，渍药一宿。<br>【主治】治阂疟以时发。<br>【用法】以酒先涂五心，过发时疟断，若不断，可饮药酒一二盏，即瘥。<br>说明：①《普济方》注出《备急千金要方》，同上。②《奇效良方》同上。
薄黄酒	薄黄酒――（水肿臌胀）<br>（《普济方》）<br>【配方】薄黄一升，大豆一升，小豆一升。<br>【制法】上以清酒一斗，煮取三升，去滓豆。<br>【主治】专治通身肿，是风虚水气病者，亦疗暴肿。<br>【用法】分三服。
补肝酒	补肝酒――（肝虚流泪）<br>（《备急千金要方》）<br>【配方】松脂（细v）十斤。<br>【制法】以水淹浸一周日煮之，细细接取上膏，水竭更添之，脂尽更水煮如前，烟尽去，火停，冷脂当沉下，取一斤酿米一石，水七斗，好曲末二斗，如家常酿酒法，仍冷下饭封一百日，脂米曲并消尽，酒香满一室。此酒须一倍加曲。<br>【主治】治肝虚寒，或高风眼泪等杂病。<br>【用法】细细饮之。
补肝酒又方	补肝酒又方――（肝虚流泪）<br>本病多因肝肾亏损，延及泪窍所致，以流泪为主要表现的外障类疾病。临床表现为患眼不红不肿，惟流泪无时，迎风更甚，平素泪液盈眶，或溢出脸缘，流至面颊。无时流泪，迎风时更甚，部分老年患者一般有重沙眼史。<br>（《备急千金要方》）<br>【配方】枸杞子。<br>【制法】取枸杞子捣碎，先内绢袋中，率一斗枸杞子二斗酒渍讫，密封泥瓮，勿泄暴干，天阴勿出，三七日满。<br>【主治】补肝，治肝虚寒，或高风眼泪等杂病。<br>【用法】温服，任意饮。忌酢。
补肾地黄酒（二）	补肾地黄酒（二）――（痹证）<br>（《永乐大典》）<br>【配方】生地黄（切）一升，大豆（熬之）二升，生牛蒡根（切）一升。<br>【制法】上以绢袋盛之，以酒二斗浸之五六日。<br>【主治】老人久风湿痹，筋挛骨痛，润皮毛，溢气力，补虚止毒，除面。<br>【用法】任性空心温服三二盏，恒作之尤佳。<br>说明：《永乐大典》谓本方出《山居备用》。
补肾地黄酒（一）	补肾地黄酒（一）――（关节疼痛）<br>（《寿亲养老新书》）<br>【配方】生地黄100克，大豆200克，生地蒡根100克，无灰酒2500克。<br>【制法】将上药用绢袋盛，浸入酒中密封，6日后即可饮用。<br>【主治】老年人肾水不足，风热湿邪壅滞经络，关节、筋骨挛痛，日久不已等症。<br>【用法】每次饮2-3盅。
补益酒	补益酒――（腰脚疼痛诸病）<br>（验方）<br>【配方】肉苁蓉90克，肉豆蔻15克，山萸肉45克，丹砂（细研为末另包）10克，好酒1公斤。<br>【制法】上药除丹砂外，共捣碎，置于瓶中，注酒浸之，封口，7日后即可取用。<br>【主治】肝肾虚损，腰脚软弱，头昏目眩，神志恍惚。<br>【用法】早、晚空腹温饮1-2小盅。
补益杞圆酒	补益杞圆酒――（眩晕）<br>（《中国医学大辞典》）<br>【配方】枸杞子、龙眼肉各60克，好白酒500克。<br>【制法】将上药浸入酒中，封固，7天后即可饮用。<br>【主治】头晕目眩，目昏多泪，腰酸肢倦，健忘，失眠，神志不宁等症。无明显症状者亦可饮用，有滋补营养之功效。<br>【用法】每次饮1小杯，每日1-2次。
参杞酒	参杞酒――（阳萎）<br>（验方）<br>【配方】枸杞子（汁）100克，地黄（汁）100克，麦门冬（汁）60克，杏仁汤（去皮尖）30克，人参20克，白茯苓30克，酒1.5公斤。<br>【制法】将上药中后三味捣碎，同前三味贮于瓶中，酒浸之，封口，7日后去渣备用。<br>【主治】肾虚精亏，阳萎不起，耳聋目昏，面色无华。<br>【用法】每次饭前温饮10毫升，每早、晚各1次。
参茸补血露	参茸补血露――（闭经）<br><br>（《全中国药成处方集》）<br>【配方】当归15克，川芎12克，丹参30克，鹿茸6克，枸杞子、五味子、白豆蔻各9克，焦术、莲子肉各15克，茯神12克，远志、石菖蒲各15克，甘草、首乌各12克，生地15克，白酒2500克，白糖适量。<br>【制法】将上药盛入绢袋，用白酒、白糖同置罐中，密封，放锅中隔水煮3小时，取出晾冷，埋土中3日出火毒，5天后即可过滤取酒液服用。<br>【主治】肾阳虚，精血不足，瘀血停滞所致的经闭，月经过多，带下诸症；阳虚精血不足的不孕、不育症。<br>【用法】每次饮一盅，日三。
参蛇浸酒	参蛇浸酒――（关节疼痛）<br>（《新中医》）<br>【配方】丹参50克，白花蛇10-25克，白酒（62度）1.25公斤。<br>【制法】将蛇剪碎，与丹参浸于酒中，泡7天即可饮用。<br>【主治】关节筋骨疼痛，往往有游走性表现者。<br>【用法】每日睡前饮10-20毫升。
蚕沙酒（二）	蚕沙酒（二）――（痹证）<br>（《增补内经拾遗方论》）<br>【配方】蚕沙120克，白酒约500克。<br>【制法】将上药浸入酒中，隔水加热1.5小时，取出静置待凉，数日后即可饮用。<br>【主治】风湿痹痛，及月经久闭（适于血瘀经闭者）。<br>【用法】每次1小蛊。
蚕沙酒（三）	蚕沙酒（三）――（痹证）<br>（《本草纲目》）<br>【配方】原蚕沙（炒黄）。<br>【制法】袋盛浸酒。<br>【主治】风缓顽痹，诸节不遂，腹内宿痛。<br>【用法】饮。<br>说明：本方见《本草纲目》卷二十五附诸药酒条。
蚕沙酒（一）	蚕沙酒（一）――（痹证）<br>（验方）<br>【配方】晚蚕沙（炒黄）60克，醇酒200毫升。<br>【制法】将上药用酒浸于瓶中，封口，5日后开封去渣。<br>【主治】风湿痹痛，皮肤瘙痒，瘾疹头风头痛，腹痛转筋，吐泻。<br>【用法】每次空腹温饮1小杯，每日3次。
蚕沙酒方	蚕沙酒方――（口眼?斜）<br>（《圣济总录》）<br>【配方】蚕沙（微炒捣碎）五升。<br>【制法】上一味，用生绢囊贮，以酒一斗五升，浸经七日。<br>【主治】治中风口面?僻，口角涎流。<br>【用法】取饮之，三合至五合，令常有酒气，以瘥为度。
蚕子酒方	蚕子酒方――（跌打损伤）<br>（《圣济总录》）<br>【配方】蚕子（不拘多少）。<br>【制法】上一味，将刀子于纸上，刮取约一钱匕细研。<br>【主治】治被打伤损，因疮中风。<br>【用法】暖酒三合至五合调服之，如人行十里，更一服。<br>说明：《普济方》同上。
仓公当归酒	仓公当归酒――（背强口噤）<br>（《三因极一病证方论》）<br>【配方】当归、防风各三分，独活一两半，麻黄（去节）一两一分，细辛（去苗）半两，附子（六钱重炮去皮脐）一个。<br>【制法】上为v散。<br>【主治】贼风、口噤，角弓反张b者。<br>【用法】每服四钱，水酒各半盏，同煎七分，去滓。口不开者，抉开口，纳汤一服；苏，二服；少汗；三服，大汗，愈。<br>说明：《奇效良方》同上。
苍耳酒	苍耳酒――（癞病）<br>（《普济方》）<br>【配方】苍耳（和茎叶花实刈取v一石八月收），牛膝根（切）一升，商陆根切一斗（白木色者），鼠黏根（切）一斗，松叶（切）二（一）斗。<br>【制法】上以水二石五斗，煮取六斗汁，如釜小可分煮之，即分三斗汁，将浸曲一斗二升，高量其曲，加于常法五分，为药力费曲故也，余三斗汁，留将拌料，糯米一石二斗，分作五　，细切生地黄三斗，和米下之；第二　，三日炊二（三）斗米，取药汁七升，拌　熟，与杏仁一斗，去皮尖碎，和捣如泥下之；第三　，五日炊二斗日炊二斗米，取药汁三（四）升半，拌　下之，已上五　法，须候米消尽，即炊如米少酒味薄，更炊一二斗下之，使味足，然后去糟取清。<br>【主治】疗大风恶疾，及一切诸风，乃至骨髓中毒风，令人充悦方。<br>【用法】依常法饮半升，不能者，可量性多少，常使有酒气逼人，夜饮最宜，补养益精神，令人先天健，大去风疾。
苍耳酒方	苍耳酒方――（耳聋）<br>（《圣济总录》）<br>【配方】苍耳（净拣）、防风（去叉）、恶实（炒）各三两，独活（去芦头）、木通各二两，生地黄（洗）三两，人参一两，薏苡仁二两，黄芪三两，桂（去粗皮）一两半，白茯苓（去黑皮）二两半。<br>【制法】上十一味细v，以酒一斗，浸七日。<br>【主治】治肾间风热，骨疼耳聋及肾中实邪。<br>【用法】空心饮之，初一盏日再，量性加至二三盏。<br>说明：《普济方》同上。
苍公酒	苍公酒――（背强口噤）<br>（《普济方》）<br>【配方】当归、防风各三分，独活一两半，麻黄一两一钱，细辛半两，附子一个。<br>【制法】上为散，每服四钱，水酒各半盏，煎。<br>【主治】贼风口噤，角弓反张。<br>【用法】口不开者，抉开纳药，一服d，二服少汗，三服大汗愈。
苍术豉酒	苍术豉酒――（腰脚疼痛诸病）<br>（验方）<br>【配方】豉（三蒸三爆）0.5公斤，苍术50克，清酒1公斤。<br>【制法】将豉浸于酒中，3宿后，再将苍术捣碎加入，4日后开取饮用。<br>【主治】风毒脚弱，麻木无力，腿脚肿胀，呕吐不食，腹痛下痢，头痛，发热。<br>【用法】随意徐徐饮之，不拘时候。<br>说明：如急用可以酒煮豉饮之。
苍术酒	苍术酒――（痰证）<br>（《费氏食养三种》）<br>【配方】苍术三十斤。<br>【制法】上洗净打碎，以东流水三担，浸二十日，去汁，以汁浸面，如家酿酒法，酒熟待饮。<br>【主治】燥湿健胃祛痰。<br>【用法】随意徐徐饮之。
草苁蓉酒	草苁蓉酒――（阳萎）<br>（《良朋汇集》）<br>【配方】草苁蓉1公斤，好酒10升。<br>【制法】将上药浸入酒中，1日后即可饮用。<br>【主治】肾虚腰痛，阳萎，遗精等症。<br>【用法】每日早、晚各1次，适量饮用。<br>说明：草苁蓉是中药列当的别名。
草乌酒	草乌酒――（痹证）<br>（《永乐大典》）<br>【配方】制草乌20克，当归、白芍药、黑豆各70克，忍冬90克，酒1.5公斤。<br>【制法】先将黑豆炒半熟，入酒中，再将另4味药碎细入酒中，5日后开取。<br>【主治】手足风湿性疼痛；并治妇女鸡爪风。<br>【用法】随量温饮，不拘时候。渣爆干为末，酒调服。
侧金盏酒	侧金盏酒――（心悸）<br>心悸是指病人自觉心中跳动不安，不能自止的证候。主要是心阳不足、心阴亏损，心失所养，心神不安；或痰饮内停，瘀血阻滞等造成。常用补血益气、调理阴阳、化痰涤饮、活血化瘀、安神镇惊等法治疗。这里选录的两种药酒配方，亦是根据这种治疗法则组成的。<br>（《陕甘宁青中草药选》）<br>【配方】侧金盏花1钱，白酒1斤。<br>【制法】浸泡7日后服用。<br>【主治】心悸，充血性心力衰竭，心脏性水肿。<br>【用法】每服5-10毫升，日服2次。
侧子酒（八）	侧子酒（八）――（脚气）<br>（《圣济总录》）<br>【配方】侧子（炮裂去皮脐）二两，金牙三两，牛膝、丹毒、山茱萸、蒴　、杜仲（去粗皮）、石斛各三两，防风（去叉）、干姜（炮v）、椒（去目及闭口者炒出汗）、细辛（去苗）、独活（去芦头）、秦艽（去苗土）、桂（去粗皮）各一两，芎、当归、白术、茵芋、五加皮、薏苡仁各二两。<br>【制法】上二十一味，v如麻豆，绢袋盛，以酒三斗浸七宿。<br>【主治】治脚气风湿痹不仁，不能行。<br>【用法】初服一盏，渐加盏数，不拘时候。
侧子酒（二）	侧子酒（二）――（脚气）<br>（《外台秘要》）<br>【配方】侧子（生用）、干姜（生者良）各五两，丹参、牛膝各六两，金牙（碎，绵裹）、磁石（如上）、生石斛（干用八两）各一斤，石南（炙）、独活（炙）六两，萆　、生茱萸、生地黄（干者用八两）各十两，防风、茯苓各四两，五加皮、薏苡仁各一两，茵芋（炙）、椒（汗）各半两，桂心、天雄（生用）、人参、芎、当归、白术、细辛各二两。<br>【制法】上二十五味切，绢袋贮，清酒六七斗，渍之七日成。<br>【主治】主脚气，春夏发，入秋肿消气定，但苦脚弱，不能屈伸，足上不仁，手指胀闷，不得屈伸，四肢腰背，皆废。<br>【用法】一服一小盏，日二三服，量性多少稍加，以痹为度，若妇人服去石南，丈夫苦冷，著孔公孳钟乳等，多至一二斤，少至七八两，服此酒时，须随病内外炙三两处以泄气，忌猪肉、冷水、醋物、生葱、桃、李、雀肉、生菜、芜荑等。
侧子酒（九）	侧子酒（九）――（脚气）<br>（《太平圣惠方》）<br>【配方】侧子（半生半炮）、独活（去芦头）、丹参、五加皮（炙）、薏苡仁各三两，人参、蜀椒（去目并闭口炒出汗）、茵芋叶各一两，金牙（碎绵裹）各八两，牛膝（切焙）、石斛（去根节）各四两，芎、干姜（炮）、天雄（炮裂去皮脐）、石膏（碎）、桂（去粗皮）、当归（切焙）各一两半，白术、萆、防风（去叉）、熟干地黄、山茱萸（生用）、白茯苓（去黑皮）、细辛（去苗叶）各二两。<br>【制法】上二十五味，口父咀如麻豆大，用生绢袋盛，入净器中，清酒七斗渍之。秋冬七日，春夏五日。<br>【主治】治脚气春夏盛发，入秋肿消气定，但苦脚弱，不能屈伸，皮肤不仁。<br>【用法】量人性饮，日五六服，常令酒力相续，以唇痹为度。若丈夫素有冷者，加孔公孳钟乳等，多用一斤，少用三五两；其人有虚热，去熟干地黄，加生地黄五两。服此酒须更炙三里穴、风市穴、伏兔穴，以泄毒气。<br>说明：《普济方》同上，谓出《圣济总录》，实出《太平圣惠方》。
侧子酒（六）	侧子酒（六）――（脚气）<br>（《外台秘要》）<br>【配方】侧子（炮）二两，干姜二两，石斛八两，丹参三两，牛膝二两，甘草（炙）二两，防风三两，干地黄四两，芎二两，当归三两，桂心三两，五味子三两，白术二两，秦艽三两，防己二两，椒（汗）二两，独活三两，山茱萸四两，细辛二两，黄芩二两，茯苓四两，附子（炮）一两。<br>【制法】上二十二味切，绢袋贮，以酒三斗五升浸，秋冬七日，春夏五日。<br>【主治】治疗脚气瘥后，冬季用以巩固。<br>【用法】一服四合，日二，细细加之，以知为度，得食羊、鹿、麝肉，鸡亦得食，忌海藻、菘菜、猪肉、冷水、桃、李、雀肉、生葱、生菜、芜荑、酢物。<br>说明：《普济方》同上。
侧子酒（七）	侧子酒（七）――（脚气）<br>（《圣济总录》）<br>【配方】侧子（炮裂去皮脐）、独活各二两，石斛（去根）、秦艽（去苗）、紫苏茎叶、当归、白术、威灵仙各一两，仙灵脾、防风（去芦头）、赤茯苓、黄芩、汉防己、桂心、丹参、芎各三分，川椒（去目及闭口者微炒去汗）半两，细辛半两，薏苡仁五合，黑豆（炒熟）三合。<br>【制法】上药细v，以生绢袋盛，以清酒二斗，浸六七日。<br>【主治】治脚气，缓弱无力疼痛，不遂行李。<br>【用法】每于食前，随性暖服之。<br>说明：①《普济方》同上。②《太平圣惠方》同上。
侧子酒（三）	侧子酒（三）――（脚气）<br>（《普济方》）<br>【配方】侧子五两，生姜八两，桑根白皮八两，桂心四两，五加皮六两，牛膝五两，丹参六两，续断五两，细辛四两。<br>【制法】上药切，绢袋盛，用无灰酒五升，浸五六日。<br>【主治】脚气。<br>【用法】初服一鸡子黄许，日再服，稍稍加之，以知为度，必用前数法，不觉，可宜依旧脚气方用之。忌猪肉、冷水、桃李、雀肉、生葱、生菜。
侧子酒（十）	侧子酒（十）――（腰脚疼痛诸病）<br>（《太平圣惠方》）<br>【配方】制附子40克，石斛20克，独活40克，紫苏20克，仙灵脾、防风、赤茯苓、黄苓、防己、肉桂、丹参、川椒（去目及闭口者炒出汗）、川芎各10克，细辛15克，当归、白术、威灵仙各20克，薏苡仁10克，黑豆（炒熟）300克，秦艽20克，好酒1.5公斤。<br>【制法】将上药捣碎，以绢袋盛，用酒浸之，7日后开取饮用。<br>【主治】腿脚缓弱无力，疼痛难忍，四肢不遂，脐中冷痛。<br>【用法】每于饭前随量温饮。
侧子酒（四）	侧子酒（四）――（脚气）<br>（《普济方》）<br>【配方】侧子（炮）四两，生石斛（碎）三两，磁石八两，独活三两，秦艽三两，甘草（炙）三两，紫苏茎一握，前胡四两，防风三两，茯苓八两，黄苓三两，五味子四两，防己三两，桂心三两，丹参三两，蜀椒（炒出汗）三（二）两，山茱萸（碎）四两，芎<br>二两，细辛二两，当归二（三）两，白术四两，干姜三两，薏苡仁一升三合。<br>【制法】上薄切，以绢袋盛，清酒四升浸五日。<br>【主治】疗脚气不随。<br>【用法】一服四合，日再。细细加至八九合，温饮，忌生冷猪肉蒜面。其中间觉热渴，得饮豉酒，豉，仍须蒸暴之。忌海藻菘菜桃李雀肉生葱生菜及醋物等。
侧子酒（五）	侧子酒（五）――（脚气）<br>（《医部全录》）<br>【配方】侧子、牛膝、续断各五两，桑根白皮、白术、生姜各八两，五加白皮、丹参各六两，细辛、桂心各四两。<br>【制法】上药v碎，以绢袋盛，用无灰酒五升，浸五六日。<br>【主治】脚气。<br>【用法】初服一鸡子黄许，日再服，稍稍加之，以知为度。<br>说明：①忌猪肉冷水桃李雀肉生菜生葱。②《奇效良方》同上。③《普济方》无白术，余同上。
侧子酒（一）	侧子酒（一）――（痹证）<br>（《备急千金要方》）<br>【配方】侧子、牛膝、丹参、山茱萸、蒴　根、杜仲、石斛各四两、防风、干姜、蜀椒、细辛、独活、秦艽、桂心、芎、当归、白术、茵芋各三两，五加皮五两，薏苡仁二升。<br>【制法】上十二味口父咀，绢袋盛，清酒四斗渍六宿。<br>【主治】风湿痹不仁，脚弱不能行。<br>【用法】初服三合，稍加，以知为度。
菖蒲浸酒方	菖蒲浸酒方――（耳聋）<br>（《普济方》）<br>【配方】菖蒲三分，木通（v）二两，磁石（捣碎水淘去赤汁）两，防风（去芦头）、桂心各三两，牛膝（去苗）三两。<br>【制法】上为细v，用生绢袋盛，以酒一瓶内药，浸七日。<br>【主治】治虚劳耳聋。<br>【用法】每日食前暖一小盏服之。
菖蒲酒（七）	菖蒲酒（七）――（癫痫狂）<br>（验方）<br>【配方】菖蒲120克，白酒450毫升。<br>【制法】将上药用酒浸于净瓶中，封口，3-5日后即可开封饮用。<br>【主治】癫狂惊痫，神昏谵语，耳聋，健忘失眠，关节不利，咳逆痰多，胸腹胀闷，脘痞不饥，呕吐。<br>【用法】每次空心饮10-20毫升，每日3次。
菖蒲酒（三）	菖蒲酒（三）――（产后出血）<br><br>（《妇人大全良方》）<br>【配方】菖蒲一两半。<br>【制法】上细v，以酒二盏，煮取一盏，去滓。<br>【主治】治产后崩中不止，下血。<br>【用法】分温三服，食前。<br>说明：与《普济方》（注出《太平圣惠方》）同。
菖蒲酒（五）	菖蒲酒（五）――（痿证）<br>（《永乐大典》）<br>【配方】菖蒲（削治薄切，曝干）一斗。<br>【制法】以生绢袋盛之，以好酒一石，入津瓮中，安药囊在酒中，密封泥之，百日发视之，加绿叶色，复饮一斗秫米内酒中，复封四十日，便漉去滓。<br>【主治】大风十二痹。通血脉，调荣工。治骨立痿黄，医所不治者。服一剂，服经百日，颜色丰足，气力倍常，耳目聪明，行及奔马，发白更黑，齿落再生，昼夜有光，延年益寿，久服得与神通。<br>【用法】温饮一盏，日三。其药滓曝干，捣细罗为散，酒调一钱。服之大尤妙。
菖蒲酒（一）	菖蒲酒（一）――（痿证）<br>（《本草纲目》）<br>【配方】石菖蒲。<br>【制法】上药煎汁，或酿或浸。<br>【主治】三十六风，一十二痹，通血脉，治骨痿，久服耳目聪明。<br>【用法】饮之。<br>说明：本方见于《本草纲目》卷二十五附诸药酒条。
菖蒲酒方（二）	菖蒲酒方（二）――（耳聋）<br>（《圣济总录》）<br>【配方】菖蒲（米泔浸一宿v焙）三分，木通、磁石（捣碎绵裹），桂（去粗皮）各半两，防风（去叉）、羌活（去芦头）各一两。<br>【制法】上六味，口父咀如麻豆，以酒一斗渍，寒七日，暑三日。<br>【主治】治耳聋。<br>【用法】每日空腹饮三两盏，以差为度。<br>说明：①《圣济总录》一方用木通（v）一分，治耳聋及耳鸣，每日空腹温饮一二盏。余同上。②《普济方》一名菖蒲浸酒，注出《朱氏家藏方》，谓一方无羌活。治耳聋及鸣，余同上。
菖蒲酒方（三）	菖蒲酒方（三）――（痹证）<br>（《太平圣惠方》）<br>【配方】菖蒲。<br>【制法】上捣绞，取汁五斗，糯米五斗炊熟，细曲五斤捣碎，相拌令匀，入瓮密盖，三七日即开。<br>【主治】大风十二痹，通血脉，调荣卫，治骨立萎黄，医所不治者，服一剂，服经百日，颜色丰足，气力倍常，耳目聪明，行及奔马，发白更黑，齿落再生，昼夜有光，延年益寿，久予得与神通。<br>【用法】每温饮一中盏，日三服之。<br>说明：《寿亲养老新书》、《饮馔服食谱》同上。
菖蒲酒方（四）	菖蒲酒方（四）――（痹证）<br>（《太平圣惠方》）<br>【配方】菖蒲（细v蒸熟）、生术（细挫去皮）各一斗。<br>【制法】上二味都入绢袋盛，用清酒五斗，入不津瓮中盛，密封。春冬二七日，积夏一七日取开。<br>【主治】大风十二痹，通血脉，调荣卫。治骨立萎黄，医所不治者，服一剂。服经百日，颜色丰足，力气倍常，耳目聪明，行及奔马，发白更黑，齿落再生，昼夜有光，延年益寿，久服得与神通。令人不老强健，面色光泽。<br>【用法】每温饮一盏，日三合
菖蒲酒方（一）	菖蒲酒方（一）――（疥癣病）<br>（《圣济总录》）<br>【配方】菖蒲（细切）五斗。<br>【制法】上一味，以水一石五斗，煮取三斗，去滓，入米二斗，酝如酒法候熟。<br>【主治】治一切癣。<br>【用法】旋取饮令极醉，即愈。<br>说明：《普济方》注一方用末五斤，酒五升清蒸，使味出，绝酒一日服，每服一升。余同上。
菖蒲酝酒方	菖蒲酝酒方――（白癜风）<br>（《圣济总录》）<br>【配方】菖蒲（九节者去须节米泔浸切）一斤，天门冬（去心）一斤，天雄（炮裂去皮脐）三两，麻子仁（生用）一升，茵芋（去粗茎）一两，干漆（炒烟出），生干地黄（切焙）远志（去心）各三两，露蜂房（微炒）一两，苦参一斤，黄芪（炙v）八两，独活（去芦头）、石斛（去根）各五两，柏子仁（生用）二升，蛇蜕皮（微炙）长三尺，天蓼木（v）二两。<br>【制法】上一十六味，粗捣筛，以水二石五斗，煮菖蒲等取汁一石，以酿一豆二斗秫米，蒸酝如常法。用六月六日细曲，于七月七日酿酒，酒成去糟取清，收于净器中密复。<br>【主治】治白驳举体斑白，经年不瘥。<br>【用法】每温服四合至五合，日二夜一。更重煮菖蒲并药滓，取汤淋洗所患处佳。<br>说明：《普济方》同上。
长宁风湿酒	长宁风湿酒――（关节疼痛）<br>（《新医药学杂志》）<br>【配方】当归120克，土茯苓90克，生地120克，防风60克，威灵仙90克，防己、红花各60克，木瓜3030克，高梁酒（60）度1.5公斤。<br>【制法】上药浸酒中，3周后取出滤液；药渣再加水煎煮，过滤去渣，取药汁，另用蝮蛇、眼镜蛇、赤炼蛇（均用活蛇）各半公斤，分别浸酒1公斤，3周后滤取酒液，等量混合成为“三蛇酒”，将药酒、药汁、三蛇酒三者等量混合即可长宁风湿酒。<br>【主治】类风湿性关节炎及其他关节炎。<br>【用法】每次10-15毫升，每日3次。
长松酒（二）	长松酒（二）――（痹证）<br>（《普济方》）<br>【配方】松根（切片）1公斤，酒1公斤。<br>【制法】将松根九蒸九晒，用酒浸于瓶中，封口，7日后开封取用。<br>【主治】风寒湿痹，腰痛，膝弱，阳萎。<br>【用法】每于食前温饮1-2杯。
常春酒	常春酒――（闭经）<br><br>（验方）<br>【配方】常春果、枸杞子各200克，好酒1.5公斤。<br>【制法】将上药捣破裂，盛于瓶中，注酒浸泡7日后即可饮用。<br>【主治】赢瘦虚弱，腹中冷痛，妇女血闭。<br>【用法】每次空腹饮1-2杯，每日3次。
常春藤酒	常春藤酒――（口眼?斜）<br>口眼?斜，或作口眼歪斜，古有口面?口呙斜、口僻眼急等，现称歪嘴风、面瘫，与现代医学之面神经炎所指类同。临床表现为面部僵硬，面颊动作不灵；额部皱纹消失，眼裂不能闭合，不能做皱额、闭目、鼓颊等动作；进食时，食物留滞在齿、颊间，唾液自口角外流。发病前常有受凉、受潮、吹风史，少数患者于病前几日可有耳后、耳内疼痛或面部不适等前驱症状。口眼?斜也是中风病的后遗症之一，但同时伴有半身不遂等，与此不一。药酒治疗本病常用药物有：独活、白附子、三角风、白风藤、钩藤、防风、青松叶、胡麻、白僵蚕、全蝎、蚕沙、川芎、羌活、莽草、细辛、黑豆、枳茹、枳壳等。<br>（《贵阳民间草药》）<br>【配方】三角风（常春藤）五钱，白风藤五钱，钩藤7个，白酒1斤。<br>【制法】浸泡10-20日后服用；或蒸酒适量服用。<br>【主治】口眼?斜。<br>【用法】每服10-20毫升，日服2次。
常山酒（二）	常山酒（二）――（疟疾）<br>（《普济方》）<br>【配方】常山三两（细切），蒜七瓣。<br>【制法】上捣碎，虚弱者二两，蒜七瓣去皮尖切，以酒一小升半，渍浸一宿，旦去滓。<br>【主治】疗瘴疟及瘴气。<br>【用法】暖服尽，须臾当吐为妙，适令尽好，过时食，一日不得漱口及洗手面，三七日慎生葱生菜生冷肉面油腻。若早发者，半夜服，要令吐。
常山酒（一）	常山酒（一）――（疟疾）<br>（《普济方》）<br>【配方】常山苗一握（无苗取根五两代之），独颗蒜七颗，淡竹叶二握，豉一合，鳖甲三两（炙）。<br>【制法】上切，以苦酒三升，煎取一升。<br>【主治】疟疾。<br>【用法】临发随性多少，服尽之，服讫当大吐愈。忌食苋、生葱、生菜。
常山酒方（二）	常山酒方（二）――（疟疾）<br>（《圣济总录》）<br>【配方】常山三分，乌梅肉生用、甘草（生用）各半两。<br>【制法】上三味，细，以酒二盏，浸一宿，早晨去滓煎。<br>【主治】治痰实疟，发歇不止。<br>【用法】温服一盏，良久以筋入喉中引之，吐痰即瘥。<br>说明：《普济方》同上。
常山酒方（三）	常山酒方（三）――（疟疾）<br>（《圣济总录》）<br>【配方】常山、淡竹叶（切洗）一两，鳖甲（去裙酥炙）一分，甘草（炙　）三分。<br>【制法】上四味，粗捣筛，每服五钱匕，以酒半盏、浸药复，安露地一宿。明旦以水一盏，煎至七分、去滓。<br>【主治】治阂疟先寒战动，寒解壮热，日发及间日发。<br>【用法】未发前温服尽，当吐，即效不必尽剂。过发时，良久方可食。<br>说明：《普济方》同上。
常山酒方（四）	常山酒方（四）――（疟疾）<br>（《圣济总录》）<br>【配方】常山、鳖甲（醋炙去裙）各三分，虎头骨（炙）半两，豉（炒半分），桃枝一握，柳枝一握，桃仁（去皮尖双仁炒）三七枚，干枣（去核）三枚，乌梅（炙）七枚。<br>【制法】上九味，细，以酒一升浸一宿，明日入生姜五片，煎取五合去滓。<br>【主治】治疟。<br>【用法】空心分为二服。<br>说明：《奇效良方》同上。
常山酒方（一）	常山酒方（一）――（疟疾）<br>（《外台秘要》）<br>【配方】常山（切）一两，独头蒜（去根茎横切）一颗，糯米一百粒，乌豆一百粒，清酒一升。<br>【制法】上五味，病未发前一日，以酒浸药于碗中，以白纸覆之。<br>【主治】疗疟。<br>【用法】欲发时三分饮一分，如未吐更服一分，得吐则瘥，忌生菜生葱。<br>说明：《圣济总录》、《普济方》、《奇效良方》同上。
车螯酒	车螯酒――（痈疽、疮疡、发背）<br>（《普济方》）<br>【配方】车螯毂一二个泥固脐火煅过末为细末，灯心三十茎，蜜一大匙，栝蒌一个。<br>【制法】上碎，剥栝蒌，用酒一升，以下煎三味微熟。<br>【主治】治发背痈疽。<br>【用法】调车螯末二大钱，不过两服，痛止。
车螯酒方	车螯酒方――（痈疽、疮疡、发背）<br>痈是为气血毒邪所阻滞，壅遏不通而发生的化脓性疾病。疽，初起在皮肤上即有杰粒脓点，继则灼热、肿胀、疼痛，易向深部及周围扩散，脓头亦相继增多，溃后状如蜂窝。疮疡初起如瘭浆，渐渐溃烂，如汤火灼伤，汁流浸淫，是一种急性皮肤病。于临床应选用清热解毒，疏风消肿，益胃生津等药酒，做到辨证施治。<br>（《圣济总录》）<br>【配方】车螯（紫色光厚者以黄泥固济煅赤候冷为末）取三钱七，腻粉一钱七，甘草末二钱七，栝蒌实（v）一枚。<br>【制法】上四味，先将前三味和匀，次将栝蒌用酒二盏，煎至一盏，去滓。<br>【主治】治发背作寒热。<br>【用法】调下前药三钱匕，取下恶物差。
驰脂酒方	驰脂酒方――（痹证）<br>（《食治养老方》）<br>【配方】野驰脂（　之）五两。<br>【制法】上空心温酒五合，下半匙以上脂，调令消。<br>【主治】食治老人风热烦毒，顽痹不仁，五缓六急。<br>【用法】顿服之，日二服，极效。
豉酒方（二）	
豉酒方（三）	豉酒方（三）――（脚气）<br>（《圣济总录》）<br>【配方】豉（三蒸三暴令干蒸以米熟为度）三升。<br>【制法】上一味，以生绢袋裹，内净瓷瓶中，用好酒五升浸之，密封头，春夏五日，秋冬七日。<br>【主治】脚气。<br>【用法】初服半盏，渐加至一盏，日三四服，常令有酒气。<br>说明：①《经验方》治脚气，大小便不通利。余同上。②《本草纲目》同上。
豉酒方（四）	豉酒方（四）――（水肿臌胀）<br>（《普济方》）<br>【配方】豉五合。<br>【制法】用豉微炒，以酒一升半，煎五七沸，去滓。<br>【主治】伤寒毒气攻手足，及身体虚肿，宜服此方。<br>【用法】随性稍热饮之。
豉酒方（一）	豉酒方（一）――（脚气）<br>（《圣济总录》）<br>【配方】豉（三蒸三暴）一斗。<br>【制法】式一味，以清酒二斗，内瓮中浸，经三宿。<br>【主治】治风毒脚弱　满上气。<br>【用法】随意多少饮之，若急待饮，即以酒煮饭饮之。
豉心酒	豉心酒――（脚气）<br>（《老老余编》）<br>【配方】豉心（九九暴）三升九，酒五升。<br>【制法】上同浸二日。<br>【主治】治老人脚气，痹弱，烦躁不安。<br>【用法】空心，任意服。
赤车使者酒方	赤车使者酒方――（半身不遂）<br>（《圣济总录》）<br>【配方】赤车使者、当归（切焙）、白茯苓（去黑皮）各半两，防风（去叉）、独活（去芦头）、细辛（去苗叶）、人参各一两，附子（炮裂去皮脐）十五枚。<br>【制法】上八味，v如麻豆，用水一斗，黍米一斗，曲一斤五两造酒，内三斗瓮中密封，以油袋盛瓮，勿令水入，沉井底三宿，药成即置高燥处，停二日。<br>【主治】中风湿偏枯，缓纵不遂，五劳七伤，寒冷百病。<br>【用法】平旦服半盏，日三，渐增之。<br>说明：《普济方》同上。
抽葫芦酒	抽葫芦酒――（水肿臌胀）<br>（《医林改错》）<br>【配方】抽葫芦。<br>【制法】以黄酒入葫芦内煮一时，或自抽干葫芦，焙为末。<br>【主治】治腹大周身肿。<br>【用法】服酒，或黄酒调服葫芦末三钱。
楮皮枝叶酒	楮皮枝叶酒――（水肿臌胀）<br>（《普济方》）<br>【配方】楮皮枝叶一大束（一方用猪椒枝叶）。<br>【制法】上切煮取汁，随多酿酒。<br>【主治】治男子女人新久肿。<br>【用法】但以饮醉为佳，过三四日，肿少退，已后可常服之。<br>说明：《普济方》注“出千金方”。方名为作者所加。
楮实助阳酒	楮实助阳酒――（阳萎）<br>（验方）<br>【配方】楮实子（微炒）100克，鹿茸（涂酥炙去毛）10克，制附子、川牛膝、巴戟天、石斛各60克，炮姜、肉桂（去粗皮）各30克，大枣60克，醇酒2公斤。<br>【制法】上药共捣碎细，用夏布包贮，置于净器中，注酒浸之，封口，8日后去渣备用。<br>【主治】肾阳虚损，阳萎滑泄，脾胃虚寒，面色无华。<br>【用法】每次空心温饮10毫升，每日早、晚各1次。
川乌酒	川乌酒――（产后风痉）<br><br>（《普济方》）<br>【配方】川乌（v）五两，黑豆半升。<br>【制法】上药同炒半黑，以酒三升，泻于挡内急搅，以绢滤取汁。<br>【主治】治产后中风，身如角弓反张，口噤不语。<br>【用法】酒微温服一小盏。若口不开者，拗开灌之。未效，加乌粪一合炒，内酒中服之，以瘥为度。
川芎酒	川芎酒――（口眼?斜）<br>（《普济方》）<br>【配方】川芎、羌活（去芦头）各30克，莽草20克，细辛、甘草（炙）各30克，黑豆（炒）60克，酒100毫升。<br>【制法】将上药粗捣碎，分作8份，每份用酒煎取50毫升。<br>【主治】热毒风邪致?斜及偏风。<br>【用法】热含嗽，每日4-5次，咽亦无妨。
传尸酒方	传尸酒方――（痃癖）<br>（《普济方》）<br>【配方】猪胰一具（细切），青蒿叶（不拘多少）。<br>【制法】上以无灰酒一大升，微火温之，乘热内猪胰中，和蒿叶相共暖，使消尽，又取桂心一小两，别捣为末，内酒中。<br>【主治】丈夫痃癖两胁虚胀，变为水气，服之皆效验。<br>【用法】每日平旦，空腹取一小盏服之，午时、夜间各再一服，甚验，忌热面，油腻等。
磁石酒（一）	磁石酒（一）――（耳聋）<br>（《普济方》）<br>【配方】故铁三十斤。<br>【制法】以水七斗，浸三宿取汗，曲酿米七斗，如常造酒法，候熟，取磁石一斤，研末浸酒中，三日。<br>【主治】治三十年久聋。<br>【用法】可饮取醉，以绵裹磁石纳耳中，覆头卧，酒醒去磁即瘥。<br>说明：《普济方》注出《太平圣惠方》）。
刺五加酒	刺五加酒――（肠风）<br>（《本草纲目》）<br>【配方】刺五加65克，白酒500毫升。<br>【制法】将刺五加入酒内浸泡10天后服用。<br>【主治】肠风痔血，跌打损伤，风湿骨痛。<br>【用法】每服20毫升，日服2-3次。
苁蓉强壮酒	苁蓉强壮酒――（腹胀腹痛）<br>（验方）<br>【配方】肉苁蓉50克，川牛膝40克，菟丝子、制附子各20克，椒红30克，肉豆蔻20克，补骨脂（炒香）、楮实各25克，巴戟天（炒黄）30克，木香15克，鹿茸（去毛酥炙）10克，肉桂20克，蛇床子15克，炮姜20克，醇酒1.5公斤。<br>【制法】将上药共碎细，用夏白布盛，置于净器中，注酒封口浸之，春夏5日，秋冬7日即可取用。<br>【主治】肝肾虚损，腹胁疼痛，下元虚冷。<br>【用法】每次空心温服1-2小杯，每日早、晚各1次。
葱豉黄酒汤	葱豉黄酒汤――（感冒）<br>（《偏方大全》）<br>【配方】葱30克，淡豆豉15克，黄酒50克。<br>【制法】先将豆豉放砂锅内，加水一小碗，煎煮10分钟，再把洗净切段的葱（带须）放入，继续煎煮5分钟，然后加入黄酒，立即出锅。<br>【主治】风寒感冒，发热，头痛，虚烦，无汗，并有呕吐，泄泻等症。<br>【用法】趁热，顿服。<br>注意：避风、寒。
葱豉酒方	葱豉酒方――（乳病）<br>（《圣济总录》）<br>【配方】葱（切）一握，豉（绵裹）五合。<br>【制法】上二味，以水三盏，煎至二盏。<br>【主治】治乳石发，心痛胀满，饮热酒不解。<br>【用法】去滓分三服，热饮之，早晨日午近晚各一。
聪耳磁石酒	聪耳磁石酒<br>【来源】《经验方》<br>【原料】磁石30克，木通、石菖蒲各80克，白酒1700克。<br>【制作】将磁石捣碎，用纱布包裹；石菖蒲用米泔水浸2日后切碎，微火烤干。把3味药装入纱布袋里，与白酒同置入容器中，密封浸泡7天后即可服用。<br>【功效】通窍，聪耳。适用于肝肾阴虚所致之耳鸣、耳聋等症。<br>【用法】早、晚各一次，每次饮服20―30毫升。
崔氏苍耳酒	崔氏苍耳酒――（癞病）<br>（《外台秘要》）<br>【配方】苍耳（八月收，含茎叶花实）一石，牛膝根一升，松叶二斗，商陆根（白色者）二升，鼠粘根一斗。<br>【制法】上五物皆v讫，以水两石五斗，煮取六斗汁。如釜小可分煮之，即分三斗汁。将浸曲一斗二升，高量其曲，加于常法五分，为药力费曲故也。余三斗汁，留将拌料，糯米一石二斗，分作五　，净淘干漉。上并以大斗。第一　一日炊四斗米，取药汁九升拌熟，细切生地黄三斗，和米下之。第二　三日炊三斗米，取药汁七升拌　熟，与杏仁一斗去皮尖，碎和捣如泥下之。第三　五日炊二斗米，取药汁六升半拌　熟，取大麻子一斗捣碎和下之。第四股七日炊二斗米，取药汁四升半拌熟，取胡麻一斗，捣碎和下之。第五　九日炊一斗米，取药汁三升拌　下之。<br>上以前五　法，须候米消尽，即炊　之，末必要须隔日。其酒如米少味薄，更炊一二斗米下之，使味足，然后去糟取清。<br>【主治】疗大风恶疾，及一切诸风，乃至骨髓中毒风，补养精神，令人光悦。<br>【用法】依常法饮半升，不能者可量性多少，常使有酒气逼，夜饮最是所宜。
崔氏侧子酒	崔氏侧子酒――（脚气）<br>（《外台秘要》）<br>【配方】侧子（炮）四两，生石斛（碎）八两，磁石八两，独活三两，秦艽三两，甘草（炙）三两，紫苏茎一握，前胡四两，防风三两，茯苓八两，黄苓三两，五味子四两，防己三两，桂心二两，丹参三两，蜀椒（出汗）二两，山茱萸四两，芎<br>二两，细辛二两，当归三两，白术四两，干姜三两，薏苡仁一升三合。<br>【制法】上二十三味薄切，绢袋贮，以清酒四升浸五日。<br>【主治】疗脚气不遂。<br>【用法】一服四合，日再，细细加至八九合，温饮，慎生冷猪肉蒜面。其中间觉热渴，得饮豉酒，豉仍须蒸暴之，忌海藻菘菜桃李雀肉生葱生菜及醋物等。
催生马齿苋酒方	催生马齿苋酒方――（难产）<br><br>（《普济方》）<br>【配方】马齿苋。<br>【制法】绞取自然汁三分，入酒三分。<br>【主治】疗难产二三日不下。<br>【用法】微暖服之。
大补中当归酒	大补中当归酒――（产后腹痛）<br><br>（验方）<br>【配方】当归、续断、肉桂、川芎、干姜、麦冬各40克，芍药60克，吴茱萸、干地黄各100克，甘草、白芷各30克，黄芪40克，大枣20个，酒2公斤。<br>【制法】将上药共碎细，布包，用酒浸于净器中，经1宿，加水1公斤，煮取1.5公斤，备用。<br>【主治】产后虚损，小腹疼痛。<br>【用法】每饭前温饮15-20毫升，每日3次。
大豆蚕沙酒	大豆蚕沙酒――（头痛）<br>（验方）<br>【配方】大豆250克，云苓、蚕沙各126克，黄酒1.5公斤。<br>【制法】先将后2味碎细，用酒浸于净器中；别炒大豆，令声断，急投入酒中，封口，7日后开封，去渣备用。<br>【主治】头痛烦热，肌酸体重，身痒，背强口噤及女子产后中风湿。<br>【用法】每次温饮1-2小杯，每日5-7次，微出汗则佳。
大豆浸酒（五）	大豆浸酒（五）――（手足不遂）<br>（《普济方》）<br>【配方】黑豆一升。<br>【制法】拣紧小者净淘，用酒五升，同入瓶中密封，用灰火煨，常令热，约至酒减半，即去豆取酒。一方面用炒豆。<br>【主治】中风，手足不遂。<br>【用法】每服空心及临卧时，各饮二合至三合。
大豆酒（二）	大豆酒（二）――（产后虚损）<br><br>（《普济方》）<br>【配方】大豆一升。<br>【制法】上一味炒令熟热，投三升酒中，密封。<br>【主治】产后风虚，五缓六急，手足顽痹，头旋眼眩，血气不调。<br>【用法】随性饮之。<br>说明：方名为作者所加。
大豆酒（三）	大豆酒（三）――（水肿臌胀）<br>（《普济方》）<br>【配方】大豆（拣净）一斗。<br>【制法】上以水五斗，煮取一斗五升，澄清内釜中，以一斗半美酒内中，更煎取九升。<br>【主治】治男子女人新久肿，得风气入腹，妇人新产上圊则风入脏，腹中如马鞭者，嘘吸短气，咳嗽。<br>【用法】宿勿食，平旦一服三升，温覆取汗两食顷当下，去风气肿减，慎风冷，十日可全愈，若急不可待，逐急合服，肿不尽退加之，肿瘥，更服三升，若十分瘥，则勿服，病中亦可任性饮之，使酒气相接，肿瘥后，渴慎勿多饮。<br>说明：《普济方》注“出千金方”，原方名为“大豆煎”，此方名为笔者所加。
大豆酒（四）	大豆酒（四）――（水肿臌胀）<br>（《普济方》）<br>【配方】大豆。<br>【制法】用大豆三升，以水六升煮令熟，出豆澄汁，更内美酒五升，微火煎如饧。<br>【主治】疗水肿，兼治风虚水气。<br>【用法】服一升，渐增之，令小便利则肿消也。
大豆酒（一）	大豆酒（一）――（背强口噤）<br>（《肘后备急方》）<br>【配方】大豆（熬令黄黑）五升。<br>【制法】以酒五升渍取汁。<br>【主治】口噤不开。<br>【用法】以物强发口而灌之毕取汗。<br>说明：本方原无方名，见《肘后备急方・卷三・治中风诸急方第十九》，其云：“若口噤不开者，取在豆五升熬令黄黑，以酒五升渍取汁以物强发口而灌之毕取汗”。
大豆酒方（二）	大豆酒方（二）――（破伤风）<br>（《圣济总录》）<br>【配方】大豆一斗。<br>【制法】上一味捣碎，安甑上蒸，乘热以酒一斗淋下。<br>【主治】治头破脑髓出，中风口噤。<br>【用法】每服一盏，连三五服，取汗为效。<br>说明：①《普济方》注出《太圣圣惠方》。②《太平圣惠方》同上。
大豆酒方（六）	大豆酒方（六）――（耳聋）<br>耳聋又名“耳闭”、“耳聩”。系指主观感觉或客观检查均示听力有不同程度障碍者。症见头痛，鼻塞，口苦，耳窍闭塞，如棉塞耳，耳鸣耳聋，多属实证，多因风热、风寒、肝火等所致。症见头晕目眩，腰膝酸软，乏力等症者，多属虚证，主要因下元亏损，肾精不足，气虚、血虚等所致。一般暴聋者多属实证；久聋或发病较缓慢者，多属虚证。此外中医古籍还据耳袭的病因不同，分“风聋”、“湿聋”、“虚聋”、“劳聋”、“厥聋”、“猝聋”等。一般认为耳聋多由耳鸣发展而来，老年人耳聋听不真切，但又非一无所闻，称为“重听”。听力消失而同时不能言语者，称为“聋哑”，中医主治先治聋，后治哑。以下介绍用各种药酒配方治疗耳聋的方法，较之其它方法可能有其独到的地方。<br>（《圣济总录》）<br>【配方】大豆（拣）一升，鸡屎白（捣炒）半升。<br>【制法】上二味，先炒大豆声绝，入鸡屎白，取酒五升沃之，良久去滓。<br>【主治】治耳聋。<br>【用法】分温三服，厚衣盖取汗。<br>说明：《普济方》一方同上。
大豆酒方（七）	大豆酒方（七）――（产后风痉）<br><br>（《圣济总录》）<br>【配方】大豆三升。<br>【制法】右一味炒令声断，取器盛，清酒五升，沃热豆中讫，漉出豆，得余汁。<br>【主治】妇人产后中风困笃，或背强口噤，或但烦热，或头身背重，或身痒，剧者呕逆直视，此皆因湿所致。<br>【用法】每温服一盏，日五七服，温复取微汗，身才润则愈，一则去风，二则消血。
大豆酒方（三）	大豆酒方（三）――（背强口噤）<br>（《圣济总录》）<br>【配方】大豆三升。<br>【制法】上一味，炒令极熟，以清酒五升沃之，可得二升。<br>【主治】中风口噤，或伤风湿，身体　痹。<br>【用法】旋旋温服，令少汗出身微润即瘥。<br>说明：《普济方》用大豆五升，余同上。
大豆酒方（四）	大豆酒方（四）――（痈疽、疮疡、发背）<br>（《圣济总录》）<br>【配方】大豆（紧小者）三升，麻子仁（研碎）三升，乌蛇（去头尾皮骨重四两椎碎）一条。<br>【制法】上三味，相和令匀，就甑内蒸，临熟甑底汤，将好酒一斗五升，就甑中淋，候酒热又淋，凡七八遍，入瓷瓶内密封。<br>【主治】治热毒风肿成疽，日夜热痛。<br>【用法】候冷量性饮之，常带酒气，佳。<br>说明：《普济方》一方同上。
大豆酒方（五）	大豆酒方（五）――（产后风痉）<br><br>（《妇人大全良方》）<br>【配方】大豆（炒令烟出）五升。<br>【制法】以酒一升投之，密盖令温，去豆。亦有加羌活者，亦佳。<br>【主治】《千金》疗产后中风，腰背强痛，中风烦热，若渴，头身皆重。此因风冷所致及伤寒。<br>【用法】服一升，日夜数服。卧取微汗，避风。
大豆酒方（一）	大豆酒方（一）――（头痛）<br>（《备急千金要方》）<br>【配方】大豆（炒令无声）三升。<br>【制法】先以一斗二升瓶盛清酒九升，乘豆热即倾著酒中，密泥头七日。<br>【主治】治头风。<br>【用法】温服之。<br>说明：①《医部全录》用大豆二升，大豆炒令无声，瓶盛清酒九升，乘豆热，即倾著酒中，密泥头七日。余同上。②《普济方》一方同上。
大凤引酒	大凤引酒――（痹证）<br>（《柳森可用方》）<br>【配方】大豆100克，制附子16克，枳实、泽泻、陈皮、茯苓、防风各20克，米酒1公斤。<br>【制法】先将上药后6味共碎细，绢袋盛，置净器中，用酒、水2斤煮大豆，取2斤，浸器中，煮取斤半，分3份。<br>【主治】风湿痹，遍身胀满。<br>【用法】每服1份，3份为1疗程。
大佛酒	大佛酒――（经行后期）<br><br>（《百病饮食自疗》）<br>【配方】大砂仁、大佛手、大山楂各30克，黄酒（或米酒）500克。<br>【制法】将上药洗净，置酒瓶中，浸泡3-6天，即可饮用。<br>【主治】经期延后，量少色暗有块，小腹及胸胁乳房胀闷不舒，时有叹息，精神忧虑，舌可正常，脉弦涩。<br>【用法】每次饮15-30克，早、晚各1次。<br>说明：不善酒者可以醋代泡，服时加冰糖适量减酸。
大金牙酒	大金牙酒――（疫毒）<br>（《备急千金要方》）<br>【配方】金牙一斤，侧子、附子、天雄、人参、苁蓉、茯苓、当归、防风、黄芪、薯蓣、细辛、桂心、萆、萎蕤、白芷、桔梗、黄芩、远志、牡荆子、芎、地骨皮、五加皮、杜仲、厚朴、枳实、白术各三两，独活半斤，茵芊、石南、狗脊各二两，牛膝、丹参各三两，磁石十两，薏苡仁、麦门冬各一升，生石斛八两，蒴四两，生地黄（切）二升。<br>【制法】上三十九味　咀，以酒八斗渍七日，石药细研，别绢袋盛，共药同渍，服者一依方合之，不得辄信人大言浪有加减。<br>【主治】治瘴疠毒气中人，风冷湿痹，口　面戾，半身不遂，手足拘挛，历节肿痛，甚者小腹不仁，名曰脚气。药力和善。主治极多，凡是风虚，四体小觉有风疴者，皆须将服之，无所不治也。<br>【用法】温服一合，日四五夜一。
大麻仁酒方	大麻仁酒方――（癞病）<br>（《太平圣惠方》）<br>【配方】大麻仁三升。<br>【制法】水淘令净，候干，以酒一浸一宿后，和酒研取白汁，以生绢滤过；却入瓷瓶中，以重汤煮数沸即止。<br>【主治】治大风疾。<br>【用法】每编取一小盏暖过下药，仍兼服后散，相间服之。<br>说明：《普济方》一方同上。
大麻子酒	大麻子酒――（脚气）<br>（《普济方》）<br>【配方】大麻子一升。<br>【制法】上碎研，清酒三升渍三宿。<br>【主治】疗脚气上肿，小腹。<br>【用法】温服。
大生地酒	大生地酒――（水肿臌胀）<br>（《太平圣惠方》）<br>【配方】大地生120克，杉木节50克，牛蒡根（去皮）120克，丹参30克，牛膝50克，大麻仁60克，防风20克，独活、地骨皮各30克，好酒1.5公斤。<br>【制法】将上药共捣碎细，布包，用酒浸于净器中，密封口，7日后开取，去渣贮存。<br>【主治】足胫虚肿，烦热疼痛，行步困难。<br>【用法】每于饭前饮。
丹参酒	丹参酒<br>【来源】《中药制剂汇编》<br>【原料】丹参300g，米酒适量<br>【制作】1将丹参切碎；2倒入适量的米酒浸泡15天；3而后滤出药渣压榨出汁，将药汁与药酒合并；4再加入适量米酒，过滤后装入瓶中备用。<br>【功效】养血安神。<br>【用法】每次10ml，每日3次，饭前将酒温热服用。<br>【药材功效解析】丹参：味苦，性微寒，入肝肾二经，活血，通心包络，去滞生新，调经顺脉，安神宁心，治健忘怔仲，惊悸不寐。药理实验结果表明，丹参有扩张冠状动脉作用。能使冠状动脉血流量增加，并使心率减慢，对防治冠心病等老年性疾病是大有益处的。又因丹参含维生素E，所以也应有抗衰防老作用。此酒主治神经衰弱，记忆力减退，失眠健忘。<br>【宜忌】
丹参酒（二）	丹参酒（二）――（癞病）<br>（《千金翼方》）<br>【配方】丹参、前胡、细辛、卷柏、天雄（去皮）、秦艽、茵芋、干姜、牛膝、芫花、白术、附子（去皮）、代赭、续断、防风、桔梗、茹、矾石（烧汁尽）、半夏（洗）、白石脂、石南、狼毒、桂心、菟丝子、芍药、龙胆、石苇、常山、黄连、黄芩、玄参、矾石（烧）、远志（去心）、紫菀、山茱萸、干地黄、苏、甘草（炙）、白芷各一两，石膏二两，杏仁（去皮尖双仁）二十枚，麻黄（去节），大黄各伍分，菖蒲一两半，蜈蚣（赤头者，炙）二枚。<br>【制法】上四十五味，切，以酒四斗渍五宿。<br>【主治】主恶风疼痹不仁，恶疮不瘥，无痴，须眉秃落。<br>【用法】一服半合，增至一二合，日二，以瘥为度。
丹参酒（三）	丹参酒（三）――（癫痫狂）<br>（《太平圣惠方》）<br>【配方】丹参200克，米酒（50度）1000毫升。<br>【制法】将上药碎为粗粉，加入米酒，密闭浸渍14天，过滤，压榨药渣合并酒液，再过滤至澄清。<br>【主治】癫痫，神经衰弱，脑震荡后遗症，头痛失眠等多种神经系统疾病。<br>【用法】每次饮20毫升，日2次。
丹参酒（四）	丹参酒（四）――（血栓闭塞性脉管炎）<br>本病是一种进展缓慢的周围中小动、静脉闭塞性炎症。属中医“脱骨疽”、“十指零落”范畴。系因脾肾两虚，寒温侵袭，凝滞脉络所致。<br>（验方）<br>【配方】丹参30克，60度白酒500毫升。<br>【制法】丹参洗净，煎碎，装入细口瓶中，加白酒约500毫升，封紧瓶口，每日振摇一次，浸泡半月后开始饮用。<br>【主治】常饮有益于血栓闭塞性脉管炎的治疗和康复。<br>【用法】每次20毫升，每日3次，饭前服用。
丹参酒（一）	丹参酒（一）――（崩漏）<br><br>崩漏又称“经崩”，是指行经期间阴道大量出血，或持续出血，淋沥不断的病症。若出血量多而来势猛者，称“血崩”或“崩中”；若出血量少，但持续不断者，称为“漏下”。崩和漏二者可相互转化。引起崩漏的主要原因有气虚、血热、血瘀、冲任不固等。以下介绍五种治疗崩漏的药酒，仅供选用。<br>（《千金翼方》）<br>【配方】丹参、地黄、忍冬、地榆、艾各五斤。<br>【制法】上五味，先燥熟舂之，以水渍三宿，去滓，煮取汁，以黍米一斛，酿如酒法。<br>【主治】治妇人崩中去血及产后余病。<br>【用法】初服四合，稍增之。<br>说明：①《备急千金要方》同上。②《外台秘要》以上五味合捣之，以水渍三宿，去滓煮取汁，以糯米一石酿酒，饮服之，余同上。
丹参酒方（二）	丹参酒方（二）――（水肿臌胀）<br>（《圣济总录》）<br>【配方】丹参、鬼箭羽各一两半，秦艽（去苗土）、知母（冬月不用）各一两，猪苓（去黑皮）三分，白术一两半，海藻（洗去咸炙）三分，赤茯苓（去黑皮）一两，桂（去粗皮）、独活（去芦头）各三分。<br>【制法】上一十味，以酒九升，浸五日，急须者，置热灰上一日便可就。<br>【主治】治久患大腹病，其状四肢细腹大，有小劳苦，则是胫肿满，食则气急。此病服下利药极不瘥，宜用此酒，以散除风湿，利小便。<br>【用法】每服一盏，饮酒少者，随意减之，日三服。
丹参石斛酒	丹参石斛酒――（脚气）<br>（《圣济总录》）<br>【配方】石斛（去根）60克，丹参、川芎、杜仲（去粗皮）、防风（去芦）、白术、党参（去芦）、桂心、五味子、白茯苓、陈橘皮（汤浸出白炒）、黄芪各30克，干姜（炮）45克，炙甘草15克，山药30克，牛膝45克，当归30克，清酒2公斤。<br>【制法】将上药共为粗末，用生白布袋盛，置净器中，酒浸，封口，7日后开取，去渣备用。<br>【主治】脚气痹弱，筋骨疼痛。<br>【用法】饭前温饮1-2杯，渐加至2-3杯，每日2次。
丹砂酒方（二）	丹砂酒方（二）――（喉痹）<br>喉痹亦作喉闭。泛指咽喉肿痛病证的统称。通常主要因风热或阴虚所致。风热邪毒侵袭咽喉，主要表现为咽部红肿灼热，吞咽不利，疼痛，声音低哑，同时可伴头痛、寒热等，与急性咽炎相似。阴虚喉痹主要因阴亏火旺，虚火上炎所致，主要表现为患部潮红，呈慢性充血，咽部不适，似常有痰而不易咳出，吞咽欠爽，本病与慢性咽炎相似。总之凡咽喉肿痛诸病，感到阻塞不利、吞咽不爽甚至吞咽难下，均属喉痹范畴。以下介绍的丹砂酒主要治疗急喉痹。<br>（《圣济总录》）<br>【配方】丹砂（研）、桂（去粗皮）、绛矾各一钱。<br>【制法】上三味，捣研为末，以绵裹，用好酒少许，浸良久。<br>【主治】治急喉痹。<br>【用法】含饮即差。<br>说明：①《圣济总录》又一处载本方，上三味药用量为各半钱，制法和用法同，主治狗咽，喉中忽觉结塞。②《普济方》亦同说明①。
丹砂酒方（一）	丹砂酒方（一）――（癫痫狂）<br>（《圣济总录》）<br>【配方】丹砂（成块者）半两，麝香（研）二钱。<br>【制法】上二味，同研细和匀，用无灰酒二升，于瓷瓶内浸，以慢火煨，时用银筋搅令热。<br>【主治】心神不定，好登高临险，言语不避亲疏，时时自笑，高声叫呼，举止无常，大便秘，小便赤，解衣露体，不能安处。<br>【用法】每服随患人平时饮酒多少，令至醉。候患人睡著，急用厚衣被盖之，汗出病愈，若患人不能多饮，只用丹砂一分，麝香半钱，酒一升，制如前法，时时饮之。
当归地黄酒	当归地黄酒――（产后出血）<br><br>（验方）<br>【配方】生地黄、当归尾各50克，黄酒500克。<br>【制法】将上药共细碎，用酒煎数百沸，去滓备用。<br>【主治】产后血崩，腹痛。<br>【用法】每温饮20毫升，每日3次。
当归独活酒	当归独活酒――（产后风痉）<br><br>（验方）<br>【配方】独活（去芦头）60克，大豆500克，当归10克，酒1公斤。<br>【制法】先将独活、当归碎细，用酒浸泡，1宿后，再将大豆炒之，令青烟出，投酒中封闭，候冷去渣。<br>【主治】产后血虚，中风口噤。<br>【用法】每次温饮1杯许，每日3次。
当归酒（二）	当归酒（二）--（小儿弄舌）<br>小儿弄舌是指小儿时时伸舌，上下左右，有如蛇舔。其原因有心胃蕴热，挟有肝风所致者，也有因胎寒腹痛，脾胃气血不和所致聚唾弄舌者。以下介绍的当归药酒则适用于后一种情况。本方对小儿虚寒腹痛亦有效。<br>（《普济方》）<br>【配方】当归（切焙粗捣）一分，猪肉一两（薄切小片）。<br>【制法】上用清酒一碗，煮至七分，去滓。<br>【主治】治小儿十五日以来，胎寒腹痛微热，聚唾弄舌，躯啼上视。<br>【用法】每服取半呷许，令儿咽之。日三夜一，量儿大小加减。<br>
当归酒（六）	当归酒（六）――（头痛）<br>头痛为临床常见症状之一，有因外感引起者，有因内伤引起者。其中疼痛剧烈，经久不愈，呈发作性者，又称作“头风”。头痛因外感引起者，多为风邪所致或夹有风邪。酒能辛散风邪，故与其它药物相配，可用于外感头痛。头痛因内伤引起者，多为血瘀、血虚、痰浊、气虚、肝阳上亢等所致，酒能温通经络，散瘀血，故尤宜于治疗血瘀头痛，以及病久入络的头风。<br>（《景岳全书》）<br>【配方】当归30克，好酒一升。<br>【制法】将上药同酒煎取600毫升即成。<br>【主治】血虚夹瘀所致的头痛，其痛如细筋牵扯引或针刺，痛连眼角，午后尤甚，兼双目发涩，心悸怔忡，面色萎黄，眩晕等症，舌质色淡可有瘀点。<br>【用法】适量饮用。
当归酒（七）	当归酒（七）――（痿证）<br>（《本草纲目》）<br>【配方】当归1000克，曲适量。<br>【制法】将归入砂锅内加水5000毫升煎煮，待煎至3500毫升，出锅待冷；再将曲压成细末，放入汁内搅匀，注入坛内密封，注意周围保温，令发酵，10日后可服用。<br>【主治】筋痿，各种疼痛，月经不调。<br>【用法】每服20毫升，日服2次，可据酒量酌饮。
当归酒（三）	当归酒（三）――（流产）<br><br>（《普济方》）<br>【配方】当归（炙令香、v），芍药（v炒）各二两。<br>【制法】上口父咀，每服三钱整，以无灰酒一盏，入生地黄汁一合，于银器内，慢火煎至七分去滓。<br>【主治】治妊娠堕胎后血不止。<br>【用法】温服，以恶血下为度。
当归酒（四）	当归酒（四）――（筋骨诸病）<br>（《本草纲目》）<br>【配方】当归。<br>【制法】上药煎汁，或酿或浸，并如常法（酿、浸法见“牛膝酒”下。）<br>【主治】和血脉，坚筋骨、止诸痛，调经水。<br>【用法】饮用。<br>说明：本方见《本草纲目》卷二十五附诸药酒下。
当归酒（五）	当归酒（五）――（痿证）<br>痿证是指肢体筋脉驰缓，手足痿软无力的一种病证。多因热病伤阴，筋脉失养；或湿热浸淫筋脉肌肉；或肝肾亏耗，精血不足；或瘀血阻滞脉络等原因造成。根据其临床表现，又有皮痿、肉痿、筋痿、脉痿、骨痿等不同。<br>治疗痿证的药酒，有以活血化瘀通络为主者，如当归酒；有以祛风散湿为主者，如五加皮酒、海桐酒；有以滋补肝肾为主者，如虎鹿二仙酒；有以滋阴凉血阴火为主者，如枸杞根酒等，临床可根据痿证的临床表现分别选用。<br>（《本草纲目》）<br>【配方】当归150克，白酒3斤。<br>【制法】将归入酒内浸泡，10日后服用。<br>【主治】筋骨痿弱，疼痛，月经不调。<br>【用法】每服10-20毫升，日服2次。
当归酒（一）	当归酒（一）――（痈疽、疮疡、发背）<br>（《普济方》）<br>【配方】辣桂（去粗皮）半两，当归四钱。木香、白芷各二分。<br>【制法】上细v，每服三钱半，以醇酒一蛊，慢火煎七分，入乳香末半钱。<br>【主治】治痈疽阴证，头平向内，沉黯不痛，浑身患处不热。<br>【用法】不饥饱温服。以排脓散、加味千金正气散为佐；以米铺<br>蹄臀肉为养；乔麦面能发起，可煮食之。如更不发起，用局方姜附汤、当归、木香、炙甘草煎服之；更不发起，用穿山甲（头截片蘸醋炒焦）、人生牙（煅留性）各一分，上为末，分作两服，用辣桂、当归、去节麻黄煎酒，食前调下。患处用生姜斗和面厚涂，或用川乌、硫黄、人牙煅，并细末，酒调敷之。
当归酒方	当归酒方――（背强口噤）<br>（《圣济总录》）<br>【配方】当归、细辛（去苗叶）、防风（去叉）各一两半，麻黄（去根节煎掠去沫焙）二两半，独活（去芦头）三两，附子（炮裂去皮脐）四杖。<br>【制法】上六味，v如麻豆，以酒三升，煮取二升去滓。<br>【主治】中风身如角弓反张。<br>【用法】食前每温服一盏。
当归肉桂酒	当归肉桂酒――（经行后期）<br><br>经行后期又称“经迟”。是指每月经期延后六、七天以上，多至四十、五十天。其病因主要有血虚、虚寒、痰阻、气滞血瘀、肝气郁结等。一般以冲任血虚或虚寒多见。虚证多伴有腹痛绵绵喜按，经血色淡、量少、质稀者为血虚；经色不鲜、或黑而量少、质清冷者为虚寒。痰阻所致可见经色淡而粘，带下连绵，伴心悸头眩。经行不畅，少腹胀痛，痛引腰或乳房胀痛者，属气郁气滞证。经色紫暗，血块多，下腹疼痛拒按，或可扪及包块者，属瘀血证。以下介绍治疗本病的三种药酒，可根据情况辨证选用。<br>（《陕甘宁青中草药选》）<br>【配方】当归1两，肉桂2钱，甜酒1斤。<br>【制法】将归、桂浸入酒内6-7日服用。<br>【主治】月经错后。<br>【用法】每服1-2两，每日1-3次。
当归松叶酒	当归松叶酒――（关节疼痛）<br>（验方）<br>【配方】新松叶（切碎洗净漉干）１公斤，当归150克，清酒2.5公斤。<br>【制法】将上药入净器中，用酒浸之，41天之后即可开封饮用。<br>【主治】关节疼痛，肢体不遂。<br>【用法】随量饮用。
当归元胡酒	当归元胡酒――（痛经）<br><br>痛经又称“经行腹痛”，是月经前、后或行经时，以下腹及腰部为主症的一种病症。导致本病的原因可有气滞、血瘀、寒凝、气虚等不同。经前下腹痛，痛连胁肋，或兼见乳胀者，多因气滞所致；经前或月经刚来时，少腹刺痛拒按，经色紫暗，或有瘀块者，多因血瘀所致；下腹冷痛或绞痛，热熨则痛减，经行不畅，色暗滞者，多因寒凝所致；行经过后腹部及腰部绵痛，喜按，月经量少，色淡而稀等，多因气虚所致。治疗原则以行气、活血、温经、益气为主。以下有6种药酒，可根据不同情况而用之。<br>（《儒门事亲》）<br>【配方】当归、元胡、制没药、红花各15克，白酒1公斤。<br>【制法】将上药共捣碎，白夏布包，用酒浸泡于净器中，1周后即可取用。<br>【主治】月经欲来，腹中胀痛。<br>【用法】每日早、晚各空心温饮1杯。
党参酒	党参酒――（下痢泄泻）<br>（验方）<br>【配方】老条党参1只，酒0.5公斤。<br>【制法】党参选用粗大者连须，将其拍出裂缝，置于净瓶中，注酒浸之，封口7日后取用。<br>【主治】脾虚泄泻肢冷，四肢无力，食欲不佳；肺虚气喘息短，声音低微，懒言短气；血虚痿黄，头晕心慌；热性病津夜耗伤，口渴。<br>【用法】随量饮之，佐膳更佳。添尽再添，味薄后取参食之。<br>说明：表证未解，中满邪实者勿用。
地黄酒（六）	地黄酒（六）――（失眠）<br>失眠古称“不得眠”、“目不瞑”、“不得卧”、“不寐”等，常由七情所伤、心脾两虚、痰热内扰、胃气不和、血虚肝旺、心虚胆祛及外感邪热等造成。<br>治疗本病的药酒，多适用于虚证为主者，若以肝肾不足为主者，可选用地黄酒，五味子酒；若以心脾两虚为主者，可选用桂圆酒等。<br>（《惠直堂经验方》）<br>【配方】熟地240克，枸杞子、制首乌、薏苡仁各120克，当归90克，白檀香9克（或沉香末3克），龙眼肉90克，陈酒15公斤。<br>【制法】将陈酒注入坛中；上药捣碎装入绢袋，浸于酒中，10天后即可饮用。<br>【主治】失眠症，其表现是经常性的睡眠困难，该入睡时，难以入睡，或睡中易醒，睡后无清新感，精神不振，有的甚至通宵不能成寐。<br>【用法】每次饮3毫升，临睡前温服，不宜多饮。
地黄酒（三）	地黄酒（三）――（妊娠出血）<br><br>（《普济方》）<br>【配方】生地黄（切）一升。<br>【制法】以酒五升，煮取三升。<br>【主治】治胎漏下血不止，血尽子死方。亦治妊娠腹中痛。亦治落身后血。<br>【用法】分三服。一方用生地黄汁同酒煮服。或为末酒服，亦可。<br>说明：本方在《普济方》凡见两处，均注出“千金方”。
地黄酒（十）	地黄酒（十）――（产后防病）<br><br>（《备急千金要方》）<br>【配方】地黄汁一升，好曲一斗，好米二升。<br>【制法】上三味，先以地黄汁渍曲令发，家法酝之，至熟，封七日。<br>【主治】治产后百病，未产前一月，当预，酿之。产讫蓐中服之方。<br>【用法】取清服之，常使酒气相接，勿令断绝，慎蒜生冷酢滑猪鸡鱼。一切妇人皆须服之，但夏三月热不可合，春秋冬并得合服地黄，并滓内米中炊合用之，一石石石一准此一升为率。先服羊当归汤三剂，乃服之佳。<br>说明：《妇人大全良方》、《普济方》一方同上。
地黄酒（四）	地黄酒（四）――（妊娠出血）<br><br>（《妇人大全良方》）<br>【配方】生地黄（切）一升。<br>【制法】上以酒四升，煮取二升。<br>【主治】疗妊娠卒下血及子淋，亦疗落身后血。<br>【用法】分温三服。
地黄酒（五）	地黄酒（五）――（关节疼痛）<br>（《山居备用》）<br>【配方】生地黄（切）100克，大豆（炒）200克，生蒡根（切）100克，酒2公斤。<br>【制法】将上药共置于瓶中，用酒浸5日。<br>【主治】肾虚，心烦，关节疼痛。<br>【用法】随量饮之，不拘时候。
地黄酒方（八）	地黄酒方（八）――（跌打损伤）<br>（《圣济总录》）<br>【配方】生地黄汁半升，酒一升，桃仁（去皮尖双仁炒），牡丹（去心），桂（去粗皮）各一两。<br>【制法】上五味，以后三味，捣罗为细末，与前二味一处煎熟，去滓。<br>【主治】治伤损瘀血在腹。<br>【用法】温饮一盏，不拘时。<br>说明：《普济方》同上。
地黄酒方（二）	地黄酒方（二）――（补益增白）<br>（《太平圣惠方》）<br>【配方】肥地黄一杵（捣碎），糯米（熟饮）五斗，面曲（捣碎）五斤。<br>【制法】上二味相和，于盆中熟捣，纳于不津瓮中，密封，春夏三七日，秋冬五七日，日满启之，当中有一盏绿汁，是其精也，宜先酌饮之。余以生布绞汁，置器中。<br>【主治】补益变白。<br>【用法】任性饮之，续酿使之相接，不过三剂，发黑，若以新牛膝捣绞，取汁三升，用拌，即变白更急矣。<br>说明：①《普济方》同上。②《本草纲目》卷二十五诸药酒条载“地黄酒”，用生肥地黄汁，同曲、米封密器中，春夏三七日，秋冬五七日启之，中有绿汁，真精英也，宜先饮之，乃滤汁藏贮。加牛膝汁效更速，亦有加群药者。补虚弱，壮筋骨，通血脉，治腹痛，变白发。
地黄酒方（九）	地黄酒方（九）――（产后出血）<br><br>（《普济方》）<br>【配方】生地黄汁半小盏，益母草半小盏。<br>【制法】上酒一小盏相合，煎至三五沸，分为三服。<br>【主治】治产后崩中下血不止，心神烦乱。<br>【用法】频频服之，效。<br>说明：《普济方》注出“圣惠方”。
地黄酒方（六）	地黄酒方（六）――（跌打损伤）<br>（《圣济总录》）<br>【配方】生地黄（洗切研）八两，酒三升。<br>【制法】上二味，共煎数沸，去滓。<br>【主治】治倒仆，诸筋蹴损。<br>【用法】每服一盏温服，不拘时候。<br>说明：《普济方》注”出肘后方“。谓本方”治倒仆筋蹴，不得舒展，及瘀血不散。亦疗马坠“。余同上。
地黄酒方（七）	地黄酒方（七）――（胎死腹中）<br><br>（《圣济总录》）<br>【配方】生地黄（净洗切）二斤。<br>【制法】上一味，捣取自然汁，每服用七分盏，酒三分盏②，同煎才沸。<br>【主治】治妊娠因漏血伤胎，子死未久①。<br>【用法】稍热便服三二服，未下再服。<br>说明：《普济方》①“子死未久”作“子死未下”；②“每服用七盏，酒三分盏”，作“每服用七分酒，三分水同煎”。余同上。
地黄酒方（三）	地黄酒方（三）――（产后防病）<br><br>（《圣济总录》）<br>【配方】生地黄汁二升，清酒三升，生姜汁二合。<br>【制法】上三味，煮地黄四五沸，入姜酒，更煎三沸。<br>【主治】产后服豆酒已，再服，防百病。<br>【用法】任性细细饮，冷多加桂末二两，热多加生藕汁二合。<br>说明：《普济方》同上。
地黄酒方（十）	地黄酒方（十）――（腰脚疼痛诸病）<br>（《太平圣惠方》）<br>【配方】生干地黄（细切）一斤，白杨树皮（v）半斤，生姜（切碎炒熟）二两，大豆（炒令熟）半斤。<br>【制法】上诸药，用绢袋盛，以清酒一豆+斗，于瓷瓶中浸，密封，经七日开。<br>【主治】腰脚疼痛。<br>【用法】每于食前，温一小盏服。<br>说明：《普济方》同上。
地黄酒方（四）	地黄酒方（四）――（流产）<br><br>（《圣济总录》）<br>【配方】生地黄（以铜竹刀切、炒）半两，蒲黄（炒）、生姜（切炒）各一分。<br>【制法】上三味，以无灰酒三盏，于银器内，同煎至二盏，去滓。<br>【主治】治妊娠坠胎，胞衣不出。<br>【用法】分温三服，未下更服。<br>说明：《普济方》蒲黄、生姜各用一钱，余同上。
地黄酒方（五）	地黄酒方（五）――（跌打损伤）<br>（《圣济总录》）<br>【配方】生地黄汁一升，酒一升，桃仁（去皮尖别研膏）一两。<br>【制法】上三味，先将地黄汁并酒，煎令沸，下桃仁膏，再煎数沸。<br>【主治】治倒仆蹴损筋脉。<br>【用法】每服一盏温服，不拘时候。
地黄汁酒	地黄汁酒――（筋骨诸病）<br>（《备急千金要方》）<br>【配方】地黄汁一石，酒二斗。<br>【制法】将上药与酒相搅，重煎。<br>【主治】骨髓中冷痛。<br>【用法】温服，每日3次。<br>说明：《圣济总录》名“地黄酒”，生地黄（洗切》一石，本臼捣取自然汁，绞去滓，用酒二斗和匀，同于瓷石器中，煎熟为度，瓷器盛贮。每服温饮一盏，不拘时候。治骨髓虚冷痛。
地黄煮酒	地黄煮酒――（产后瘀血）<br><br>（验方）<br>【配方】生地黄6克，益母草10克，黄酒200毫升。<br>【制法】把黄酒倒入瓷杯中，再加生地黄、益母草，把瓷杯放在有水的蒸锅中加热蒸炖20分钟。<br>【主治】产后痫血性出血。<br>【用法】每次温饮50毫升，每日2次。
地龙酒	地龙酒--（小儿痘疹）<br>（验方）<br>【配方】地龙（去泥洗净）5条，乌芋20克。<br>【制法】将上药拌绞取汁，同适量酒和合，煎数沸，去温候温。<br>【主治】出疹血热毒盛，黑陷不起。<br>【用法】顿服。<br>说明：乌芋即荸荠。
地榆菖蒲酒	地榆菖蒲酒――（产后出血）<br><br>（验方）<br>【配方】菖蒲20克，地榆50克，当归40克，黄酒500毫升。<br>【制法】将上药捣为细末，同酒煎取1杯去渣。<br>【主治】产后血崩。<br>【用法】食前分3次温饮。
地榆附子浸酒方	地榆附子浸酒方――（下痢泄泻）<br>（《普济方》）<br>【配方】天地榆一斤，附子一两。<br>【制法】以上酒一斗渍五宿。<br>【主治】疗休息痢。<br>【用法】饮一升，日三，服尽更作，忌猪肉、冷水。<br>说明：方名为笔者所加。
地榆酒	地榆酒――（月经过多）<br><br>（重庆《祖国医学采风录》第1集）<br>【配方】地榆62克，甜酒适量。<br>【制法】将地榆研成细末，用甜酒煎服。<br>【主治】月经过多，或过期不止，经色深红或紫红，质地粘稠有块，腰腹胀痛，心烦口渴，面红唇干，小便短赤，舌质红，苔黄，脉滑数。<br>【用法】每次6克。
调经酒	调经酒――（痛经）<br><br>（验方）<br>【配方】当归、川芎、吴茱萸各120克，炒白芍、白茯苓、陈皮、元胡、丹皮各90克、熟地、醋香附各180克，小茴香、砂仁各60克，烧酒15公斤，黄酒10公斤。<br>【制法】将上药用绢袋盛之，浸入酒中，容器封固，隔水加热1.5小时后，放凉，再浸数日即可饮用。<br>【主治】气滞血涩、夹有寒邪所致的经行腹胀疼痛，经血量少、色黯有块，以及月经不调等症。<br>【用法】适量饮用，每天2次。
跌打损伤药酒	跌打损伤药酒――（跌打损伤）<br>（伤科汇篡》）<br>【配方】当归、生地、五加皮各30克，破故纸、紫荆皮、十大功劳、猴姜、薏苡仁、广木香、羌活、莪术、桃仁、川芎、桂仲各24克，虎骨（酥炙）36克，好酒10公斤。<br>【制法】将上药浸于酒中，容器封固，隔水加热约1.5小时，取出后静置数日，压榨过滤后即可饮用。<br>【主治】跌打损伤，包括打扑、殴打、闪压、运动损伤等。<br>【用法】每次服0.5～1两。<br>说明：如伤情复杂，严重时，应采取相应措施，此酒只是起到辅助治疗作用。也适用于风湿性筋骨疼痛等症。
跌打万应药酒	跌打万应药酒――（跌打损伤）<br>（验方）<br>【配方】田七、羌活、独活、续断、三棱、莪术、红花、归尾、生地、五加皮各6克，木瓜4.5克，桂枝6克，苏木4.5克，香附、沉香各6克，木香、乳香各4.5克，骨碎补6克，没药4.5克，牛膝、杜仲、破故纸、青皮、枳壳、首乌各6克，白茯苓、熟地、炙黄芪、酒白芍各9克，白术4.5克，枸杞子6克，川芎4.5克，虎骨、鹿筋各15克，远志、乌枣各6克，乌豆500克，龙眼肉120克，白酒5公斤，黄酒适量。<br>【制法】将上药用黄酒拌、闷润，将酒吸尽后，蒸透，浸于白酒中1个月，取澄清酒液饮用。<br>【主治】跌打损伤，肿胀疼痛。<br>【用法】适量饮用，如果平素体质尚好，受伤后正气损伤不重，虚象不显著的，饮量宜少；阴虚火旺者应慎服。
丁香山楂煮酒	丁香山楂煮酒――（腹胀腹痛）<br>腹胀是指腹部胀满；腹痛是指胃脘以下，耻骨毛际以上部位发生疼痛；二者有时可同时存在。腹胀属虚者多因脾胃虚弱，脾阳失运所致；属实者多因热结肠胃所致。腹痛常因感受六淫之邪，虫积、食滞所伤，气滞血瘀，或气血亏虚，经脉失荣等引起。<br>治疗本病的药酒，常用吴茱萸、丁香、附子、肉桂、姜、豆蔻等药配成，多用于寒性腹痛腹胀，如茱萸酒、丁香煮酒、红茅药酒等。寒实内结，胀满疼痛俱重者，在配制药酒时，又常加用除积导滞之品，如屠苏酒、秦艽酒等，在使用时须加以注意。<br>（验方）<br>【配方】黄酒50毫升,丁香2粒,山楂6克。<br>【制法】把黄酒放在瓷杯中,再加入丁香,把瓷杯放在有水的蒸锅中加热蒸炖10分钟,趁热饮酒。<br>【主治】可用于感寒腹痛、腹胀、吐泻等症。<br>【用法】饮服。
丁香煮酒	丁香煮酒――（腹胀腹痛）<br>（验方）<br>【配方】黄酒50毫升，丁香2粒。<br>【制法】把黄酒放在瓷杯中，再加入丁香，把瓷杯放在有水的蒸锅中加热蒸炖10分钟。<br>【主治】感寒腹疼，腹胀，吐泻。<br>【用法】趁热饮酒。
豆豉酒	豆豉酒――（乳病）<br>（《普济方》）<br>【配方】醇酒二升，豉五合。<br>【制法】上同煮沸，热澄清。<br>【主治】治乳石发动，诸药不治。<br>【用法】旋饮一盏。
豆淋独活酒	豆淋独活酒――（产后风痉）<br><br>（《普济方》）<br>【配方】黑豆半斤（净），独活半两（切碎）。<br>【制法】上于铁铫中炒黑豆令焦黑，候烟起，以无灰好酒二升沃之，安瓷器中，每用酒一盏，去豆入独活同煎，约至八分。一方炒黑豆令焦，一方无独活，以豆淋酒调荆芥妙。<br>【主治】治产后中风，形如角弓反张，口噤涎潮，烦热身重，呕吐直视，一名独活紫汤。<br>【用法】去滓温服，日进无时，以差为度。或卒中未有独活，止连服前豆淋酒亦效，莫如加独活效速，凡产后服黑神散，皆宜以豆淋酒调服，活血祛风，最为要药，妊娠折伤胎死，服此得瘥。
豆淋酒（一）	豆淋酒（一）――（崩漏）<br><br>（《普济方》）<br>【配方】大豆（炒）三升。<br>【制法】上药炒令焦，以酒三升，淋取汁。<br>【主治】治月水不断。<br>【用法】顿服。
豆淋酒（二）	豆淋酒（二）――（中风）<br>（《本草纲目》）<br>【配方】黑豆（炒焦）。<br>【制法】上以酒淋之。<br>【主治】破血去风，治男子中风口?，阴毒腹痛及小便尿血，妇人产后一切中风诸病。<br>【用法】温饮。<br>说明：本方见《本草纲目》卷二十五附诸药酒条下。
豆淋酒方	豆淋酒方――（破伤风）<br>（《圣济总录》）<br>【配方】大豆（炒去腥半熟勿使太热）五升。<br>【制法】上一味，粗捣筛，蒸一馈顷，倾出盆中，以酒一斗五升淋之，绞去滓。<br>【主治】治金刃伤破见骨，中风口噤。<br>【用法】每温服五合至七合，日二夜一，衣复微汗出，别研生杏仁膏，傅于疮上，若脑髓出者难救。<br>说明：《普济方》同上。
读书丸酒	读书丸酒<br>【来源】《经验方》<br>【原料】远志、熟地、菟丝子、五味子各36克，石菖蒲、川芎各24克，地骨皮48克，白酒1200克。<br>【制作】将上药加工粗碎，装入细纱布袋扎紧口，放入坛内，倒入白酒，加盖封固，置阴凉处，经常摇动。7天后开封过滤即可。<br>【功效】补益心肾，益智健脑。适用于健忘，注意力不集中，失眠多梦，心悸怔忡，头昏目眩，耳鸣，腰膝酸软等症。<br>【用法】早、晚各一次，每次15―30毫升。
独活大豆酒	独活大豆酒――（中风）<br>（验方）<br>【配方】独活60克，大豆30克，酒1公斤。<br>【制法】将独活用酒渍之，并煎取0.5公斤，别炒大豆热投酒中，2小时后去渣即得。<br>【主治】中风舌强不语。<br>【用法】每次饭前温服20毫升。
独活当归酒	独活当归酒――（腰脚疼痛诸病）<br>（《圣济总录》）<br>【配方】独活，杜仲、当归、川芎、熟地、丹参各30克，好酒1公斤。<br>【制法】将上药碎细，用酒浸于净瓶中，密封，近火煨，1日夜后候冷即可饮用。<br>【主治】风湿性腰腿疼痛。<br>【用法】随量，不拘时候温饮，常令有酒气。
独活寄生酒	独活寄生酒――（痹证）<br>（《经验方》）<br>【配方】独活30克，桑寄生20克，秦艽30克，防风20克，细辛12克，当归50克，白芍30克，川芎20克，生地、杜仲各50克，牛膝、党参各30克，茯苓40克，甘草、肉桂各15克，醇酒1.5公斤。<br>【制法】将上药捣碎，用酒浸于净瓶中，密封口，14日后开封，去渣备用。<br>【主治】风寒湿痹，关节疼痛，屈伸不利，腰膝酸痛，肢体麻木，阴雨加重。<br>【用法】随量饮用，不拘时候。
独活浸酒方（二）	独活浸酒方（二）――（半身不遂）<br>（《太平圣惠方》）<br>【配方】独活一两，桂心一两，防风（去芦头）一两，附子（炮裂去皮脐）一两，大麻仁二合，牛膝一两，川椒（去目及闲口者微炒去汗）二两，天蓼木（v）二两。<br>【制法】上诸药，都细v，以生绢袋盛，以酒一豆＋斗，密封头，浸三日后开。<br>【主治】中风，偏枯不遂，骨节冷痛。<br>【用法】每日食前及临卧时，酒一中盏饮之，以药力尽为度，患者不过三两剂必效。
独活浸酒方（三）	独活浸酒方（三）――（脚气）<br>（《圣济总录》）<br>【配方】独活（去芦头）、生干地黄（焙）各三两，生黑豆皮一大升，海桐皮二两，生恶实根一斤，桂（去粗皮）一两，大麻子仁（炒）一升。<br>【制法】上七味，v如黑豆粒大，以生绢袋盛，用无灰酒三斗，同内瓷壅中浸之，冬七日，夏三日，春秋五日。<br>【主治】治岭南脚气发幼，地气郁蒸，热毒风盛，脾肺常有虚热。<br>【用法】不限早晚，随意饮之，常令有酒气，酒尽更添，药无味即再作。<br>说明：《普济方》谓主治“岭南热毒风盛，湿气郁蒸，脚气发动，脾肺常有虚热，心神烦闷，脚膝酸痛”。余同上。
独活浸酒方（一）	独活浸酒方（一）――（痹证）<br>（《太平圣惠方》<br>【配方】独活、石南各四两，防风（去芦头）三两，茵芋、附子（炮裂去皮脐）、川乌头（炮裂去皮脐）、天雄（炮裂去皮脐）、桂心、牛膝（去苗）各一两。<br>【制法】上件药，细v，以生绢袋盛，用好酒二斗渍经七日。<br>【主治】八风十二<br>【用法】每日随性温饮一小盏，勿令大醉，以效为度。<br>说明：《普济方》同上。
独活酒（八）	独活酒（八）――（小儿痫证）<br>《千金要方》说：“小儿之痫有三种，有风痫、有惊痫、有食痫”。风痫多由于将养失度，血气不和，或厚衣汗出，腠理开舒，风邪因入所致，其病在肝，可见面红、目青、发搐；惊痫即泛指小儿惊风、痫证一类的病证，多起于惊怖而发作，可表现为周身热面赤，睡眠不安，惊惕上窜，甚或上视身强，手足拳，发搐，口吐白沫；食痫多因伤食而发病，其症见初起面黄、腹泻、呕吐、下利酸臭，时时抽搐。以下收载治疗小儿风痫药酒3种，治惊痫药酒一种，供选用。<br>（《普济方》）<br>【配方】独活、甘草、木防己各四分，干姜、细辛各五分，鸱头一枚许，桂心二两，铁精一两，人参三钱。<br>【制法】上入绢袋中，酒四升半，浸五夜。<br>【主治】治小儿风痫，屡经发动。<br>【用法】初服半合，日二服。
独活酒（二）	独活酒（二）――（痹证）<br>（《肘后备急方》）<br>【配方】独活、附子（生用、切）各五两。<br>【制法】以酒一斗渍经三宿。<br>【主治】风毒脚弱痹满上气。<br>【用法】服从一合始，以微痹为度。<br>说明：《普济方》同上。
独活酒（六）	独活酒（六）――（牙痛）<br>（《普济方》）<br>【配方】独活、莽草、细辛各半两，附子、防风各半两。<br>【制法】上细v，以酒一升半，煎至一升。一方无防风。<br>【主治】治风牙齿疼痛。<br>【用法】热漱冷吐。
独活酒（三）	独活酒（三）――（背强口噤）<br>（《奇效良方》）<br>【配方】独活（去芦）四两，好酒四大盏。<br>【制法】用酒煎药。<br>【主治】中风通身冷，口噤不知人者。<br>【用法】分二三次热服。
独活酒（五）	独活酒（五）――（产后风痉）<br><br>（《普济方》）<br>【配方】羌活三两，防风三两，大乌豆（炒令拆）一升。<br>【制法】上以酒五升，先渍二味，经宿，大豆乘热投中搅匀，密封二日，以汤煮瓶，良久。<br>【主治】治产后中风，四肢麻痹不仁，或角弓反张，并口噤。<br>【用法】服八合，覆衣取汗，速以豆淋酒服之。
独活酒（一）	独活酒（一）――（痹证）<br>（《备急千金要方》）<br>【配方】独活、石南各四两，附风三两，附子、乌头、天雄、茵芋各二两。<br>【制法】上七味口父咀，以酒二斗渍七日。<br>【主治】八风十二痹。<br>【用法】服半合，日三，以知为度。<br>说明：《千金翼方》载本方，“上七味切，以酒二斗渍六日”；“先食服，一服半合，以知为度”。余皆同上。
独活酒方（八）	独活酒方（八）――（痹证）<br>（《圣济总录》）<br>【配方】独活（去芦头）半两，杜仲（去粗皮）一两，当归（切焙）、川芎、熟干地黄（焙）各一两半，丹参一两。<br>【制法】上六味，细v，用好酒五升，于净瓶内浸密封，重汤煮两时许，取出候冷。<br>【主治】风湿腰痛　痹。<br>【用法】旋暖不拘时饮之，常令微醉。
独活酒方（二）	独活酒方（二）――（背强口噤）<br>（《圣济总录》）<br>【配方】独活（去芦头）一两。<br>【制法】上一味，v。以清酒二升，煎取一升，取大豆五合，熬令皮拆色粱鹭本，取前酒热投于豆中，搅匀密盖，经一食顷，去滓。<br>【主治】中风口噤不开。<br>【用法】温服三大合，口噤即灌之，日三。<br>说明：又方治中风舌强不语，余同上。
独活酒方（六）	独活酒方（六）――（产后风痉）<br><br>（《圣济总录》）<br>【配方】独活（去芦头细v）二两，大豆一升。<br>【制法】上二味，用酒五升，浸独活一宿，次将大豆，炒令青烟出，投酒中封闭，候冷去滓。<br>【主治】产后血气不足，中风口禁。<br>【用法】每温服一盏。
独活酒方（七）	独活酒方（七）――（脚气）<br>（《太平圣惠方》）<br>【配方】独活（去芦头）、附子（炮裂去皮脐）各二两半。<br>【制法】上二味，v如麻豆大，盛以绢袋，内瓷瓶中，以醇酒五升浸密封，三日后旋取。<br>【主治】治脚气久虚，脉沉细缓弱。<br>【用法】从一合饮之，加至半盏，长令体中酒气相接，未效再服，以瘥为度。<br>说明：《普济方》同上。
独活酒方（三）	独活酒方（三）――（脚气）<br>（《圣济总录》）<br>【配方】独活（去芦头）、山茱萸、天门冬（去心焙）、黄芪、甘菊花、防风（去叉）、天雄（炮裂去皮脐）、侧子（炮裂去皮脐）、防己、白术、赤茯苓（去黑皮）、牛膝、枸杞子（焙）各三两，生地黄七两。<br>【制法】上一十七味，口父咀如麻豆，生绢袋盛，以无灰酒五斗，浸七日。<br>【主治】治脚气痰壅，头痛喘闷，胸膈心背痛。<br>【用法】开封初饮三两合，渐加、常令酒力相接。<br>说明：《普济方》同上。
独活酒方（四）	独活酒方（四）――（痿证）<br>（《圣济总录》）<br>【配方】独活（去芦头）一斤，金牙细辛(去苗叶）、地肤子、莽草、熟干地黄（切焙）、蒴根、防风（去叉）、附子（炮裂去皮脐）、续断、蜀椒（去目并闭口炒出汗）各四两。<br>【制法】上一十一味，除金牙外，并细v，盛以绢囊，清酒五升渍之，密泥器口，夏三宿，冬五宿酒成。其金牙别捣为末，别以练囊盛，内大囊中。<br>【主治】肉苛肌肉不仁，遍身　重。<br>【用法】温二合服，日三渐增之。
独活酒方（五）	独活酒方（五）――（半身不遂）<br>（《圣济总录》）<br>【配方】独活（去芦头）三两，大豆一升（紧小者炒熟）。<br>【制法】上二味，粗捣筛，以清酒五升，煎十余沸去滓。<br>【主治】偏风一边不遂，口眼?斜。<br>【用法】每服饮五合至一升，日二夜一。
独活酒方（一）	独活酒方（一）――（产后中风）<br><br>（《备急千金要方》）<br>【配方】独活一斤，桂心三两，秦艽五两。<br>【制法】上三味口父咀，以酒一斗半，渍三日。<br>【主治】产后中风。<br>【用法】饮五合，稍加至一升，不能多饮，随性服。<br>说明：《普济方》、《太平圣惠方》同上。
独活牛膝酒	独活牛膝酒――（半身不遂）<br>（《太平圣惠方》）<br>【配方】独活、肉桂、防风、制附子各30克，大麻仁（炒香）50克，牛膝30克，川椒（去目及闭口者炒出汗）50克，烟1.5公斤。<br>【制法】将上药捣细，用净器盛，以酒渍之，密封口，3日后开取，去渣备用。<br>【主治】中风半身不遂，骨节疼痛。<br>【用法】每日饭前及临睡时，暖1中杯饮之，以药力尽为度，不过2、3剂则愈。
独活人参酒	独活人参酒――（产后中风）<br><br>（《太平圣惠方》）<br>【配方】独活（去芦）45克，白鲜皮15克，羌活（去芦头）30克，人参20克。<br>【制法】将上药捣为粗末，每用10克药末，同水7份，酒3份，煎至7份，去渣待温。<br>【主治】产后中风，困乏多汗，体热头痛。<br>【用法】温服，不拘时候。
独活石斛酒	独活石斛酒――（腰脚疼痛诸病）<br>（《太平圣惠方》）<br>【配方】独活40克，炮姜20克，石斛、牛膝、丹参、萆、制附子、赤茯苓各30克，防风20克，薏苡仁40克，山茱萸30克，肉桂、白术、川芎各20克，秦艽30克，当归、人参、甘菊花各20克，生地40克，酒2.5公斤。<br>【制法】将上药捣碎，用酒浸于净器中，7日后开取去渣备用。<br>【主治】感受风湿，腰脚酸痛，行走艰难，头晕目眩。<br>【用法】每次饭前随量温饮。
杜仲酒（三）	杜仲酒（三）――（腰脚疼痛诸病）<br>（《千金翼方》）<br>【配方】杜仲（炙）八两，羌活四两，石南二两，大附子（去皮）三枚。<br>【制法】上四味，切，以酒一斗渍三宿。<br>【主治】腰脚疼痛不遂，风虚。<br>【用法】服二合，日再。<br>说明：①《备急千金要方》方中大附子为五枚，余同上。②《普济方》与《备急千金要方》同。
杜仲酒（五）	杜仲酒（五）――（产后虚损）<br><br>（《普济方》）<br>【配方】杜仲（去粗皮炙微黄v）二两，桂心、丹参、当归、子、芎、牛膝（去苗）、桑寄生、附子（炮裂去皮脐）、熟干地黄（v）各一两，川椒（去闭口及目微炒）半两。<br>【制法】上细v，以生绢袋盛，用好酒一斗，瓷瓶中浸，经七日，密封后开取。<br>【主治】治产后脏虚，腰间疼痛，肢节不利。<br>【用法】每日空心及午食前，温饮一盏。
对虾酒	对虾酒――（阳萎）<br>（《偏方大全》）<br>【配方】新鲜大虾1对，白酒（60度）250毫升。<br>【制法】将虾洗净，置于瓷罐中，加酒浸泡并密封，约10天后即成。<br>【主治】性机能减退，阳萎，遗精等。<br>【用法】每日随量饮酒或佐餐，待酒尽后，将是烹炒食用。
恶实根酒方	恶实根酒方――（赤游风）<br>（《圣济总录》）<br>【配方】恶实根（洗去土控干），生蒴根（洗去土控干）各一斤。<br>【制法】上二味，细v，以酒一斗浸七日。<br>【主治】治刺风游风。<br>【用法】每温饮一盏，日三四饮。
恶实酒方	恶实酒方――（脚气）<br>（《圣济总录》）<br>【配方】恶实根（细切）半斤，枳壳（去瓤）四两，生地黄（切）一升，小黑豆半斤。<br>【制法】上八味，粗捣筛，以绢袋盛，无灰酒二斗浸三日。<br>【主治】治脚气肿满生疮，积年不差，或饮酒壅滞，散在腠理，及风痒疥癣，毒气下注，轻腰脚，通肠胃，去肺中热毒。<br>【用法】任性多少下后漏芦丸，更以后白敛汤洗之。<br>说明：用法用所云漏芦丸及白敛汤方如下。①漏芦丸方：漏芦，萎蕤（切焙），乌蛇（酒浸去皮骨炙）各三两，苦参四两，枳壳（去瓤麸炒）二两，秦艽（去苗土），麦门冬（去心焙）各一两半，防己一两，玄参三两白术，黄芪（v）各一两半，大黄（v炒）三两，黄芩（去黑心）一两。上一十三味，捣罗为末，炼蜜为丸，如梧桐子大，每服三十丸，至四十丸。②白敛汤洗方：白敛三两半，漏芦（切），槐白皮（切），蒺藜子（炒去角），五加皮（切）各半斤，甘草（v）一两。上六味，粗捣筛，以水一斗，煮取六升，内芒硝半升，如疮痒不拘时洗，其汤旋暖温用。
二冬二地酒	二冬二地酒――（阳萎）<br>（验方）<br>【配方】菟丝子、肉苁蓉各120克，天门冬、麦门冬、生地、熟地、山药、牛膝、杜仲（姜汁炒）、巴戟天（去心）、枸杞子、山茱萸、人参、白茯苓、五味子、木香、柏子仁各60克，覆盆子、车前子、地骨皮各45克，石菖蒲、川椒、远志肉、泽泻各30克，好酒3公斤。<br>【制法】将上药共捣为粗末，用夏白布包贮，置于净器中，用酒浸泡7-12日后即可饮用。<br>【主治】肾虚精亏，中年阳萎，老人视物昏花，神志恍惚，腰降酸软。<br>【用法】每空心服1小杯，早、晚各1次。
二活川芎酒	二活川芎酒<br>【来源】《圣济总录》<br>【原料】羌活15克，独活15克，川芎20克，黑豆30克，大麻仁30克，米酒200毫升。<br>【制作】将上药精加工，捣碎为末，置净瓶中，入酒浸泡，密封21日后开启，过滤去渣留溶剂化物备用。<br>【功效】祛风，活血，解痉。中风初得，颈项强直，肩背酸痛，肢体拘急，时有恶风，发热。<br>【用法】每日早、晚各1次，每次饮服10-25毫升。<br>【宜忌】<br>【注释】方中二活，祛风除湿，散表寒，利关节；川芎活血；黑豆解痉；麻仁滋润柔筋。诸药制酒使得辛窜透邪之力更强。
二藤酒	二藤酒――（疫毒）<br>（《普济方》）<br>【配方】都淋藤、黄藤（长握各取二虎口长三寸并细　）。<br>【制法】上以酒三大升，都入小瓷罐中密封，慢火围四边烧之。<br>【主治】专治解腹内诸毒，并解一切毒。<br>【用法】令沸伺温，乃温服，常有酒色，无禁忌。<br>若不获己，欲食俚人食者，先取甘草一寸，炙令熟，嚼咽汁，若食著毒药即吐，依前法治之，若经含甘草而不吐者，非也，宜常取甘草十数截，身带之以自防，岭南人将生熟物并于火上炮炙食之，永无虑，若席上撒药，卧著因汗入肉，最难治，可常自将净席随身，及匙筋甘草并解毒药行为妙。（《圣济总录》同上，编者注）昔有席辨刺史常言，岭南俚人解毒药，并是常用物，畏人得其法，乃言之百头牛药，或言之百两银药，辨久住，彼与之亲狎，乃得其实，凡欲食，先取甘草一寸，炙熟嚼咽汁，若中毒，随即吐出，乃用淋藤黄藤二物，酒煎令温服之，常服毒随大小溲出，都淋藤者出岭南，高三尺余，甚细，常所谓三百两银药也，又常带甘草随身，以备缓急。<br>说明：《普济方》注出《太平圣惠方》。
二味独活酒方	二味独活酒方――（脚气）<br>脚气一病始见于《诸病源候论》卷十三，古名缓风，又称脚弱等，据临床表现及病因病理不同，而有干脚气、湿脚气、寒湿脚气、湿痰脚气及脚气冲（攻）心等多种类型。其致病多由风湿毒邪外受，或由饮食厚味所伤，蕴湿酿热，流注于脚而成。临床症见腿脚麻木，痛，软弱无力，或皮肤不仁，或挛急，或肿胀，或萎枯，或胫红肿发热；甚者入腹攻心，小腹坚满，呕吐不食，心悸气喘，胸闷不舒；进而神志恍惚，言语错乱。治疗以宣壅逐湿为主，根据各种类型病因病机不同，配合温经散寒，通络舒筋，活血和营，清火利湿诸法。常用药物有：羌活、防风、牛膝、独活、黄柏、海桐皮、侧子、桑根白皮、黄苓、石斛、五加皮、萆　、生地黄、秦艽、石膏、茵芋、香豉、赤小豆、地骨皮、川芎、丹参、桂心、附子、细辛、川椒、干姜、天雄、当归、白矾石、山药等。古人运用药酒治疗本病有丰富的经验，以下介绍的药酒至今仍有一定的实用价值，临床可根据具体病情选择使用。<br>（《圣济总录》<br>【配方】独活（去芦头），附子（炮裂去皮脐）各五两。<br>【制法】上二味细v，用生绢袋盛，内净瓷瓮中，以清酒二斗浸，密封头，春夏五日，秋冬七日。<br>【主治】治脚气。<br>【用法】量性饮之，常令酒力相续，以差为度。
二味牛膝酒	二味牛膝酒――（腹胀腹痛）<br>（《圣济总录》）<br>【配方】生地黄、生牛膝各250克。<br>【制法】将上二味和捣如泥作团状，以纸裹外重以黄泥固济，微火炙，勿令泥有裂处，待干即于地炉中灰火养半日，次以炭火渐渐烧之，加至火令近，烧一复时，取出候冷，去泥纸，捣罗为散。<br>【主治】少腹滞痛，腰膝浮肿，筋骨无力，足趾极冷。<br>【用法】每用15克，酒20毫升，以瓷器煎至25毫升，和渣食前顿服，老小随意加减均可。<br>说明：脾胃虚寒者，月经过多者慎用。
二味牛膝酒方	二味牛膝酒方――（脚气）<br>（《太平圣惠方》）<br>【配方】生牛膝、生地黄（净洗控干切暴两日）各半斤。<br>【制法】上二味，和捣如泥作团，以纸裹，外更以黄泥固济微火炙，勿令泥有裂处，待干即于地炉中灰火养半日，次以炭火渐渐烧之，加至火三斤，烧一复时，取出候冷，去泥纸，捣罗为散。<br>【主治】治脚气极冷，著厚绵衣盖复不觉暖者。<br>【用法】每服五钱匕，酒一盏半，以瓷器煎至七分，和滓食前顿服，老少以意加减。
发灰酒	发灰酒――（腹胀腹痛）<br>（《普济方》）<br>【配方】妇人油头发。<br>【制法】烧作灰<br>【主治】小腹切痛，属小肠病。<br>【用法】酒服二钱。<br>元丰中丞相王邵公小腹痛不止，圣旨宣差大医攻治，终是不效，丸药之至热，硫黄附子五夜叉丸，用之不瘥，驸马张都尉令取妇人油头发，酒服二钱。即时痛除。
矾石酿酒方	矾石酿酒方――（悦色驻颜）<br>（《千金翼方》）<br>【配方】矾石（烧）、石膏、代赭、恒山、蜀椒（去目闭口者汗）、远志（去皮）、狼毒、半夏（洗）、芒硝、矾石（炼）、玄参、麻黄（去节）、防风、桔梗、秦艽、石南、石苇（去毛）、黄连、莽草、干地黄、凝水石、菟丝子、甘草（秋）各一两，白石英一两半，杏仁（去皮尖熬）二十枚。<br>【制法】上二十五味，捣筛盛韦囊中，以时曲三斤、米三斗作酒，酒熟合药封之，冬十日，春七日，夏三日，秋五日，出药去滓。<br>【主治】服百日，令面白如桃李花色，耳目聪明，邪气荡除，去魂还复。<br>【用法】服酒如一鸡子，日再。
范汪豆酒方	范汪豆酒方――（水肿臌胀）<br>（《外台秘要》）<br>【配方】大豆一升。<br>【制法】上一味，以水四升，煮取二升汁，去豆。内美酒一升合煎，取一升。<br>【主治】疗风虚水气肿。<br>【用法】任意饮之，日三，常令有酒气。
范汪蒲黄酒方	范汪蒲黄酒方――（水肿臌胀）<br>（《外台秘要》）<br>【配方】蒲黄、小豆、大豆各一升。<br>【制法】上三味，以清酒一斗，煮取三升，去豆。<br>【主治】疗通身肿，皆是风虚水气，亦疗暴肿。<br>【用法】分三服。
防风酒	防风酒――（疫毒）<br>（《肘后备急方》）<br>【配方】防风二两克，白酒一斤。<br>【制法】将防风放入白酒内浸泡二十日，即可饮用。<br>【主治】预防温疫。<br>【用法】随量饮水。<br>说明：原方为水桂三分。
防风酒方（三）	防风酒方（三）――（产后中风）<br><br>（《备急千金要方》）<br>【配方】防风、独活各一斤，女萎、桂心各二两，茵芋一两，石斛五两。<br>【制法】上六味口父咀，以酒二斗渍三宿。<br>【主治】治产后中风。<br>【用法】初服一合，稍加至三四合，日三。<br>说明：①《千金翼方》同上。②《普济方》防风、独活各一两，余同上。
防风酒方（一）	防风酒方（一）――（癞病）<br>（《圣济总录》）<br>【配方】防风（去叉v碎）一斤，天麻（坐刂碎）五两，黍米一石，枸杞根（刮去皴皮去心v碎）五斤，好面曲十五斤。<br>【制法】上五味，将防风天麻枸杞根三味，用水六斗，煮取三斗去滓，置不津器中，将黍米依造酒蒸，蒸讫入曲末拌，分三　如常法。又取槐白皮一斤细v，并用三年纯黑猫一个，去皮肠肚外烂煮，同v槐白皮相和入酒，酒熟压去糟。<br>【主治】治恶风癞病。<br>【用法】每服温饮三四合至一合，日二夜一。<br>说明：《普济方》同上。
防风松叶酒	防风松叶酒――（关节疼痛）<br>（《太平圣惠方》）<br>【配方】松叶（十月初采）160克，麻黄、防风各30克，制附子15克，独活30克，秦艽、肉桂各20克），牛膝36克，生地30克，醇酒1.5公斤。<br>【制法】将上药捣碎细，和匀，用纱布包盛，用酒浸于净器中，封口，春秋7日，冬14日，夏5日，日满开取，去渣备用。<br>【主治】因风湿侵袭的关节疼痛，四肢麻木，步履艰难。<br>【用法】每次温饮1小杯（约10毫升），每日3次。<br>说明：服酒期间勿食有毒、滑利、动风之物。
防治冻伤酒	防治冻伤酒――（冻疮）<br>冻疮多因寒盛阳虚，气血冰凝所致。治冻疮药酒有温、补、通的作用。温可散寒，补可助阳，通可活脉。倘全身冻伤者，应令其血温气通，荣卫周流，刻不容缓，首先保温，以助阳气，渐复生机。切忌直接火烘，或取暴热解冻之法，否则危险。<br>（《陕甘宁青中草药选》）<br>【配方】红花、干姜各6钱，附子4钱，徐长卿5钱，肉桂3钱，白酒2斤。<br>【制法】浸泡6日后服用。<br>【主治】预防冻伤。<br>【用法】每服8毫升，日服2-4次。
蜂房酿酒方	蜂房酿酒方――（癞病）<br>（《太平圣惠方》）<br>【配方】露蜂房五两，苦参四斤。<br>【制法】上诸药，细v，用水三　，煮取一　二升，去滓，用浸曲四斤半，炊秫米三　，入曲药溶拌，如常酝法，酒熟，压去糟。<br>【主治】治乌癞。<br>【用法】每于食前暖一小盏服之。<br>说明：《医部全录》同上。
佛手酒（三）	佛手酒（三）――（胃脘痛）<br>（《大众药膳》）<br>【配方】佛手30克，白酒1公斤。<br>【制法】将上药洗净，用清水润透后切片，再切成3分正方形小块，待风吹略收水气后，放入坛或瓶内，然后注入白酒，封口浸泡，隔5天，将坛搅拌或摇动1次，10天后开坛去渣，即可取用。<br>【主治】胃脘胀满，脘痛如攻撑，连及胁痛，嗳气吐酸，大便不畅，常因情忘不舒而作痛，嗳气或矢气后疼痛稍减，苔多薄白，脉弦。<br>【用法】每日酌量饮用3-5克。
佛手露酒	佛手露酒――（胁痛）<br>胁痛是由肝气郁结、瘀血内阻、痰火内结、外邪侵袭等原因引起，以一侧或两侧胁肋部发生疼痛为主要表现的病症。由于胁为肝所主，故胁痛主要与肝胆疾病有关。治疗本病的药酒较少，多用理气药配制而成，如香附根酒，适用于肝郁气滞的胁痛。<br>（《全国中药成药处方集》）<br>【配方】佛手120克，五加皮30克，木瓜12克，山栀15克，良姜、砂仁各9克，木香、公丁香各6克，当归18克，广皮15克，青皮12克，肉桂9克，白酒10公斤，冰糖1.5公斤。<br>【制法】将上药装入生绢袋内，浸于酒中，用文火加热30分钟后，过滤，加冰糖溶化，以瓷坛或玻璃瓶贮存。<br>【主治】肝郁气滞，脾胃不和，胸胁满闷心烦，气逆欲呕，食欲不振，胃脘胀痛等症。<br>【用法】每日早晨、中午各温服2-3小盅，孕妇忌服。
茯苓酒（二）	茯苓酒（二）――（眩晕）<br>（《本草纲目》）<br>【配方】茯苓粉。<br>【制法】同曲、米酿酒。<br>【主治】治头风虚眩，暖腰膝，主五劳七伤。<br>【用法】饮之。
浮萍酒	浮萍酒――（风瘾疹）<br>（验方）<br>【配方】鲜浮萍（洗净）60克，醇酒250克。<br>【制法】将上药细捣烂，用酒浸于净器中，5日后开取，去渣备用。<br>【主治】风热性瘾疹，皮肤搔痒。<br>【用法】取适量涂擦患处。
附子杜仲酒	附子杜仲酒――（感冒）<br>（《古今图书集成）<br>【配方】杜仲（去粗皮，灸）50克，仙灵脾15克，独活、牛膝各25克，附子（炮裂去皮脐）30克，酒1公斤。<br>【制法】将上药碎细，用酒浸之，7宿后即可开取饮用。<br>【主治】感冒后身体虚弱，腰膝疼痛，行步困难。<br>【用法】每次饮10-20毫升，每日3次。
附子浸酒方	附子浸酒方――（风疾诸病）<br>（《太平圣惠方》）<br>【配方】附子（大者炮裂去皮脐）半斤。<br>【制法】上细v，以生绢袋盛，用好酒一斗，于瓷瓶中，密封浸七日。<br>【主治】风疾。<br>【用法】每服温饮一小盏，日再服，以瘥为度。
附子酒（二）	附子酒（二）――（痹证）<br>（《太平圣惠方》）<br>【配方】附子（炮裂去皮脐）、独活各50克，醇酒0.5公斤。<br>【制法】将上药共捣碎细，用酒浸之，5日后可开瓶饮用。<br>【主治】足胫肿胀，疼痛麻木，筋脉挛急。<br>【用法】每饭前温饮1小杯，每日3次。
附子酒（三）	附子酒（三）――（痹证）<br>（《三因极一病证方论》）<br>【配方】大附子（去皮脐切作四片）一枚。<br>【制法】上用醇酒一升，春浸五日，夏三日，秋冬七日。<br>【主治】中风，风冷痰癖胀满诸痹。<br>【用法】每服一合，日二三服，以痹住为效，未知，再作。<br>说明：《普济方》同上。
附子酒（四）	附子酒（四）――（痛风）<br>（《普济方》）<br>【配方】生附子（不去皮）一两一枚，皂角刺二十一根。<br>【制法】上细v分为二处，用好酒二瓶，入上件药，慢火煨候干至半瓶，却合作一处。密缚泥头，经二宿。一方加黑豆一合。<br>【主治】痛风，妇人血风，身上瘙痒。<br>【用法】每服一盏，温服，无时候，未效又服。
附子酒（五）	附子酒（五）――（痹证）<br>（《普济方》）<br>【配方】附子一个（半两以上者，慢火炮去皮脐切作片子）。<br>【制法】上用无灰酒五升浸附子，夏二春秋五冬七日可服。<br>【主治】祛风除湿，温径络散寒邪。<br>【用法】每服温饮一盏，常令酒气不断，食后，一方水煎入盐，空心食前，更入生姜五片同煎，亦得。<br>说明：《普济方》云本方“出十便良方”。
附子酒方	附子酒方――（脚气）<br>（《太平圣惠方》）<br>【配方】附子（炮裂去皮脐）、独活各五两。<br>【制法】上件药，v，以酒五升，渍五六日后用之。<br>【主治】治脚气，风毒湿，筋脉挛急疼痛。<br>【用法】每于食前，随性暖服之。
复方白蛇酒	复方白蛇酒――（腰脚疼痛诸病）<br>（《柳森可用方》）<br>【配方】白花蛇1条，虎胫骨60克，当归、川芎各30克，制附子、肉桂、熟地、山萸肉、萆、石斛、细辛、黄芪、天麻各40克，独活60克，枳壳25克，肉苁蓉40克，醇酒3公斤。<br>【制法】将上药大碎细，白布袋盛，用酒浸于净瓮中，密封口，7日后可开取。<br>【主治】腰脚疼痛，行步艰难，皮肤痒痛不知。<br>【用法】随量温饮，不拘时，常令微醉，旋饮旋添，味薄即止。
复方当归酒	复方当归酒――（关节疼痛）<br>（《中药制剂汇编》）<br>【配方】红花55克，当归80克，制何首乌55克，小血藤80克，白酒1000毫升。<br>【制法】将上药制为粗末，入绢袋盛，浸酒中，封固，10天后即可饮用。<br>【主治】骨性关节炎（即增生性关节炎）。<br>【用法】每次10毫升，早、晚各1次。最大量不要超过20毫升。<br>说明：小血藤系木兰科植物铁箍散的根、茎藤和叶。功效：活血止痛。
复方红花苏木酒	复方红花苏木酒<br>【来源】《中药制剂汇编》<br>【原料】两背针（皮）2.5kg50％食用乙醇7500ml苏木2.5kg红花500g高粱酒7500ml<br>【制作】1将上述药材放入干净的器皿中；2倒入食用乙醇、高粱酒浸泡，密封；315天后开启，滤过去渣，装瓶备用。<br>【功效】活血法瘀，消肿止痛。此方选用活血法瘀之品，治跌打损伤所致的瘀血肿痛，温散润利，肿消痛止。此酒主治因跌打损伤而引起的瘀血肿痛。<br>【用法】每次20～30ml，每日2次。外用适量，擦患部至有灼热感。孕妇、有内出血者忌服。<br>【宜忌】
复方蔓荆子酒	复方蔓荆子酒――（头痛）<br>（验方）<br>【配方】蔓荆子120克，菊花60克，川芎40克，防风、薄荷60克，黄酒1公斤。<br>【制法】将上药共捣碎，用酒浸于净瓶中，7日后开封，去渣备用。<br>【主治】风热性头痛、头昏、偏头痛。<br>【用法】每次饮15毫升，渐加至20毫升，每日3次。
蝮蛇酒	蝮蛇酒――（疥癣病）<br>（《中医临证备要》）<br>【配方】蝮蛇1条，人参15克，白酒1公斤。<br>【制法】将蝮蛇置于净器中，用酒醉死，加入人参，7日后取用。<br>【主治】牛皮癣。<br>【用法】随量频饮，不拘时候。
干姜酒	干姜酒<br>【来源】《长寿补酒》<br>【原料】干姜30克，白酒500毫升。<br>【制作】将干姜拍碎，置净器中，入酒煮取300毫升，过滤去渣，贮入净瓶备用。<br>【功效】心腹冷痛，吐泻，肢冷脉微，寒饮喘咳，风寒湿痹，阳虚呕吐，吐衄便血。<br>【用法】每日2次，早、晚各温饮20毫升。<br>【宜忌】<br>【注释】干姜，又名干生姜，是姜科植物姜的干燥根茎，其性味辛热，入脾、胃、肺经，《名医别录》说姜"治寒冷腹痛，中恶，霍乱，胀满，风邪诸毒，皮肤间结气，止唾血"。干姜可通心阳，祛脏腑寒冷，发诸经寒气，可治感寒腹痛，又擅温肺化痰，回阳救逆。又干姜之辛热，再助酒性之通透湿润，一举夷平阴寒。
干姜酒方	干姜酒方――（心痛）<br>（《食治养老方》）<br>【配方】干姜末半两，清酒六合。<br>【制法】上温酒热，即下姜末投酒中。<br>【主治】食治老人冷气逆心痛结，举动不得。<br>【用法】频服之，立愈。
甘草酒	甘草酒――（头痛）<br>（验方）<br>【配方】生甘草30克，生姜4片，栝蒌（去子，置于碗内）1颗。<br>【制法】先将生姜、甘草用酒2大杯，煎取6成，去渣，热入栝蒌碗中，绞取汗，候温。<br>【主治】发热，头痛，心烦。<br>【用法】不计时候，分2次温服。
甘草酒方	甘草酒方――（疫毒）<br>（《圣济总录》）<br>【配方】甘草（炙）、升麻、沉香（　）、麝香（别研）各半两，豉一两半。<br>【制法】上五味，除麝香外，粗捣筛，入麝香拌匀，酒煎去滓服。<br>【主治】治毒气肿，当头上如刺痛。<br>【用法】每服五钱七，酒一国土半，煎至八分去滓，早晚食前各一服，其滓热傅肿上，甚者取豉半升、栀子仁十四枚、葵菜二两，三味用水二升半，煎至一升，滤去滓，温分三服，空心日午晚间，服尽为度。<br>说明：《普济方》同上。
高良姜酒方	高良姜酒方――（霍乱）<br>霍乱是以发病急骤，吐泻交作为特征的疾病。常因夏秋之季，感受时邪疫疠之气；或含凉露宿，寒湿入侵，邪郁中焦；或饮食不洁；或贪食寒凉生冷之物，以致脾胃受伤，运化失常，升降失司，清浊相干，乱于肠胃而发病。病从寒化者，为寒霍乱；病从热化者，为热霍乱；失水过多，以致两小腿腓肠肌痉挛，不能伸直者，为霍乱转筋。<br>本病所用药酒，多适宜于寒霍乱。常用生姜、高良姜、肉桂、丁香等制成，如高良姜酒、生姜酒、回阳救急酒等。霍乱转筋者，用苦酒配制为宜，因苦酒味酸苦性涩，入肝经，用于霍乱转筋有助于解除筋脉拘急。<br>（《外台秘要》）<br>【配方】高良姜。<br>【制法】上件火炙令焦香，每用五两打破，以酒一升，煮取三四沸。<br>【主治】疗霍乱吐痢，亦疗霍乱腹痛气恶。<br>【用法】顿服。
蛤蚧酒	蛤蚧酒――（阳萎）<br>（《中国动物药）<br>【配方】蛤蚧1对，白酒100毫升。<br>【制法】将蛤蚧去头、足、鳞，切成小块，浸于酒中，封固两个月。<br>【主治】肾虚腰痛，阳萎等症。<br>【用法】每次饮30毫升，每日1次。<br>说明：使用蛤蚧很重要的一点是注意真伪。最常见的伪品是一种叫喜山鬣晰的动物，形体与蛤蚧颇为相似，但蛤蚧有以下特点：无眼睑，背部鳞片镶嵌排列，为粒鳞，趾宽扁，爪短。喜山鬣晰则有眼睑，背部鳞片叠瓦状排列，为起棱鳞片，指、趾窄长，爪长。上述特点可资鉴别。
蛤蚧酒1	蛤蚧酒<br>【来源】《药酒与膏滋》<br>【原料】蛤蚧1对，黄酒500毫升。<br>【制作】取蛤蚧1对，去头足及鳞，切成小块，连尾巴，置于瓶中，入黄酒浸泡，7-10日后即可饮用。<br>【功效】补肺益肾，纳气定喘。虚劳羸瘦，动则气喘，咳嗽少气，阳痿早泄等症。<br>【用法】可随饮随加酒，味薄为止。<br>【宜忌】<br>【注释】蛤蚧性味咸平，功效补肺益肾，定喘止咳；主治虚劳，肺痿，喘嗽，咯血，消渴，阳痿。《本草拾遗》曰：“补可去弱，人参、羊肉之属”。蛤蚧补气，定喘止渴，功同人参，益阴血，助精扶羸，功同羊肉。治劳损痿弱，许叔微治消渴，皆用之，俱取其滋补也。某老医云：“气液衰，阴血竭者宜用之”。又曰：“定喘止嗽，莫家于此”。
狗骨酒	狗骨酒――（痹证）<br>（《偏方大全》）<br>【配方】狗骨、白酒各适量。<br>【制法】将狗骨浸入酒中，15天后可服。<br>【主治】风湿痹症，腰腿痛，肌肉萎缩等症。<br>【用法】适量饮用。
狗脊酒	狗脊酒――（关节疼痛）<br>（验方）<br>【配方】金毛狗脊150克，黄酒1500克。<br>【制法】将药浸于酒中，封固容器，置锅中，隔水加热煮1.5小时，取出埋土中7日退火毒，即可服用。<br>【主治】关节筋骨疼痛，腰膝无力，活动不便等症。<br>【用法】每次饮1小盅，日3。<br>说明：制备上述狗脊酒时，应去除其毛须。其作方法一般用砂烫去毛，或燎，或刮。为了易切片，先用清水洗净，浸泡半日后，用蒸笼蒸透，再行切制。
枸杞菖蒲酒	枸杞菖蒲酒――（手足不遂）<br>（《备急千金要方》）<br>【配方】枸杞根一百斤，菖蒲五斤。<br>【制法】上二味细v，以水四石，煮取一石六斗去滓，酿二斛米。<br>【主治】治缓解风四肢不随，行步不正，口急及四体不得曲伸。<br>【用法】酒熟稍稍饮之。<br>说明：《普济方》同上。
枸杞根酒	枸杞根酒――（痿证）<br>（验方）<br>【配方】枸杞根250克，白酒1公斤。<br>【制法】将上药碎细，布包，酒浸于净瓶中，封口，7日后，滤渣待用。<br>【主治】脚膝痿弱，体内久积风毒，肩膊胸背疼痛，妇女产后头晕目眩。<br>【用法】每日温饮15毫升，渐加至20毫升，不拘时候。酒尽后，再添酒，味薄即止。
枸杞酒（一）	枸杞酒（一）――（灭瘢痕）<br>瘢痕的形成主要因疮疡、跌打损伤皮肤、烫火伤、钮所伤、手术等瘥后所致。一般轻者可留有色斑，重则可形成瘢痕。本病发生在关节活动部位，因瘢痕挛缩，可不同程度的影响其功能活动。发生于面、颈等部位还影响美观。以下介绍3种来瘢痕的药酒。据载有较好的灭瘢痕的作用，患此病的患者可以试用之。<br>（《千金翼方》）<br>【配方】枸杞根一斤、干地黄末、干姜末、商陆根末、泽泻末、椒末、桂心末各一升。<br>【制法】上件先将枸杞根一味切，以东流水四石煮之一日一夕，去滓，得一石汁，渍曲酿之，如家酝法，酒熟取清。后六味，盛以绢袋，内酒中，密封口埋入地三尺，坚覆上二十日，沐浴整衣冠，向仙人再拜讫，开之，其酒当赤如金色。<br>【主治】来瘢痕，除万病。<br>【用法】平旦空肚服半升为度。
枸杞酒方（一）	枸杞酒方（一）――（灭瘢痕）<br>（《备急千金要方》）<br>【配方】枸杞根一百二十斤，干地黄末二斤半，桂心末、干姜末、泽泻末、蜀椒末各一升，商陆末二升。<br>【制法】上件枸杞根细切，以东流水四石煮一日一夜，取清汁一石，渍曲一如家酝法，熟取清，贮不津器中，将余药以绢袋盛，内酒底，紧塞口，埋入地三尺，坚覆上，三七日沐浴整衣冠再拜，平晓向东甲寅地日出处开之。其酒赤如冬色。<br>【主治】除万病，灭瘢痕。<br>【用法】旦空腹服半升。
枸杞菊花酒	枸杞菊花酒――（阳萎）<br>（验方）<br>【配方】枸杞子500克，甘菊花20克，麦冬100克，曲250克，糯米7.5公斤。<br>【制法】将上药煮烂，连汁和曲、米如常法酿酒。酒熟压去糟，收贮备用。<br>【主治】虚劳精损，阳萎遗精，肾虚消渴，腰背疼痛，足膝酸软，头晕目暗，视物模糊，迎风流泪，肺燥咳嗽。<br>【用法】每次饭前饮1-2小杯，每日早、晚各1次。
枸杞子酒（二）	枸杞子酒（二）――（悦色驻颜）<br>（《普济方》）<br>【配方】生枸杞子五升。<br>【制法】上研捣勿碎，酒二斗浸七日，漉去滓饮之。<br>【主治】专治补虚，长肌肉，益颜色，肥健人，能去劳热。<br>【用法】初以三合为始，后即任性饮之。<br>说明：《普济方》注出《肘后方》。
枸杞子酒（一）	枸杞子酒（一）――（肝虚流泪）<br>（《审视瑶函》）<br>【配方】枸杞子（肥者）1斤，陈无灰酒10斤。<br>【制法】将枸杞子杵烂，用绢袋盛，浸酒密封，勿令气泄，候3、7日即可饮用。<br>【主治】目疾。<br>【用法】每饮1、2盅，勿过量，并可将猪肝煮熟切片，蘸花椒盐同食。
古今录验桑酒方	古今录验桑酒方――（水肿臌胀）<br>（《外台秘要》）<br>【配方】桑枝并心皮（细刂）。<br>【制法】以水八升，煮取上件四升汁，以四升米酿酒。<br>【主治】疗水肿下之则虚竭，不下则溢满，还覆十无一活者。<br>【用法】一服一升。
骨髓痛方	骨髓痛方――（筋骨诸病）<br>（《医部全录》）<br>【配方】虎骨四两，芍药一斤，生干地黄五斤，清酒一斗。<br>【制法】将上药口父咀，以酒浸三宿，曝干，复入酒中，如此取酒尽为度，捣筛备用。<br>【主治】骨髓疼痛，烦热。<br>【用法】酒服方寸匕，每日二次。
固精酒	固精酒――（不孕不育）<br><br>（《惠直堂经验方》）<br>【配方】枸杞子120克，当归60克，熟地180克，好酒约3000克。<br>【制法】将上药盛入绢袋，置于瓷制容器或其他适宜容器中，加酒，封固，隔水加热，煮1小时，取出埋于地下，7天后即可启用。<br>【主治】男性不育症。体质属阴血不足者亦可服用。<br>【用法】每日早、晚各饮3小盅，不可过量。
广济钟乳酒方	广济钟乳酒方――（阳萎）<br>（《外台秘要》）<br>【配方】钟乳（研，绢袋盛）、薯蓣、五味子各三两，附子（炮）、甘草（炙）、当归、石斛、前胡、人参、生姜屑、牡蛎（熬）、积实各二两，桂心一两，菟丝子五合，干地黄五两。<br>【制法】上十五味切，以绢袋盛，清酒二斗渍之，春夏三日，秋冬七日。<br>【主治】阳萎不起，滴沥精清。<br>【用法】量性饮之，忌海藻菘菜猪肉冷水生葱芜荑生冷粘食等。
龟版杜仲酒	龟版杜仲酒――（关节疼痛）<br>（《偏方大全》）<br>【配方】龟版、杜仲各适量。<br>【制法】将上二味，浸入白酒中，约40天可服。<br>【主治】由风湿性关节炎引起的疼痛症。<br>【用法】适量饮用。
桂心酒	桂心酒――（Y瘕）<br>（《备急千金要方》）<br>【配方】桂心、牡丹、芍药、牛膝、干漆、土瓜根、牡蒙各四两，吴茱萸一升，大黄三两、黄芩、干姜各二两，虻虫二百枚，虫、蛴螬、水蛭各七十攻，乱发灰、细辛各一两，僵蚕五十枚，大麻仁、灶突墨各三升，干地黄六两，虎杖根、鳖甲各五两，　　子二升。<br>【制法】上二十四味口父咀，以酒四斗分两瓮，浸之七日<br>一瓮盛，搅令调，还分作两瓮。<br>【主治】月经不通，结成Y瘕。<br>【用法】初服二合，日二，加至三四合。
桂心酒（二）	桂心酒（二）――（心痛）<br>（《食治养老方》）<br>【配方】桂心末一两，清酒六合。<br>【制法】上温酒令热，即下桂心末调之。<br>【主治】食治老人冷气心痛，缴结气闷。<br>【用法】频服，一、二服效。
桂心酒（三）	桂心酒（三）――（关节疼痛）<br>（《普济方》）<br>【配方】桂心、特丹、芍药、牛膝、干漆、土瓜根、牡蒙各四两，吴茱萸一升，大黄二两，黄芩、干姜各二两，虫二百枚，虫、蛴螬、水蛭各七十枚，乱发灰、细辛各一两，僵蚕五十枚，大麻子、灶突灰各二升，干地黄六两，虎杖根、鳖甲各五两，子三升。<br>【制法】上口父咀，以酒四升，分两瓮浸之七日。并一瓮盛，搅调还分作两瓮。<br>【主治】寒凝血瘀，骨节疼痛。<br>【用法】初服二合，加至三四合。<br>说明：《普济方》注出《备急千金要方》。
桂心酒（一）	桂心酒（一）――（产后腹痛）<br><br>（《备急千金要方》）<br>【配方】桂心三两。<br>【制法】以酒三升，煮取二升，去滓。<br>【主治】产后腹痛，及卒心腹痛。<br>【用法】分三服，日三。
桂圆酒	桂圆酒――（失眠）<br>（《偏方大全》）<br>【配方】桂圆肉250克，白酒（60度）400毫升。<br>【制法】将桂圆肉切碎，装入磁瓶中，以酒浸泡15-20天即成。<br>【主治】神经衰弱，失眠，健忘，心悸等症。<br>【用法】每日2次，每次10-20毫升。
桂枝浸酒方	桂枝浸酒方――（癞病）<br>（《太平圣惠方》）<br>【配方】桂枝、芎、独活、甘草（炙微赤）、牛膝（去苗）、薯蓣、附子（炮裂去皮脐）、干姜（炮裂）、踯躅花各一两（醋拌炒令干），防风（去芦头）、天雄（炮裂去皮脐）、茵芋、杜仲（去皴皮炙微黄）、白术各一两半，白茯苓、蒴根，猪椒根皮各二两。<br>【制法】上细v，用生绢袋贮，以清酒二斗，浸七日满后。<br>【主治】大风疾。<br>【用法】每日空心及夜卧时，暖一小盏服之。<br>说明：《普济方》同上。
桂枝酒	桂枝酒――（失音）<br>（《备急千金要方》）<br>【配方】桂枝、芎、独活、牛膝、薯蓣、甘草各三两，附子二两、防风、茯苓、天雄、茵芋、杜仲、白术、蒴根各四两，干姜五两，大枣四十枚，踯躅、猪椒叶根皮各一升。<br>【制法】上十八口父咀，以酒四斗渍七日。<br>【主治】治肝虚寒，卒然哑不出声，踞坐不得，面目青黑，四肢缓弱，遗失便利，厉风所损。<br>【用法】服四合，日二，加至五六合。<br>说明：《普济方》附子用二两，大枣四十铢，无猪椒叶根皮，用猪椒、桑白皮各一升。
桂枝酒（二）	桂枝酒（二）――（中风）<br>（《太平圣惠方》）<br>【配方】桂枝40克，川芎、独活、炙甘草、牛膝、薯蓣、制附子各30克，防风35克，云苓40克，茵芋20克，杜仲、陆英根、炮姜各30克，白术35克，踯躅花30克，清酒2.5公斤。<br>【制法】将上药共捣碎细，用酒浸于净器中，7日后开封，去渣备用。<br>【主治】四肢抽搐，肌肉疼痛，体虚乏力，关节不利，口噤，口眼歪斜，言语不清。<br>【用法】每日临睡前空心温服，随量。
桂枝酒（一）	桂枝酒（一）――（跌打损伤）<br>（《永乐大典》）<br>【配方】辣桂。<br>【制法】上为末。<br>【主治】打扑伤坠，瘀血溷闷，身体疼痛。<br>【用法】每二钱温酒调下。或用辣桂一分，大黄、当归各半分，每三钱生姜、紫苏煎服，取下黑物即安。或末有药，仓卒且服米醋一小盏，亦散瘀血。<br>说明：《永乐大典》注出《大全良方》。307
海狗肾酒	海狗肾酒――（阳萎）<br>（《本草纲目》）<br>【配方】海狗肾2个，曲200克，糯米5公斤。<br>【制法】将海狗肾酒浸捣烂，和曲、米如常法酿酒。<br>【主治】肾虚阳萎，性欲减退，体弱畏冷，腰膝酸软。<br>【用法】每次空腹饮1-2小杯，每日3次。
海马酒	海马酒――（阳萎）<br>（《食物与治病》）<br>【配方】海马1对，白酒500克。<br>【制法】将海马浸入酒内，封固，两周后可饮用。<br>【主治】肾阳虚损，命门火衰的阳萎，腰膝酸冷等症。<br>【用法】每天临睡前饮1小杯。<br>说明：孕妇、阴虚火旺者禁用。
海桐酒	海桐酒――（痿证）<br>（《普济方》）<br>【配方】牛膝、海桐皮、五加皮、独活、防风、杜仲、枳壳各二两，生地黄二两半，白术一两，薏苡仁一两。<br>【制法】上口父咀，用生绢袋二个，两停盛药，以好酒一斗五升，亦分两瓷器内浸，春夏七日，秋冬二七日。<br>【主治】湿痹，手足痿，筋脉挛，肢节疼痛无力，不能行走。<br>【用法】每服一盏，日三夜一，使酒力薰薰，百日步履如故。<br>说明：《普济方》注又名“薏苡仁酒”。
海桐皮浸酒方（二）	海桐皮浸酒方（二）――（风疾诸病）<br>（《普济方》）<br>【配方】海桐皮、五加皮、独活、侧子（炮裂去皮脐）、天麻、桂心、防风（去芦头）、枳壳（麸炒微黄去瓤）、杜仲（炙微黄）以上各三两，牛膝五两（去苗），薏苡仁六两，生地黄半斤。<br>【制法】上细v和匀，以生绢袋盛，用清酒三斗浸之，春夏七日，秋冬二七日。<br>【主治】治风。<br>【用法】每日随性饮一盏，常令有酒气，不得大醉。
海桐皮浸酒方（四）	海桐皮浸酒方（四）――（腰脚疼痛诸病）<br>（《太平圣惠方》）<br>【配方】海桐皮、五加皮、独活、防风（去芦头）、干蝎（生用）、杜仲（去皱皮炙微黄）、酸枣仁（微炒）、桂心、侧子（炮裂去皮脐）、薏苡仁各一两，生干地黄三两。<br>【制法】上件药，v如豆大，用生绢袋盛，以好酒二斗，于瓷瓶中浸，密封，秋夏七日，春冬二七日开取。<br>【主治】风毒流入脚膝疼痛，行立不得。<br>【用法】每日不计时候，温饮一小盏子。
海桐皮浸酒方（一）	海桐皮浸酒方（一）――（痈疽、疮疡、发背）<br>（《圣济总录》）<br>【配方】海桐皮（v）、五加皮（v）、独活（去芦头）、防风（去叉）、干蝎（炒）、杜仲（去粗皮切）、牛膝（去苗浸切焙）、薏苡仁炒）各一两，生干地黄（焙）三两。<br>【制法】上九味，粗捣筛，生绢囊贮，以好酒一斗五升，浸于瓷瓶中密封，秋夏三日，春冬七日开取。<br>【主治】治热毒风结成疽，肿痛行履不得。<br>【用法】食前温酒三合，加至四五合，不拘时，甚者常充酒气相续。<br>说明：①《普济方》同上。②《医部全录》用法：食前温服三合或四五合，不拘时，常令酒气相续。余同上。③《奇效良方》各“海桐皮散浸酒方”，内容同上。
海桐皮酒方	海桐皮酒方――（腰脚疼痛诸病）<br>（《圣济总录》）<br>【配方】海桐皮、五加皮、独活（去芦头）防风（去叉）、枳壳（去瓤麸炒）、杜仲（去粗皮炙）各一两，牛膝（去苗）、薏苡仁各二两，生地黄半斤。<br>【制法】上九味，细v绵裹，以无灰酒二升，春夏浸七日，秋冬二七日。<br>【主治】风冷流于脚膝，行立不得。<br>【用法】每日空腹温服一大盏日三，常令酒气不绝，重者不过两剂瘥。<br>说明：《普济方》同上，名“海桐皮酒”。
海藻浸酒	海藻浸酒――（瘰疠）<br>（《普济方》）<br>【配方】海藻一斤。<br>【制法】以酒二升渍上药数日。<br>【主治】治颌下瘰疬如梅李。<br>【用法】稍稍饮之。<br>说明：《普济方》注“出本草上”。
海藻浸酒方	海藻浸酒方――（水肿臌胀）<br>（《圣济总录》）<br>【配方】海藻（洗去咸）、赤茯苓（去黑皮）、防风（去叉）、独活（去芦头）、附子（炮裂去皮脐）、白术各三两，鬼箭（去茎用羽）、当归（切焙）各二两，大黄（醋炒）四两。<br>【制法】上九味，　如麻豆，生绢囊贮，以酒二斗浸之，春夏五日，秋冬七日。<br>【主治】治气肿行走无定，或起如蚌，或大如瓯，或著腹背，或著臂脚。<br>【用法】初服三合，空心午时临卧各一服，若频利即减，未利加至四五合，以差为度。<br>说明：《普济方》前六药各用二两，余同上。
海藻酒（二）	海藻酒（二）――（瘿瘤）<br>（《补辑肘后方》）<br>【配方】海藻500克，白酒2000毫升。<br>【制法】将海藻入绢袋盛之，浸入酒中，春夏2天，秋冬3天即可。<br>【主治】瘿瘤，颈前中部肿大，质软不痛，或觉颈部发胀，胸闷等症。<br>【用法】每服1小盅，日3。酒饮完后，可再浸2000毫升白酒，最后还可将其渣，曝晒为末服用。
海藻酒（三）	海藻酒（三）――（痹证）<br>（《普济方》）<br>【配方】海藻、茯苓、防风、独活、附子、白术各三两，大黄、鬼箭、当归各二两。<br>【制法】上口父咀，以酒二斗浸五日。<br>【主治】游风行走无定，肿或如核，或如瓯，或著腹背，或著脚，悉主之。<br>【用法】初服二合，渐加，以知为度。<br>说明：《普济方》注出《备急千金要方》。
海藻酒（一）	海藻酒（一）――（瘿瘤）<br>（《肘后备急方》）<br>【配方】海藻、昆布各500克，好酒5000毫升。<br>【制法】将上药切碎，用酒浸7天后即成。<br>【主治】瘿瘤；也有预防单纯性甲状腺肿的作用。<br>【用法】适量饮用。
海藻酒方（二）	海藻酒方（二）――（瘿瘤）<br>（《奇效良方》）<br>【配方】海藻（洗去碱）一斤，酒二升。<br>【制法】将海藻入酒内浸一宿即可饮用。<br>【主治】颈下卒结核，渐大欲成瘿瘤。<br>【用法】每饮一、二合，酒尽将海藻暴干，捣为末，酒调一钱匕，日三即瘥，如浸用，将药末以绢袋盛了渍，春夏二日，秋冬三日。<br>说明：①《医部全录》名海藻酒，主治瘿气。制法：将海藻用绢袋盛之，浸入清酒中，春夏二日，秋冬三日。用法：每服二合，日三服。酒尽再作，其渣暴干为末，每服方寸匕，日三服。余同上。②《普济方》用法：取三合饮之，酒尽，将海藻晒干，捣为末，调酒一钱，一日三服，即瘥。余均同上。
海藻酒方（一）	海藻酒方（一）――（瘿瘤）<br>（《圣济总录》）<br>【配方】海藻（洗去咸）二两。<br>【制法】上一味细v，以清酒四升浸二宿，漉去滓。<br>【主治】治咽喉噎塞，冷气妨闷，结成瘿气。<br>【用法】每取半盏，细细含咽，日三，不拘时，以差为度。<br>说明：《普济方》同上。
海藻昆布浸酒	海藻昆布浸酒――（瘰疠）<br>（《普济方》）<br>【配方】海藻、昆布各一斤。<br>【制法】酒浸数日。<br>【主治】治瘰疬颔下如梅核。<br>【用法】服之。
寒凉咳嗽酒	寒凉咳嗽酒<br>【来源】《山居备用》<br>【原料】全紫苏60克，杏仁、瓜蒌皮、浙贝母、半夏、枳壳、百部、桔梗、桑白皮、枇杷叶、茯芩各15克，陈皮、干姜各30克，细辛、豆蔻仁、五味子各7.5克，甘草1.5克，白酒2500克。<br>【制作】将药用白纱布袋盛之，置于净器中，入酒浸泡，密封，5日后开启，过滤后装瓶备用。<br>【功效】祛风散寒，止咳平喘。适用于寒凉咳嗽，症见咳嗽气喘，鼻塞流清涕，喉痒声重，痰稀色白，头痛发热，恶寒或恶风等。<br>【用法】每日早、晚各1次，每次饮服30―50毫升。<br>【宜忌】咳嗽属阴虚，久咳痰少，痰中带血丝，口燥咽干者忌服。
蒿艾酒	蒿艾酒――（癞病）<br>（《普济方》）<br>【配方】白艾蒿。<br>【制法】取白艾蒿十束如升大，煮取汁，以曲糯米一如酿酒法，候热，绢滤饮之。<br>【主治】治癞疾。<br>【用法】凡恶疾遍体，面目有疮者，皆可饮之。
何首乌酒	何首乌酒――（疥癣病）<br>（《中医临证备要》）<br>【配方】何首乌30克，当归身、穿山甲、生地、熟地、虾蟆各20克，侧柏叶15克，松针、五加皮各30克，川草乌各5克，黄酒3公斤。<br>【制法】将上药共碎细，布包，用酒浸于净瓶中，7日后开封，去渣备用。<br>【主治】牛皮癣。<br>【用法】空心随量饮之，不拘时候。
核桃仁酒	核桃仁酒――（胃脘痛）<br>（《陕甘宁青中草药选》）<br>【配方】青核桃6斤，白酒10斤。<br>【制法】将青核桃捣碎，浸泡20-30天服用。<br>【主治】治各种胃痛。<br>【用法】每服10-15毫升，日服3次。
黑豆浸酒	黑豆浸酒――（水肿臌胀）<br>（《普济方》）<br>【配方】黑豆一升（炒黑），白花蛇（酒浸炙微黄）一条重五两，大麻仁二升（蒸熟），五加皮（）五两，苍耳子（炒微黄）五两，牛蒡子（酥炒微黄）一升。<br>【制法】上捣碎，生绢袋盛，用好酒三斗，内入瓷瓶中封头，浸七日开瓶。<br>【主治】治风肿无问冷热。<br>【用法】每于食前，　一中斛服之。<br>说明：《普济方》注出《太平圣惠方》。
黑豆浸酒方（一）	黑豆浸酒方（一）――（手足不遂）<br>（《圣济总录》）<br>【配方】黑豆（拣紧小者净淘）一升。<br>【制法】上一味，用酒五升，用入瓶中密封，用灰火煨，常令熟。约至酒减半，即去豆取酒。<br>【主治】治中风手足风手足不随。<br>【用法】每服空心及临卧时，各饮二合至三合。
黑豆酒（二）	黑豆酒（二）――（手足不遂）<br>手足不遂指手足活动不利，不能正常行走持物，见于中风后遗症等，治疗一般从祛风通络，舒筋活血等入手，药酒配方中常用的药物有：黑豆、丹参、白术、地骨皮、桑枝、柏枝、石榴枝、羌活、防风、夜合枝、枸杞根、菖蒲、天麻、石斛、桂心、当归、川芎、牛膝、杜仲、虎胫骨、茵芋、狗脊、乌蛇肉，仙灵脾、五加皮、油松节、独活等。<br>（《普济方》）<br>【配方】黑豆（拣紧小者淘掐）250克，丹参150克，黄酒2公斤。<br>【制法】将上药粗碎，同酒入瓶密封，用灰火煨，常令热，约至酒减半，即去取酒。<br>【主治】中风手足不遂。<br>【用法】每早、午、晚及临卧时各饮1-2杯。
黑豆酒（一）	黑豆酒（一）――（脚气）<br>（《圣济总录》）<br>【配方】黑豆（炒）250克，白芷30克，薏苡仁60克，黄酒1.5公斤。<br>【制法】将上药粗碎，用酒浸于瓶中，密封瓶口，3宿后开取，去渣备用。<br>【主治】脚气痹弱，头目眩晕，筋急，小便不利。<br>【用法】每日随量饮之，常令酒力相续。
黑豆酒方（二）	黑豆酒方（二）――（产后风痉）<br><br>（《圣济总录》）<br>【配方】黑豆（小者打碎）二升，酒四升。<br>【制法】右将黑豆，铛中慢火炒令香熟，即以酒投之，取出以绢滤去豆，将酒瓮器盛。<br>【主治】产后中风，腰背反折，筋急口噤。<br>【用法】每服一盏，温服不拘时。
黑豆酒方（一）	黑豆酒方（一）――（脚气）<br>（《圣济总录》）<br>【配方】黑豆（炒）二升。<br>【制法】上一味，以酒一斗浸，密复瓶口，经三宿。<br>【主治】治脚气　弱，头目眩冒筋急。<br>【用法】随性饮，常令酒力相续。<br>说明：《普济方》一方同上。
黑豆羌活酒	黑豆羌活酒――（背强口噤）<br>（验方）<br>【配方】羌活15克，防风10克，黑豆（去皮炒令熟）30克，黄（米）酒200毫升。<br>【制法】将上药共为粗末，用酒浸，置火上候沸即住，即渣，候温。<br>【主治】中风口噤，四肢强直，角弓反张。<br>【用法】分2次灌之。
黑附子酒	黑附子酒――（痛风）<br>（《永类钤方》）<br>【配方】大生附子（不去皮，重一两）一只，皂角刺二十一个，黑豆一合。<br>【制法】三味细v，分作二处，好酒入药慢火辉干，取半合作一处，密封罐，经两宿。<br>【主治】痛风，妇人血风瘙痒。<br>【用法】每服一钱。
黑桂酒	黑桂酒――（产后瘀血）<br><br>（《圣济总录》）<br>【配方】黑豆（炒熟去皮）、肉桂、当归、芍药、炮姜、生地各30克，炙甘草20克，蒲黄（纸上炒）30克，酒1.5公斤。<br>【制法】将上药共碎细，用酒浸于净瓶中，7宿后开封饮用。<br>【主治】产后气血瘀滞，身体肿满，或泻痢寒热。<br>【用法】每饮15-20毫升，每日3次。
黑铅酒方（二）	黑铅酒方（二）――（痈疽、疮疡、发背）<br>（《普济方》）<br>【配方】黑铅一斤，甘草（微炙）三两。<br>【制法】上用酒一斗，着空瓶之傍，先以甘草置在酒瓶内，然后熔铅投在酒瓶中，却出酒在空瓶内取出铅，依前熔后投，如此者九度，并甘草去之，只使酒。<br>【主治】治发背及诸痈毒疮并发脑，疼痛浸渍。<br>【用法】令病者饮醉寝，即愈。
恒山酒	恒山酒――（疟疾）<br>（《普济方》）<br>【配方】恒山、鳖甲（醋炙去裙）各三分，虎头骨（炙）半两，豉（炒）半分，桃枝一握，柳枝一握，桃仁三七枚（去皮尖双仁炒），干枣三枚（去核），乌梅（炙）七枚。<br>【制法】上细，以酒一升，浸一宿，明日入生姜五片，煎取五合，去滓。<br>【主治】治疟方。<br>【用法】空心分为二服。
红花酒	红花酒――（痛经）<br><br>（验方）<br>【配方】红花100克，60度白酒400克。<br>【制法】把洁净的红花放入细口瓶内，加白酒浸泡一周，每日振摇一次。<br>【主治】温通经脉，活血。可用于妇女冲经虚寒、血瘀性痛经症。<br>【用法】每次服用10毫升，也可兑凉白开水10毫升或加红糖适量饮用。
红花山楂酒	红花山楂酒――（月经过少）<br><br>月经过少又称“月经涩少”或“经行不爽”。是指行经时出血点滴，量少而不畅，一、二天即净的病症。主要病因为血虚、血寒、血瘀、血滞及痰湿，但以虚寒气滞者多见。更年期妇女出现本症时可能为闭经的先兆。每次经量极少，点滴即无，长期不愈，应考虑生殖系结核之可能。总之本病的特点是经量少于正常，或排血时间短。治疗时还应考虑患者的体质因素，使用攻逐药物尤应慎重，不可随意用之。以下介绍两首治疗本病的药酒，供选用。<br>（《百病饮食自疗》）<br>【配方】红花15克，山楂30克，白酒250克。<br>【制法】将上药入酒中浸泡1周。<br>【主治】经来量少，紫黑有块，少腹胀痛，拒按，血块排出后疼痛减轻，舌边可见紫黯瘀点，脉沉涩。<br>【用法】每次饮15-30克，每日2次，视酒量大小，不醉为度。
红葵酒	红葵酒――（哮喘）<br>（《新医药学杂志》）<br>【配方】天天果4.5公斤，千日红花2公斤，白酒（60度）30公斤。<br>【制法】采用冷浸法，两种药要分别浸于酒中，天天果浸入15公斤酒，放一容器，千日红花浸入15公斤酒，放另一容器，一个月后，压榨，过滤，取上两种浸酒的澄清液合并在一起，加0-15%的单糖浆，装瓶密封即成。<br>【主治】寒喘型的支气管哮喘，在易发作季节来临之前，服用此酒，有防止或减轻发作的作用。<br>【用法】每次10-20毫升，日3，或每晚一次。对于不习惯饮酒者，亦可用开水稀释后使用。服药后一般10-20分钟，喉胸有热感，以后气喘渐平稳，痰容易咳出，渐有舒适感。<br>说明：天天果是茄科茄属龙葵的种子。千日红花是苋科植物千日红的花序。
红蓝花酒（二）	红蓝花酒（二）――（痛经）<br><br>（《金匮要略》）<br>【配方】红蓝花30克，酒一升。<br>【制法】将药入酒内，煎至减半。<br>【主治】一切风邪，如妇女经后或产后，风邪易于侵入腹中，扰乱腹内气血，使气滞血瘀，发生腹中刺痛。<br>【用法】顿服一半，未止再服。<br>说明：饮用此酒期间，婴儿应暂停哺乳。
红蓝花酒（三）	红蓝花酒（三）――（胎死腹中）<br><br>（《妇人大全良方》）<br>【配方】红花一两。<br>【制法】上为末，分二服。每服酒二盏、童子小便二盏，煮取盏半，候冷，留滓再并煎。一方无童便。<br>【主治】《近效》方疗血晕、绝不识人，烦闷，言语错乱，恶血不尽，腹中绞痛，胎死腹中。<br>【用法】分为二服。<br>说明：《普济方》注曰“如口噤翰开灌之。如子死腹中，服之立下。”余同上。
红蓝花酒（一）	红蓝花酒（一）――（痛经）<br><br>（《金匮要略方论》）<br>【配方】红蓝花一两。<br>【制法】上一味，以酒一大升，煎减半。<br>【主治】妇人六十二种风，及腹中血气刺痛。<br>【用法】顿服一半，未止再服。<br>说明：《普济方》载本方同上，注出“经验良方”。
红茅药酒	红茅药酒――（腹胀腹痛）<br>（《全国中药成药处方集》）<br>【配方】公丁香、白豆蔻各6克，砂仁10克，良姜、零陵香、红豆蔻各6克，白芷10克，当归30克，木香2克，肉豆蔻6克，陈皮20克，枸杞10克，檀香2克，草豆蔻6克，佛手10克，桂枝6克，沉香4克，肉桂20克，山药6克，红曲162克，烧酒5200克，蜂蜜1560克，冰糖4162克。<br>【制法】将上药装入布袋，浸于酒中，加热煮数沸兑入蜂蜜、冰糖，溶化即成。<br>【主治】寒湿中阻，脾胃气滞的脘满痞塞，腹胀腹痛，不思饮食，消化不良等症。<br>【用法】适量饮用，饮时须将酒烫热。
红丝毛酒	红丝毛酒――（跌打损伤）<br>（《陕甘宁青中草药选》）<br>【配方】线丝毛2两，白酒1斤。<br>【制法】泡5-7天后服用。<br>【主治】腰扭伤，风湿性关节炎，跌打损伤。<br>【用法】每服5-10毫升，日服2次。
红糖醴	红糖醴――（腹胀腹痛）<br>（验方）<br>【配方】黄酒50毫升，红糖10克。<br>【制法】黄酒、红糖同置小铝锅中，以小火煮沸，待糖溶化后停火。<br>【主治】寒性腹痛、腹泻患者服之有效。<br>【用法】趁热顿服。
胡麻浸酒方	胡麻浸酒方――（口眼?斜）<br>（《圣济总录》）<br>【配方】胡麻（炒捣粗罗）一斤。<br>【制法】上一味，用生绢囊贮，以酒一斗五升，浸七日。<br>【主治】治中风口面?斜。<br>【用法】每服三合，稍稍服之，加至四五合，以瘥为度。
胡麻酒	胡麻酒――（中暑）<br>（《山家清供》）<br>【配方】麻子二升，生姜二两，生龙脑叶一撮。<br>【制法】渍麻子，煎熟，略炒，加生姜、生龙脑叶，同入炒，细研，投以煮酝五升，滤渣去水，浸之。<br>【主治】解暑热。<br>【用法】盛夏，正午饮一巨觥，清风飒然，绝无暑气。
胡荽酒	胡荽酒――（小儿痘疹）<br>小儿痘疹是泛指感受外邪所致的多种出疹性疾病。如麻疹、风疹、水痘等等。一般多由于外感风邪，血热毒盛所致。体质弱的小儿易见疹不易出，疹毒内陷之证。以下介绍2种药，胡荽酒有透疹解表作用，为外用喷于小儿体表；地龙酒则适用于血热毒盛，黑陷不起。<br>（《太平圣惠方》）<br>【配方】胡荽三两。<br>【制法】上药细切，以酒二大盏，煎令沸，沃胡荽，便以物合定，不令气出，候冷去滓。<br>【主治】治小儿疹痘，欲令速出。<br>【用法】微微从项以下，喷背膂，及两脚胸腹令遍，勿喷于面。<br>说明：《圣济总录》胡荽用半握，余同上。
壶芦酒	壶芦酒――（鼻窒）<br>（《医部全录》）<br>【配方】苦壶芦子。<br>【制法】将上药打碎，以醇酒半升浸，春三、夏一、秋五、冬七日。<br>【主治】鼻塞，眼昏，疼痛，脑闷。<br>【用法】少少纳鼻中。
葫芦酒	葫芦酒――（鼻窒）<br>（《奇效良方》）<br>【配方】苦葫芦子适量，酒半升。<br>【制法】将苦葫芦子以酒浸之，春三夏一，秋五冬七日，即可应用。<br>【主治】鼻塞眼昏，疼痛脑闷。<br>【用法】少少内鼻中。
虎骨苁蓉酒	虎骨苁蓉酒――（痹证）<br>（《圣济总录》）<br>【配方】虎胫骨（酥炙）、黄芪、酸枣仁（炒）、桔梗、茯神、羌活、石菖蒲（米泔水浸一宿切焙）、肉苁蓉（酒浸一宿）、熟地黄、制附子、萆、石斛、防风各30克，羚羊角15克，远志（去心）、川芎、牛膝（酒浸焙）各30克，好酒2公斤。<br>【制法】将上药共碎细，以生白布袋盛，置于净器中，注酒浸之，密封器口，春夏3日，秋冬7日即可取用。<br>【主治】腰膝风痹，皮肤麻木不仁，步履艰难，心神恍惚，怔忡健忘，头晕目眩。<br>【用法】每次空腹温饮1-2杯，每日3次。<br>说明：酒尽再添，服完，取渣焙干为末，每服6克，酒调下，每日3次。
虎骨当归酒	虎骨当归酒――（痹证）<br>（《太平圣惠方》）<br>【配方】虎胫骨（炙酥黄）60克，制附子15克，当归35克，清酒1公斤。<br>【制法】上药共为细末，用白布袋盛，置于净器中，注酒浸之，封口，春夏3日，秋冬7日即可取用。<br>【主治】腰脚寒冷痹痛。<br>【用法】每日空腹温饮1小杯，不耐酒者，随意饮之。
虎骨地黄酒	虎骨地黄酒――（关节疼痛）<br>（《圣济总录》）<br>【配方】虎骨（酥炙）45克，干姜（炮）、川芎、地骨皮、白术、五加皮各30克，枳壳24克，丹参60克，熟地黄45克，清酒1.5公斤。<br>【制法】将上药粗捣碎，用生白布袋贮，置于净器中，酒浸4宿后开取。<br>【主治】肝虚劳损，关节疼痛，筋脉挛急。<br>【用法】每日空腹温饮1杯，渐加至2杯。<br>说明：酒尽再添，味薄即止。
虎骨杜仲酒	虎骨杜仲酒――（半身不遂）<br>（《圣济总录》）<br>【配方】虎胫骨（炙酥）、石斛、石楠叶、防风、当归、茵芋叶、杜仲（酒炒）、川牛膝（酒炒）、巴戟天（去心）各30克，酒2公斤。<br>【制法】将上药捣碎如麻豆大，白布袋盛，置于净器中，注酒渍10日后即成。<br>【主治】中风偏枯，四肢不遂，筋脉挛急。<br>【用法】每次空心温饮1小杯，每日3次。
虎骨酒（八）	虎骨酒（八）――（筋骨诸病）<br>（《本事方》）<br>【配方】虎胫骨（真者）、萆、仙灵脾、薏苡仁、牛膝、熟地黄各二两。<br>【制法】上药细v，绢袋盛，浸酒二斗，饮一盏，入半盏，可得百日。妇人去牛膝。<br>【主治】祛风补血益气，壮筋骨，强脚力。<br>【用法】每饮一盏，另入酒半盏，服百日。<br>说明：《普济方》同上。
虎骨酒（二）	虎骨酒（二）――（关节疼痛）<br>（圣济总录）<br>【配方】虎骨（酒涂炙）三两，干姜（炮）二两，芎、地骨皮、白术（v）、猪椒根（v洗）、五加皮各二两，枳壳（去襄麸炒）一两半，丹参四两，熟干地黄（切焙）三两。<br>【制法】上一十味，粗捣筛，用生绢袋贮，以清酒三斗浸四宿。<br>【主治】肝虚劳损，关节疼痛，筋脉挛急。<br>【用法】每日空腹服一盏，加至二盏。<br>说明：一方自术、猪椒根、五加皮各用二两半，熟干地黄用一两。每日空服温服半盏，渐加至一盏。余同上。
虎骨酒（六）	虎骨酒（六）――（筋骨诸病）<br>（《海上方》）<br>【配方】虎腰脊骨一具，前两脚全骨一具，无灰浓酒适量。<br>【制法】将上二味并于石上，以斧捶碎，安铁床上，文炭火炙，待脂出，则投入酒中密封，春夏七日，秋冬三七日。<br>【主治】筋骨疼痛。<br>【用法】任情日饮三度。患十年以上者不过三剂，七年以下者，一剂必瘥。
虎骨酒（七）	虎骨酒（七）――（中风）<br>中风病出《内经》邪气藏府病形等篇，亦称卒中，有中经络、中脏腑之风。中经络者但见口眼歪斜，肌肤麻木，半身不遂，言语不利等症，一般无神志改变；中脏腑者猝然昏仆，不省人事，并见中经络症状。药酒主要用于治疗中经络诸症，常用药物如：当归、川芎、黄芪、菖蒲、牡蛎、牛膝、赤白芍、石斛、人参、细辛、白茯苓、甘菊花、山茱萸、生干熟地、鼠粘子、枸札子、晚蚕沙、虎胫骨、秦艽、紫苑、白蒺藜、狗脊、蛇床子、附子、肉苁蓉、天雄、兔丝子、白术、杜仲、白芷、全蝎、天麻、白花蛇等。<br>（《普济方》）<br>【配方】茄子根（净洗蒸过九月十月者曝干）五两，鼠粘子（炒）、蔓荆子各一两，大麻子、晚蚕砂各半升，苍耳子、枸杞子（蒸）各半升，秦艽、萆各二两，生牛蒡叶一握，虎骨二两。<br>【制法】上用绢袋盛，于大罐内以酒浸，封闭不令失气，二七日开，不令面向瓶口，恐药触人。<br>【主治】中风瘫痪。<br>【用法】每服一盏，一日三服。<br>说明：《普济方》注出《医学切问》）。
虎骨酒（十一）	虎骨酒（十一）――（关节疼痛）<br>（《本草纲目》）<br>【配方】虎胫骨（炙黄捶碎）一具。<br>【制法】上同曲、米如常酿酒，亦可浸酒。<br>【主治】臂胫疼痛，历节风，肾虚，膀胱寒痛。<br>【用法】饮用。<br>说明：本方见《本草纲目》卷二十五附诸药酒条下。
虎骨酒（四）	虎骨酒（四）――（关节疼痛）<br>（《三因极一病证方论》）<br>【配方】虎骨（炙焦碎如大豆）五两，丹参二两，地骨皮、干姜、芎各一两，熟地黄一两三分，猪椒根、五加皮、枳实（麸炒去瓤）、白术各两一分。<br>【制法】上为v散，以绢袋盛，淳酒四斗，浸四日。<br>【主治】肝劳虚寒，口苦，关节疼痛，筋挛缩，烦闷。<br>【用法】初服二三合，渐加至一盏，日再服，食前。
虎骨酒（五）	虎骨酒（五）――（腰脚疼痛诸病）<br>（《普济方》）<br>【配方】虎骨一具，虎胫二茎。<br>【制法】上酥炙黄捶碎，同无灰酒三斗，密封七日。<br>【主治】腰脚疼痛挛痹，不得屈伸，及腿膝冷麻。<br>【用法】空心晚食温之，随意饮。<br>说明：《普济方》注“出本草方”。
虎骨酒（一）	虎骨酒（一）――（筋骨诸病）<br>（《备急千金要方》）<br>【配方】虎骨一具。<br>【制法】炭火炙令黄色，捶刮取净捣碎得数升，清酒六升浸五宿。<br>【主治】骨髓疼痛，风经五脏。<br>【用法】随性多少稍饮之。<br>说明：《普济方》注：“……清酒六升，于磁瓶中浸，密封，春夏七日，秋冬二七日，夜开取浸五宿。一方治历节风，涂酥炙黄用”治“骨髓疼痛，风经五脏，男女皆可服”。“易曰：虎啸风生，龙吟云起。此亦有情与无情相感，治风之效，故亦无疑。”余同上。
虎骨酒补方	虎骨酒补方――（关节疼痛）<br>（《备急千金要方》）<br>【配方】虎骨（炙焦碎如雀头）一升，丹参八两，干地黄七两，地骨皮、干姜、芎各四两，猪椒根、白术、五加皮、枳实各五两。<br>【制法】上十味口父咀，绢袋盛，以酒四斗浸四日。<br>【主治】肝虚寒劳损，口苦，关节骨疼痛，筋挛缩烦闷。<br>【用法】初服六七合，渐加至一升、日再服。
虎骨酒法	虎骨酒法――（筋骨诸病）<br>（《普济方》）<br>【配方】虎胫骨、新芍药。<br>【制法】以无灰酒浸，春夏七日，秋冬二七日。浸后，须以银石器盛，于慢火上温养三日两日，即得服。一方有黄羚羊角一大两。<br>【主治】肾经疼痛，不得屈伸，走注痛苦，不问浅深。<br>【用法】饮之。<br>说明：《普济方》注出“本草”。
虎骨羚羊酒	虎骨羚羊酒――（关节疼痛）<br>（《普济方》）<br>【配方】虎胫骨（捣碎炙黄）白芍各30克，羚羊角15克，酒0.5公斤。<br>【制法】将上药共碎为末，白布包，置净器中，用酒浸之，7日后即成。<br>【主治】肝虚劳损，口苦，关节疼痛，筋脉挛缩。<br>【用法】每日空腹饮1杯，酒尽再添，换3次即止。
虎骨木瓜酒	虎骨木瓜酒――（痹证）<br>（《普济方》）<br>【配方】虎骨（酥炙）30克，木瓜90克，川芎、川牛膝、当归、天麻、五加皮、红花、川断、白茄根各30克，玉竹60克，秦艽、防风各15克，桑枝（切碎）120克，高粱酒2.5公斤。<br>【制法】将上药共捣为粗末，白夏布袋盛，置净器中，用酒浸泡7日，滤清加冰糖250克。<br>【主治】风寒湿邪侵入经络<br>【用法】任量饮之，不拘时。
虎骨续断酒	虎骨续断酒――（腰脚疼痛诸病）<br>（《太平圣惠方》）<br>【配方】虎胫骨、熟地各30克，续断、赤箭、党参、桂心、当归、萆、川芎、酸枣仁（炒）、山萸肉、五味子、漏芦、五加皮、制附子、仙灵脾、骨碎补各15克，荆芥、川椒各7.5，海桐皮、肉苁蓉、森香各15克。乌蛇（去头尾，焙干）60克，石斛、防风、牛膝各15克，酒2公斤。<br>【制法】将上药共捣碎，用生白布袋盛，置净器中，以酒浸泡，封口，7日后开取，去渣备用。<br>【主治】肾虚中风，腰脚疼痛无力。<br>【用法】每食前温饮10-20毫升，每日3次。
虎胫骨酒	虎胫骨酒――（半身不遂）<br>（《重订严氏济生方》）<br>【配方】石斛（去根）、石楠叶、防风（去芦）、虎胫骨（酥炙）、当归（去芦）、茵芋叶、杜仲、川牛膝（去芦）、芎、金毛狗脊（燎去毛）、川续断、川巴戟（去心）各一两。<br>【制法】上件，锉如豆大，以绢囊盛药，以酒一斗，渍之十日。<br>【主治】中风偏枯半死，行劳得风，若鬼所击，四肢不遂，不能行步，但是一切诸风挛急之证，悉皆治疗。<br>【用法】每服一盏，荡热服，不拘时候。<br>说明：《普济方》同上。
虎胫骨酒方	虎胫骨酒方――（关节疼痛）<br>（《太平圣惠方》）<br>【配方】虎胫骨（涂酥炙令黄）一具。<br>【制法】上药捣碎，用米曲一依常法酿酒，二十日熟。<br>【主治】骨极，膝胫　疼，肢节多痛。<br>【用法】每取一中盏，空心及晚食前，暖过服之。
虎鹿二仙酒	虎鹿二仙酒――（痿证）<br>（验方）<br>【配方】虎骨500克，鹿筋1000克，枸杞、龙眼肉各500克，淮牛膝、当归各250克，白蜜500克。<br>【制法】先将虎骨、鹿筋分别用开水煮一片刻，洗净，煎熬成膏。再将枸杞等药熬成膏，诸膏合在一起，加白蜜，再略熬成膏。以15克膏用酒1000克的比例，用好烧酒浸泡。及至用时，加入适量好黄酒掺和饮用。<br>【主治】肝肾不足，风寒入侵，腰膝痿软，举步无力，筋骨关节疼痛等症。<br>【用法】夏季饮用量宜少，冬季饮用量宜略多，酌量及习惯使用。<br>说明：湿热浸淫，肺热伤津所致的痿证不可使用。
虎潜酒	虎潜酒――（痹证）<br>（《喻选古方试验》）<br>【配方】虎胫骨1对，龟版90克，破故纸、牛膝=、生地、骨碎补、枸杞子各45克，当归90克，羌活、川续断、桑寄生、海风藤、红花、白茯苓、杜仲各30克，川芎、丹参各21克，乳香、没药、赤何首乌、小茴香、狗脊各18克，独活30克，好酒10公斤。<br>【制法】将上药切成片，入绢袋内，悬于酒坛中，注以陈年好酒，封固，隔水煮1.5小时，然后取出埋土中两天后即可饮用。<br>【主治】风湿痹痛日久不愈，筋骨痿软者。<br>【用法】酌量饮用。饮后的药渣可再注酒6公斤，按上法制。<br>说明：阴虚火旺者不宜服用。
虎杖酒	虎杖酒――（关节疼痛）<br>（《新医药学杂志》）<br>【配方】虎杖根250克，白酒750克。<br>【制法】将上药洗净切片，置酒中浸泡，密封，半月后即可饮用，用时可加少量赤砂糖使酒着色。<br>【主治】风湿性关节炎，类风湿，腰椎肥大，骨关节炎等症。<br>【用法】成人每次饮15克，日2。亦可佐餐服用。<br>说明：对酒过敏或患有慢性肝病者禁用；妇女行经期停用。
花蛇酒	花蛇酒――（痹证）<br>（《本草纲目》）<br>【配方】白花蛇肉一条。<br>【制法】上用袋盛，同曲置于缸底，糯饭盖之，三七日，取酒饮。<br>【主治】诸风，顽痹瘫缓，挛急疼痛，恶疮疥癞。<br>【用法】饮用。<br>说明：本方见《本草纲目》卷二十五附诸药酒条下。
华佗辟疫酒	华佗辟疫酒――（疫毒）<br>疫以有一定季节性或传染性为特点，早在《内经》就有“五疫之至，皆相染易，无问大小，症状相似”的记载。毒可随疫而生，亦可随其它邪气产生，随疫而生者谓之疫毒。<br>疫毒伤人，临床表现以起病急、传变快，表证短暂，较快出现高热、烦渴等症状，进而出现痉、阙、闭、脱等危象为特点。由于其起病急，传变快，所以古人在防治疫毒的过程中，特别重视疫毒的预防。在历代防治疫毒的药酒中，不但有治疗山瘴岚毒者，如华佗辟疫酒、生牛蒡根酒等；治中水毒者，如水蓼酒；治腹内诸毒，并解一切毒者，如二藤酒。而且研制了不少具有预防作用的药酒，如防风酒、岁旦屠苏酒、屠苏酒等，为我们留下了宝贵的遗产。<br>（《华佗神方》）<br>【配方】大黄、白术各15克，桂心18克，桔梗、蜀椒各15克，川乌6克，菝葜12克，白酒400毫升。<br>【制法】将上药用夏白布袋盛贮，悬于井底，10日后取出，置白酒中，煎数沸。<br>【主治】南方山瘴岚毒侵入人体，合家同病。<br>【用法】每早服1小蛊。
化瘀止痛酒	化瘀止痛酒――（跌打损伤）<br>（验方）<br>【配方】生地黄汁250毫升，酒500克，丹皮、肉桂（去粗皮）、桃仁（去皮尖炒）各30克。<br>【制法】将桃仁、丹皮、内桂捣为细末，与生地黄汁同酒煎数10沸，取下候冷，去渣，收贮备用。<br>【主治】伤损瘀血在腹。<br>【用法】每次温饮1-2小杯，每日3次，不拘时候。孕妇忌服。
槐花酒	槐花酒――（痈疽、疮疡、发背）<br>（《证治准绳》）<br>【配方】槐花120克，黄酒500毫升。<br>【制法】将槐花微炒黄，乘热入酒，煎数10余沸，去渣。<br>【主治】疮毒已成末成，但痛者。<br>【用法】热服取汗，示成者2、3服，已成者1、2服即愈。<br>说明：《医部全录》同上。
槐酒	槐酒――（痔疮）<br>（《外台秘要》）<br>【配方】槐东南枝（细v）一石，槐东南根（细v）二石，槐白皮（v）一石，槐子一石。<br>【制法】上四味，大釜以水十六石，煮取五石，澄取渍，更煎，取一石六斗，炊两石黍米，上曲二斗酿之，搅令调，封泥七日。<br>【主治】主五痔五十年不瘥。<br>【用法】酒熟取清饮，日三四，适寒温量性，常令小小醉耳，合时更煮滓，取汁淘米，洗器，不得用生水。
槐枝酒	槐枝酒――（痹证）<br>（验方）<br>【配方】槐枝（切碎）1公斤，曲350克，糯米6公斤。<br>【制法】将槐枝煮汁，同曲、米如常法酿酒，酒成压去糟渣。<br>【主治】风痹，肢体疼痛，痿弱无力。<br>【用法】随量徐徐温饮，不拘时候。
槐枝酒方	槐枝酒方――（痔疮）<br>痔疮是指直肠下端粘膜下和肛管皮肤下痔静脉扩大和曲张所形成的静脉团。中医将肛门内外有小肉突出如峙者，统称为“痔疮”。本病多由平素湿热内积，过食辛辣，久坐久立，或妇女临产用力过甚，经常便秘，或久泻久痢等因素引起，以致体内生风化燥，湿热留滞，浊气瘀血下注肛门而成。按其生产部位，有内痔、外痔，内外痔（混合痔）之分。本病治疗原则主要以清热凉血，润燥疏风为主。其治疗方法也很多，如内治法、针刺法、炙法、熨法、熏洗法、结扎法、枯痔法等等。以下再介绍几种药酒疗法，以丰富本病的治疗，可供选用。<br>（《太平圣惠方》）<br>【配方】槐枝叶（细研）二，槐子仁（捣碎）二升，苍耳茎叶（细v）一　。<br>【制法】上诸药，入于釜中，以水一硕，煮取五，去滓澄清，看冷暖，入曲末五斤，糯米五，蒸令热，都拌和，入瓮，如法盖覆，候酒熟。<br>【主治】治痔疾，数年不瘥。<br>【用法】任性温温服之，常令似醉，久服神效。<br>说明：《普济方》同上。
槐子酒	槐子酒――（痔疮）<br>（《备急千金要方》）<br>【配方】槐东南枝（细v）一石，槐东南根（v）三石，槐子二斗。<br>【制法】上三味以大釜中安十六斛水，煮取五斛澄取清，更煎取一石六斗，炊两斛黍米，上曲二十斤酿之，搅令调，封泥七日。<br>【主治】主五痔十年不瘥者。<br>【用法】酒熟取清，饮适性，常令小醉。<br>说明：《普济方》注一方有槐柏皮（细v）一石，余同上。
还睛神明酒	还睛神明酒――（内外障翳）<br>（《圣济总录》）<br>【配方】黄连18克，石决明、草决明、生姜、石膏、黄硝石、薏苡仁、秦皮、山芋肉、当归、黄芩（去黑心）、沙参、朴硝、炙甘草、车前子、淡竹叶、柏子仁、防风、制乌头、辛荑、人参、川芎、白芷、瞿麦穗、桃仁（去皮尖）、细辛、地肤子各10克，龙脑1.5克，白芍、泽泻、肉桂、芥子各10克，丁香6克，珍珠（无孔者）3颗，醇酒2.5公斤。<br>【制法】将上药共捣碎，用纱布包贮，以酒浸于净器中，封口，春夏7日，秋冬14日后开取，去渣备用。<br>【主治】眼睛视物昏暗，经年不愈，内外障失明。<br>【用法】每日饭后温饮1-2小酒杯，可渐渐增加，勿使醉吐。
还睛神明酒方	还睛神明酒方――（内外障翳）<br>本病多因禀赋不足、脾虚失养所致，以入夜至暗处视物不明为主要表现的目疾。往往临床表现为初起暗处不见，亮处尚明，入暮视物不清，白日视物尚清，惟见顶上之物。日久视野缩小，双目呆滞，行动缓慢，常碰撞身边物体，至晚期多失明。<br>（《圣济总录》）<br>【配方】黄连（去须）五两、石决明、草决明、生姜、石膏、黄硝石、蕤仁、秦皮、山茱萸、当归、黄芩（去黑心）、沙参、朴硝、甘草（炙）、芍药、泽泻、桂（去粗皮）、荠子、车前子、淡竹叶、柏子仁、防风（去叉）、乌头（去皮脐）、辛荑、人参、芎、白芷、瞿麦穗、桃仁（去皮尖双仁炒）、细辛（去苗叶）、地肤子各三两，龙脑三钱，丁香二钱，珍珠（无孔者）二十五颗。<br>【制法】上三十四味，口父咀绢囊盛，用好酒五斗，瓮中浸之，春夏一七日，秋冬十四日。<br>【主治】治眼昏暗及内外障失明等，惟不疗枯损睛破者，但黑白不损，服此药更生，瞳子平复如故。<br>【用法】食后服半合，勿使醉吐，稍稍增之，百日后目明如旧。<br>说明：《普济方》同上。
还童酒	还童酒――（筋骨诸病）<br>（《回生集》）<br>【配方】熟地90克，生地、全当归各120克，川萆60克，羌活、独活各30克，怀牛膝60克，秦艽90克，苍术、广皮、川断各60克，麦冬90克，枸杞60克，川桂皮15克，小茴香、乌药各30克，丹皮、宣木瓜各60克，五加皮120克，陈酒25公斤。<br>【制法】将上药用绢袋盛，浸于酒中，封固，隔水加热1.5小时，晾凉，再将酒坛埋入地下7天，即可饮用。<br>【主治】风湿筋骨不利，兼有面色不华等阴血不足现象者。<br>【用法】每日早、晚各2小盅。
黄连酒方	黄连酒方――（疟疾）<br>（《圣济总录》）<br>【配方】黄连（去须　）一两，常山（细）一两。<br>【制法】上二味，以酒一升半浸之经宿。<br>【主治】治久疟。<br>【用法】发前煎取一盏，分二服，临发更一服，有热当吐，有冷当下。<br>说明：《普济方》注出《肘后方》，内容同上。
黄芪杜仲酒	黄芪杜仲酒――（阳萎）<br>（《太平圣惠方》）<br>【配方】黄芪30克，萆、防风各45克，牛膝60克，桂心30克，石斛60克，杜仲45克，肉苁蓉（去皮炙干）60克，制附子、山萸肉、石楠、白茯苓各30克，酒1.75公斤。<br>【制法】将上药共为粗末，白布袋盛，用酒浸于瓷瓶中，密封瓶口，3日后开封去渣。<br>【主治】肾阳虚损，气怯神疲，腰膝冷痛，阳萎滑精。<br>【用法】每于食前温饮1-2杯。
黄芪酒（四）	黄芪酒（四）――（中风）<br>（《普济方》）<br>【配方】黄芪、独活（去芦头）、桂（去粗皮）、蜀椒（去开口并且炒出汗）、牛膝（去芦头）、白术、蔹根各三分，防风（去叉）四两，芎、甘草（炙v）、细辛（去苗叶）、山茱萸、附子（炮裂去皮脐）、秦艽（去苗土）、干姜（炮）、当归（切焙）、乌头（炮裂去皮脐）、人参各三两。<br>【制法】上v如麻豆，用生绢袋盛于四斗醇酒内浸三日。<br>【主治】治产后中风偏枯，半身不遂，言语不利，疼痛时作。<br>【用法】每温服一盏，不拘时。
黄芪酒（一）	黄芪酒（一）――（半身不遂）<br>（《千金翼方》）<br>【配方】黄芪、独活、山茱萸、桂心、蜀椒（去目闭口者汗）、白术、牛膝、葛根、防风、芎　、细辛、附子（去皮）、甘草（炙）各三两，大黄一两，干姜二两半，秦艽、当归、乌头（去皮）各二两。<br>【制法】上一十八味，切，以酒三斗渍十日。大虚加肉苁蓉二两，萎蕤二两，石斛二两；多忘加菖蒲二两，紫石英二两；心下水加茯苓二两，人参二两，薯蓣三两。酒服尽后，更以酒三斗渍滓，不尔，可暴干作散。<br>【主治】大风虚冷，淡萜枯脚肿满百病。<br>【用法】一服一合，日三，稍加至五合，夜二服，无所忌。散以酒服方寸匕，日三。
黄芪酒方（一）	黄芪酒方（一）――（产后中风）<br><br>（《圣济总录》）<br>【配方】黄芪、蜀椒（去目并闭口者炒出汗）、白术、牛膝（去苗v）、葛根各三两，防风（去叉）四两，芎、甘草（炙v）、细辛（去苗叶）、山茱萸、附子（炮裂去皮脐）、秦艽（去苗土）、干姜（炮）、当归（切焙）、乌头（炮裂去皮脐）、人参各二两，独活（去芦头）、桂（去粗皮）三分。<br>【制法】上一十八味，v如麻豆，用生绢袋盛，于四斗醇酒内浸三日。<br>【主治】产后中风偏枯，半身不遂，言语不利，疼痛无力。<br>【用法】每温服一盏，不拘时。
黄芪苦酒方	黄芪苦酒方――（汗证）<br>汗证是指人体阴阳失调，营卫不和，腠理开不利而引起汗液处泄的病证。根据其临床表现，汗证又可分为自汗、盗汗、战汗、绝汗、黄汗等。<br>治疗汗证的药酒较少，这里选录的黄芪苦酒方是治疗黄汗的药酒方。<br>（《普济方》）<br>【配方】黄芪五两，芍药（醋炒），桂（去皮）各三两。<br>【制法】上如麻豆，每服五钱匕，苦酒一盏半，煎至七分。一方用苦酒之合，水一盏半，同煎。<br>【主治】黄汗，身体肿，发热汗出而不渴，状如风水，汗水沾衣色黄如药汁，脉自沉。此由汗出入水中浴，水入汗孔，从外而得之。<br>【用法】去滓温服，服之当心烦，苦酒阻故也。<br>说明：《普济方》注出《备急千金要方》。
黄芪石斛酒	黄芪石斛酒――（痹证）<br>（《圣济总录》）<br>【配方】石斛120克，黄芪、党参、防风各45克，丹参、山萸、杜仲、牛膝各60克，细辛30克，天冬70克，生姜90克，薏米、杞果各150克，五味子、茯苓、山药、萆各60克，黄酒3公斤。<br>【制法】将上药共捣为粗末，置净瓶中，用酒浸5天，去渣备用。<br>【主治】正虚风侵，腰脚痹痛，颜面麻痹。<br>【用法】每服2-3杯，加至3-4杯，酒力要相继，不可间断。
黄芪续断酒	黄芪续断酒――（痹证）<br>（《危亦林得效方》）<br>【配方】黄芪、防风、肉桂、天麻、萆、白芍、当归、云母粉、白术各30克，茵芋叶20克，木香、仙灵脾、甘草、续断各30克，好酒2.5公斤。<br>【制法】将上药共碎细，生绢袋盛，用酒浸于净瓶中，7日后开封去渣备用。<br>【主治】风湿痹痛，身体麻木，皮肤搔痒，筋脉拘急，手足不遂，言语謇涩。<br>【用法】每温饮1杯，不拘时候。
黄土酒方	黄土酒方――（产后风痉）<br><br>（《圣济总录》）<br>【配方】灶中黄土、干姜（炮）。<br>【制法】上二味等分，捣罗为散。<br>【主治】产后风痉。<br>【用法】以温酒调一指撮服。<br>说明：《普济方》主治产后风痉不得语，腰背着床不得，口噤。余同上。
黄药子酒（二）	黄药子酒（二）――（瘿瘤）<br>（《医部全录》）<br>【配方】黄药子一升，酒一斗。<br>【制法】将药洗净，v，入酒浸之。<br>【主治】项下瘿气。<br>【用法】每日早晚常服一盏。忌一切毒物及戒怒，仍以线逐日度之，乃知其效也。
黄药子酒（三）	黄药子酒（三）――（瘿瘤）<br>（《斗门方》）<br>【配方】黄药子500克，白酒10升。<br>【制法】将黄药子洗净切片，装入绢袋，浸入酒中，容器封固，冷浸7天后即成。<br>【主治】痰热互结所致的瘿病。<br>【用法】早、晚各1次，每次1-2小盅，应控制饮用量。<br>说明：脾胃虚寒及肝功能不正常者，不宜饮用此酒。
黄药子酒（一）	黄药子酒（一）――（瘿瘤）<br>（《普济方》）<br>【配方】万州黄药子（须紧重者为上，如轻虚即是他州者，其力即慢）三斤。<br>【制法】上须用焙，取无灰酒一斗投药中，泥封固瓶口，以糠火烧一顿饭时，停住，令酒冷。旁边糠火不可多堆，烧酒气香出，瓶头有津，即止火，不待经宿。<br>【主治】治忽生瘿病一二年者。<br>【用法】令患者时时饮一盏，不令绝酒气，经三日后，常把镜自照，觉销即停饮，不尔，便人颈细也。已验如神，忌食毒物。<br>说明：原书无方名，据药味和制法命名。
回阳救急酒	回阳救急酒――（霍乱）<br>（《中医杂志》）<br>【配方】公丁香、肉桂、樟脑各30克，白酒（以南昌酒厂出品的三花酒为良）500毫升。<br>【制法】将上药压碎，装入稀布袋中，浸酒中，宜用瓷坛做容器，密封1个月，然后将酒装入玻璃瓶中备用。<br>【主治】阴寒霍乱。<br>【用法】每次用10-20滴，滴舌面，先含后咽，或以冷白开水冲服。因吐泻不止而转筋者，可用该酒外擦患处。<br>说明：如患者身热，泻下物臭秽难闻，口渴，心烦，腹中绞痛，舌苔黄腻，则属热霍乱，该酒即不适用；有里急后重者，也不可用该酒。
茴桂酒	茴桂酒――（经行后期）<br><br>（《百病饮食自疗》）<br>【配方】小茴香30克，桂枝15克，白酒250克。<br>【制法】将上药用酒浸泡3-6天，即可饮用。<br>【主治】经期延后，色暗红，量少，少腹冷痛，得热稍减，恶寒，面色青白、苔薄白，脉沉迟而紧。<br>【用法】每次饮15-20克，每日2次。
茴香酒（二）	茴香酒（二）――（疝气）<br>（《类编朱氏集验医方》）<br>【配方】茴香。<br>【制法】灯笼草根浑酒，茴香炒碾。<br>【主治】治膀胱偏坠，久不愈者。<br>【用法】用上酒调下茴香末。<br>说明：《普济方》一方同上。
茴香酒（四）	茴香酒（四）――（疝气）<br>（《本草纲目》）<br>【配方】茴香（舶茴尤妙）。<br>【制法】上药浸酒。<br>【主治】治卒肾气痛，偏坠牵引，及心腹痛。<br>【用法】煮饮之。<br>说明：本方见《本草纲目》卷二十五附诸药酒条下。
茴香酒（一）	茴香酒（一）――（跌打损伤）<br>（《普济方》）<br>【配方】破故纸（炒香）、茴香（炒）、辣桂等分。<br>【制法】上为末。<br>【主治】打坠凝瘀，腰疼通用。<br>【用法】每服二钱，热酒调，食产进，故纸主腰痛，主行血。<br>说明：《普济方》注出《太平圣惠方》）。
茴香小雀酒	茴香小雀酒――（疝气）<br>本病是因肠管不收，坠入阴囊所致。以阴囊偏坠有大小，时上时下为主要表现。立则疼痛肿胀，卧则消肿如常。多因劳累、嚎、哭、忿怒、咳嗽加剧。中医学认为疝的发病多与肝经有关。大凡肝郁气滞，或寒滞肝脉，皆可致疝。亦有先天脏气薄弱，不能收摄而致疝者。治疗当分别不同原因，辨证施治。<br>（《普济方》）<br>【配方】舶上茴香三钱，胡椒一钱，缩砂仁、辣桂各二钱。<br>【制法】上为末，以生雀燎毛去肠，拭净洗，用三个，入药于其腹中，麻绳系定，湿纸数重，裹煨香熟。<br>【主治】治肾冷疝气，偏坠急痛。<br>【用法】空心嚼食，温酒送下。<br>说明：《普济方》注出《直指方》。
鸡肠酒	鸡肠酒――（小便频数）<br>小便频数是一症状，在许多疾病中均可见到，对属于下焦虚冷，肾气不固的患者，以及没有其它明显不适，仅见小便频数，为肾气欠固的老年人，适合于用药酒治疗。<br>（《老老余编》）<br>【配方】鸡肠一具。<br>【制法】上洗如常法，v碎炒作霍，以酒着椒葱五味。<br>【主治】治小便数。<br>【用法】食之。
鸡粪酒	鸡粪酒――（产后中风）<br><br>（《备急千金要方》）<br>【配方】鸡粪（熬令黄）一升，乌豆（熬令声绝勿焦）一升。<br>【制法】上三味，以清酒三升半，先淋鸡粪，次淋豆取汁。<br>【主治】主产后中风及百病，并男子中一切风。<br>【用法】一服一升，温服取汗，病重者凡四五日服之。
鸡肝酒（二）	鸡肝酒（二）――（妊娠出血）<br><br>（《普济方》）<br>【配方】鸡肝二个。<br>【制法】上用酒一升，煮熟。<br>【主治】治妊娠下血不止，大效。<br>【用法】共食之。<br>说明：《普济方》注出“济生拔萃方”。方名系笔者命名，原书名“立圣散”。
鸡肝酒（一）	鸡肝酒（一）――（产后血晕）<br><br>（《普济方》）<br>【配方】生鸡肝。<br>【制法】用细断生鸡肝内一斤热酒中讫，漉出滓，停酒冷服。<br>【主治】治产后血晕绝。<br>【用法】如人饮一服，不能饮者，可数口进。<br>说明：《普济方》注出“肘后方”。方名系笔者所加。
鸡翎酒	鸡翎酒――（妊娠出血）<br><br>（《普济方》）<br>【配方】鸡翎。<br>【制法】上烧灰末，温酒调服。<br>【主治】疗妊娠尿不知出时，胎漏故也。亦治妊娠下血，疼痛不止。亦治小便不禁。<br>【用法】温酒调服方寸匕。
鸡屎白豆淋酒方	鸡屎白豆淋酒方――（破伤风）<br>（《圣济总录》）<br>【配方】鸡屎白一合，大豆六合。<br>【制法】上二味，炒令大豆焦黑，次入鸡屎白同炒，乘热泻于三升酒中，密盖良久，滤去滓。<br>【主治】治因金疮中风反张者。<br>【用法】每服五合，如人行五里，更一服，汗出佳，未差即更作服之，以汗出为度，服后宜吃热生姜稀粥投之。<br>说明：《普济方》和《奇效良方》均同上。
鸡血藤酒	鸡血藤酒――（痹证）<br>（验方）<br>【配方】鸡血藤胶250克（或鸡血藤片400克），醇酒1公斤。<br>【制法】将上药置于净瓶中，用酒浸之，7日后可用。<br>【主治】筋骨不舒疼痛，腰膝冷痛，跌打损伤，风寒湿痹，转筋虚损，手足麻木，妇女经水不调。<br>【用法】每次空心温服1-2杯，每日2次。
鸡子酒	鸡子酒――（妊娠出血）<br><br>（《永乐大典》）<br>【配方】鸡子五枚（取黄）。<br>【制法】上取好酒一盏，同煎如稀饧。<br>【主治】妊娠血下不止。<br>【用法】顿服之，未差更作服之，以差为度。
鸡子酒方	鸡子酒方――（难产）<br><br>（《圣济总录》）<br>【配方】鸡子（去清）一枚。<br>【制法】上一味，以苦酒半盏，投鸡子于酒中。<br>【主治】治二三日不产。<br>【用法】饮之立产。<br>说明：《普济方》载本方同上，谓鸡子用三枚亦得。
极熟豉酒	极熟豉酒――（疫毒）<br>（《太平圣惠方》）<br>【配方】香豉500克，米酒2公斤。<br>【制法】将上药用酒浸于瓶中，3日后取饮。<br>【主治】南方瘴气形成的腰脚酸痛，心神烦闷。<br>【用法】随量饮之，每日不拘时候。
集验疗白癞酿酒方	集验疗白癞酿酒方――（癞病）<br>（《外台秘要》）<br>【配方】苦参二斤，露蜂房（炙）五两。<br>【制法】上二味切，以水三斗，法曲二斤，和药渍，经三宿，绞去滓，炊黍米二斗，酿准常法作酒，候酒熟压取。<br>【主治】疗白癞。<br>【用法】先食一饮一鸡子，日三，稍稍增之，以瘥为度。
集验疗瘿酒方	集验疗瘿酒方――（瘿瘤）<br>本病是指人体颈部囊肿或肿块。证见色红而高突，有如“缨络”状，故名郁怒忧思过度，肝失条达，脾失健运，导致气滞、痰凝、血瘀结于颈部而成，生活在山区的与水土有关。根据发病情况的不同，可分为气瘿、血瘿、肉瘿、筋瘿、石瘿等。气瘿包括单纯性甲状腺肿，血瘿则包括血管瘤，肉瘿相当于甲状腺腺瘤或甲状腺囊肿，筋瘤浅表静脉瘤、静脉曲张等，石瘿则包括甲状腺癌等症。治宜疏肝理气解郁化瘀，活血软坚和外治等法。<br>（《外台秘要》）<br>【配方】柳根三十斤。<br>【制法】以水一斛，煮得五升，同米三斗酿之。<br>【主治】疗瘿。<br>【用法】酒成，先食服一升，日三。
寄生黑豆酒	寄生黑豆酒――（产后风痉）<br><br>（验方）<br>【配方】黑豆250克，桑寄生200克，酒1.5公斤。<br>【制法】将桑寄生碎细，用酒浸于净器中，再净黑豆炒香，投入酒中，5日后，去渣备用。<br>【主治】产后中风，腰背疼痛，口噤。<br>【用法】每温饮1小杯，不拘时候。
蓟根酒方	蓟根酒方――（崩漏）<br><br>（《千金翼方》）<br>【配方】大小蓟根（切）各一斤。<br>【制法】上二味，以酒一渍五宿。<br>【主治】治妇人崩中去血不止。<br>【用法】随意多少服之。
加皮丹参酒	加皮丹参酒――（关节疼痛）<br>（《圣济总录》）<br>【配方】五加皮150克，枳刺60克，丹参90克，桂皮、当归（炒）、炙甘草各30克，制附子10克，秦椒（去目及闭口者并炒出汗）、白藓皮各31克，薏苡仁15克，大麻仁60克，木通31克，川芎、干姜（炮）各10克，白酒1.75公斤。<br>【制法】将上药用酒浸泡，春夏4日，秋冬6日后开取，去渣备用。<br>【主治】关节冷痛，颜色苍白，手足拘挛，腹中转痛。<br>【用法】每空腹温饮10-20毫升，渐加至20-30毫升，以愈为度。
剪草浸酒	剪草浸酒――（疥癣病）<br>（《普济方》）<br>【配方】剪草。<br>【制法】用剪草浸酒。<br>【主治】治虱疮疥癣。<br>【用法】服之。<br>说明：《普济方》注出“本草方”。
见肿消酒	见肿消酒――（跌打损伤）<br>（《陕甘宁青中草药选》）<br>【配方】见肿消2两，白酒1斤<br>【制法】浸泡5-7天饮用。<br>【主治】跌打损伤内有瘀血，外有出血者，风湿腰腿痛。<br>【用法】每日服10毫升，1日3次。
姜附酒	姜附酒――（呃逆呕吐）<br>（验方）<br>【配方】干姜60克，制附子40克，黄酒500克。<br>【制法】上2味，共碎细，同酒置于净瓶中，浸渍，封口，7日后开取饮用。<br>【主治】心腹冷痛，呃逆呕吐，泄泻，痢疾，完谷不化，寒饮喘咳，痰白而清稀，肢冷汗出。<br>【用法】每次食前温饮1-2杯，每日3次。<br>说明：阴虚内热腹痛及孕妇不宜用。
姜酒	姜酒――（半身不遂）<br>（《本草纲目》）<br>【配方】姜。<br>【制法】以姜浸酒，或用姜汁和曲，造酒如常。<br>【主治】偏风，中恶疰忤，心腹冷痛。<br>【用法】暖服一碗即止（指姜浸酒），姜汁和曲造酒酌饮之。<br>说明：本方见《本草纲目》卷二十五附诸药酒条下引孟洗曰。
姜汁酒方	姜汁酒方――（胎死腹中）<br><br>（《圣济总录》）<br>【配方】生姜汁（作三服）六分盏，鸡子黄（作三服）三枚。<br>【制法】上二味，先用酒三分盏，醋二分盏，同煎沸，入姜汁二分盏，又煎令沸倾出，用鸡子黄一枚，乘热打转。<br>【主治】治子死腹中，气血凝冷难下。<br>【用法】稍热服之，须臾未下，尽此三服。
僵蚕豆淋酒	僵蚕豆淋酒――（产后中风）<br><br>（验方）<br>【配方】黑豆250克，僵蚕250克，酒1公斤。<br>【制法】将黑豆炒焦，用酒淋之，绞去渣，贮净瓶内，加入僵蚕，5日后取用。<br>【主治】产后中风诸病。<br>【用法】每温饮50毫升，日2次，夜1次。
胶艾酒	胶艾酒――（胎动不安）<br><br>（《备急千金要方》）<br>【配方】阿胶30克，艾叶、川芎、芍药、甘草各20克，当归、生地各30克，黄酒、水各250克。<br>【制法】上药用黄酒、水煮取250克，分3份。<br>【主治】妊娠顿仆失踞，胎动不安。<br>【用法】每日早、午、晚各饮1份。
椒柏酒	椒柏酒――（疫毒）<br>（《中国医学大辞典》）<br>【配方】椒37粒，侧柏叶7枝，酒500克。<br>【制法】将上药用酒浸于净瓶中，7日后取用。<br>【主治】瘴气，瘟疫等时气。<br>【用法】每日早晨空心温饮1杯。
解酒毒方	解酒毒方――（解酒毒）<br>酒毒是由于饮酒过度，以致蕴湿酿热，酒毒积聚，表现为面目红赤，烦热躁动，心中懊，呃逆恶心，时时欲吐，胡言乱语，或哭笑无常，醉酒神昏等，甚则可因酒精中毒致死。《金匮要略・黄疸病脉证并治》中所述之酒疸（即酒黄疸）一病，即属于酒毒范畴。这里介绍的解酒毒药酒，常用药有柑子皮、豆豉、葱白、菘菜子、干蔓菁根、柏子仁、大麻子仁、葛根汁、楷杷叶汁、葛根花及小豆花等，文献记载不仅能解酒毒，治疗酒毒所致诸症，而且还有使“饮酒令人不醉”的作用。<br>（《太平圣惠方》）<br>【配方】柑子皮（洗焙干）二两。<br>【制法】上捣细罗为散，遇酒醉不醒，用之。<br>【主治】解酒毒，或醉昏闷烦满，要易醒宜服此方。<br>【用法】炒三钱，以水一中盏，煎三五沸，入少盐花，如茶旋呷，未效更服。
芥子酒熨方	芥子酒熨方――（失音）<br>（《圣济总录》）<br>【配方】白芥子（研碎）五合。<br>【制法】上一味，用酒煮令半熟，带热包裹。<br>【主治】治伤寒后肺中风冷，失音不语。<br>【用法】熨项颈周遭，冷则易之。<br>说明：《普济方》同上。
蚧参酒	蚧参酒<br>【来源】《圣济总录》<br>【原料】蛤蚧1对，人参30克，甘蔗汁100毫升，白酒1.5升。<br>【制作】将甘蔗切成小段，榨汁备用；将蛤蚧去头足，粗碎；将人参碎成小段；两药用纱布袋盛之；将白酒、甘蔗汁倒入坛内搅匀，放入药袋，加闰密封，置阴凉处，；经常摇动，20日后即可开封取饮。<br>【功效】元气亏损，久病体虚，精神不振，失眠健忘，气短乏力，喘促不止等症。<br>【用法】每日早、晚各1次，每次饮服10-20毫升。<br>【宜忌】<br>【注释】方中蛤蚧补肺、肾，益精血，止咳嗽；人参补元气，宁神益智；甘蔗汁既能生津，又能解酒之醉，同酒伍用，有相得益彰之妙。诸药制酒，共奏滋补强壮之功。此酒主要用于元气亏损，久病体弱的患者。中老年体虚无力者，经常适量饮用此酒，有强壮身体的功效。对于虚性咳喘者，白酒可改为米酒、黄酒配制他药。
金花酒	金花酒――（口疮）<br>（《景岳全书》）<br>【配方】黄柏90克，黄连15克，栀子30克，江米酒500毫升。<br>【制法】将上药用酒煎数百沸，去渣，候凉备用。<br>【主治】口舌生疮，牙龈出血。<br>【用法】每空心饮20毫升，不拘时候，以愈为止。
金星酒方	金星酒方――（痈疽、疮疡、发背）<br>（《圣济总录》）<br>【配方】金星草（和根净洗慢火焙干）四两，甘草一钱。<br>【制法】上二味，捣罗为末，分作四帖，每帖用酒一升，煎三两沸后用之。<br>【主治】治五毒发背。<br>【用法】更以冷酒二升相和，入瓶器中封却，时取饮之。<br>说明：金星草即凤尾草。
金牙侧子酒	金牙侧子酒――（痹证）<br>（《外台秘要》）<br>【配方】侧子（炮）、牛膝、丹参、山茱萸、蒴　根、杜仲（去皮，炙）、石斛各四分，防风、干姜、椒（汗）细辛、独活、秦艽，桂心、芎　、当归、白术、茵芋（炙）各三分，五加皮五分，薏苡仁（碎）一升。<br>【制法】上二十味并细切，绢袋盛，清酒四五升，渍五六宿。<br>【主治】风湿痹不仁，弱不能行。<br>【用法】初服三合，日再服，稍加，以知为度，忌猪肉、冷水、生葱、生菜、桃李、雀肉等。
金牙酒（八）	金牙酒（八）――（脚气）<br>（《普济方》）<br>【配方】金牙、茵芋、细辛、干姜、干地黄、防风、附子（去皮）、地肤子、蒴、升麻各四两，人参二两，独活一斤，牛膝五两，石斛五两。<br>【制法】上切，以酒四斗渍之六七日。<br>【主治】最为疗脚气屈弱之要，五脏心下坚满，惊悸不宁。亦疗口不能语，脚屈至良久。<br>【用法】服二三合，稍加之。忌猪肉冷水生菜芜荑。
金牙酒（六）	金牙酒（六）――（脚气）<br>（《圣济总录》）<br>【配方】金牙、细辛（去苗叶）、茵芋、防风（去叉）、附子（炮裂去皮剂）、干姜（炮）、地肤子、蒴　、生干地黄（焙）、升麻、人参各二两，牛膝、石斛（去根）各三两，独活（去芦头）六两。<br>【制法】上一十四味，口父咀，用生绢袋盛，入净瓮中，以清酒三斗浸密封。春夏五日，秋冬七日。<br>【主治】治风毒脚气，上攻心脾，口不能语。<br>【用法】随量饮之，不拘时，常令酒力相续。
金牙酒（七）	金牙酒（七）――（脚气）<br>（《圣济总录》）<br>【配方】金牙（捣碎）、牛膝（去苗）、石斛去根）各三两，细辛、茵芋、干姜（炮裂）、防风（去芦头）、蛇床子各一两，生干地黄、附子（炮裂去皮脐）、莽草各二两。<br>【制法】上药细v，以生绢袋盛，用酒二斗，渍六七日。<br>【主治】治脚气屈弱，言语謇涩。<br>【用法】每于食前，随性暖服之。<br>说明：①《太平圣惠方》同上。②《普济方》方中有独活五两，茵芋用量为二两，余均同上。
金牙酒（三）	金牙酒（三）――（疫毒）<br>（《圣济总录》）<br>【配方】金牙一斤，侧子（炮裂去皮脐）、附子（炮裂去皮脐）、天雄（炮裂去皮脐）各三两，人参二两半，肉苁蓉（切焙）、白茯苓（去皮）各二两，独活（去芦头）八两，当归（切焙）、白术、防风（去叉）、黄芪、山芋、细辛（去苗叶）、桂（去粗皮）、茵芋（炙）、石楠（微炙）、芎　、地骨皮、五加皮（汤浸灸）各三两，磁石（煅醋淬七度别研）十两，丹参五两半，杜仲（去粗皮灸）七两，萆<br>三两，牛膝（去苗切）五两半，狗脊（去皮）三两，萎蕤二两，薏苡仁一升，白芷三两，麦门冬（去心焙）五两，石斛（去根）八两，厚朴（去粗皮生姜汁炙），枳壳（去瓤麸炒），桔梗各三两，生地黄二升，蒴四两，黄芩（去黑心）、远志（去心）、蔓荆实各三两。<br>【制法】上三十九味，细　如麻豆大，每半料以绢袋盛，入瓷瓮中，用好酒八斗浸，密封七日。<br>【主治】治瘴毒气中人，口　面戾，半身不遂，历节肿痛，甚则小腹不仁，名曰脚气。<br>【用法】每服取一合，温服之，渐加至二合三合。常令有酒气要续，以效为度。<br>说明：《普济方》同上。
金牙酒（五）	金牙酒（五）――（风疾诸病）<br>（《普济方》）<br>【配方】金牙石20克，地肤子30克（或蛇床子30克）熟地、陆英根各30克，川椒、羌活各120克，附子、防风、细辛各30克，莽草20克，莽草20克，白酒1公斤。<br>【制法】将上药共粗碎，用白布袋盛，以酒浸入瓷器中，封固，勿令泄气，春夏3-4宿，秋冬6-7宿，浸成去渣。<br>【主治】中风不仁，步履艰难，行动不利。<br>【用法】每次饮30毫升，常令酒气相接，勿醉。
金银花酒	金银花酒――（痈疽、疮疡、发背）<br>（《医方集解》）<br>【配方】金银花50克，甘草10克。<br>【制法】将上药用水2碗，煎取半碗，再入酒半碗，略煎分3份。<br>【主治】疮肿，肺痈，肠痈。<br>【用法】早、午、晚各服1份，重者1天2剂。
近效疗久难瘥疟常山酒方	近效疗久难瘥疟常山酒方――（疟疾）<br>（《外台秘要》）<br>【配方】常山三两，鳖甲（炙）二两，鲮鲤甲（炙）、乌贼鱼骨（炙）各一两，乌梅肉七枚、桃仁（去皮尖别捣如泥）四十九枚，竹叶（切）、葱白（切）各一升，豉（熬令香）三合。<br>【制法】上九味细切，合以酒三升渍经再宿。<br>【主治】疗久难瘥疟。<br>【用法】空腹早朝温服一合，良久取吐，如不吐，至齐午以来服之，四服如不瘥，隔日更依前服必瘥，瘥后十日内，不得吃冷水粘骨人苋生菜，馀如常。
浸酒	浸酒――（腰脚疼痛诸病）<br>（《御药院方》）<br>【配方】虎胫骨（炙令黄，捶碎如棋子）八两，丹参、天麻各一大两，桂、牛膝、菝葜、人参各一大两，乌豆（炒令得所）二升，羚羊角、杜仲、芎各六分，薏苡仁八分，南椒（择去开口）半两，酒三斗。<br>【制法】将上药细v，吹去末，以生绢袋贮之，浸入酒中，令没，密封七日即成。<br>【主治】诸头目，腰脚，筋骨风益血添气力。<br>【用法】空腹量性饮，药味薄则换。
浸酒方（二）	浸酒方（二）――（跌打损伤）<br>（《圣济总录》）<br>【配方】雀屎（炒研）半合。<br>【制法】上一味，以酒七合，煮至五合，滤去滓。<br>【主治】治金疮或打击破疮等，风入，口闭牙噤，身强欲死。<br>【用法】令温顿服，腹中转动，当时愈，若不能开口，发开灌之。
浸酒方（三）	浸酒方（三）――（闭经）<br><br>（《普济方》）<br>【配方】大麻子三升，CA子二升，灶屋煤四两，土瓜根、射干各六两牛膝八两，桂心四两。<br>【制法】上口父咀，以清酒三斗，绢袋盛药，浸五宿。<br>【主治】治月经不通，百疗不瘥，脏腑宿冷，恶血凝结。<br>【用法】以一盏下乾漆丸良，或单服之亦得。<br>说明：《普济方》注出《备急千金要方》）。
浸酒方（四）	浸酒方（四）――（腰脚疼痛诸病）<br>（《普济方》）<br>【配方】杜仲<br>（去粗皮炙微黄色）八两，石南、羌活、附子（炮裂去皮脐）、牛膝（去苗）各三两，防风二两（去芦头）。<br>【制法】上细v，以生绢袋盛，用好酒三斗，于瓷瓶中浸，七日后开取。<br>【主治】诸风，腰脚疼痛。<br>【用法】每日三四度，饮一盏。<br>说明：①《普济方》注出《太平圣惠方》。②《太平圣惠方》同上。
浸酒方（五）	浸酒方（五）――（筋骨诸病）<br>（《本草纲目》）<br>【配方】虎骨（涂酥炙微黄）一两。<br>【制法】上捣碎，以生绢袋盛，以清酒三斗，于瓷瓶中浸，密封，春夏七日，秋冬二七日后开取。<br>【主治】风毒攻注，骨髓疼痛，日夜不可忍。<br>【用法】每日随性，稍稍饮之，其酒旋取旋添，以差为度。
浸酒方（一）	浸酒方（一）――（破伤风）<br>（《圣济总录》）<br>【配方】鸡屎白（炒黄）三升。<br>【制法】上一味，以生绢袋盛，入瓷瓶中，与酒六升，火煨浸半日，去滓。<br>【主治】治金疮中风发痉。<br>【用法】温服五合，日三夜一，并取茛菪根，捣作饼子，当疮上安著，以炙上热彻黄水出，取差。<br>说明：“以炙上热彻黄水出，取差”，《普济方》作“以炙上，热彻，黄水出便瘥”，余同。
经验乌须酒	经验乌须酒――（乌须黑发）<br>须发变白除老年自然衰老有之而外，须发早白，或因疾病引起的须发变白，一般多以肾阴肝血不足，血气不荣，须发失养所致。青年少白头亦有因血热风燥引起的。以下介绍9种治疗须发变白的药酒，供酌情选用。<br>（《万病回春》）<br>【配方】大枸杞二升，生地黄汁三升，无灰好酒二斗。<br>【制法】大枸杞要每年冬十月壬癸日，面东采摘红肥者，捣破，同酒盛于磁器内，浸二十一日足，开封，添生地黄汁搅匀，各以纸三层封其口，俱至立春前三十日开瓶。<br>【主治】乌须，身轻体健，功不可述。<br>【用法】空心暖饮一杯，勿食三白。
荆芥豉酒	荆芥豉酒――（感冒）<br>感冒是因风邪侵袭人体，以头痛、鼻塞、流涕、发热、恶寒、脉浮等为主要临床表现的疾病。根据其表现特点的不同，临床又分风寒、风热、夹暑、夹湿、夹燥、夹食等证。<br>本病所用药酒，以治风寒为主，常用豆豉、葱、姜等配制而成，如荆芥豉酒、葱豉黄酒汤；或用附子、肉桂等配制而成，治疗阳虚外感或受謇为主者，如肉桂酒。<br>风热外感者，亦可用药酒治疗，意在用酒以行药势。<br>（验方）<br>【配方】豆豉250克，荆芥10克，酒750克。<br>【制法】上2味，同酒煎5-7沸，去渣，收贮备用。<br>【主治】外感风寒，发热无汗。<br>【用法】随量稍热饮之。
荆芥豆淋酒	荆芥豆淋酒――（背强口噤）<br>（《普济方》）<br>【配方】荆芥穗四两，大豆半斤（炒令烟出好酒一升沃之去豆不用）。<br>【制法】上用水三升，并酒同煮至一半。<br>【主治】若忽尔摇头口噤，背强直如发B状，此由风邪乘虚客于足太阳之经，诊其脉缓散而迟者，盖其人本虚，风邪留于经络，日久而发谓之风痉，其脉三部俱洪数者，由蕴热搏于诸阳之经，甚则日夜数十发，正所谓热则生风，亦名日。b。<br>【用法】去滓温服。
九藤酒	九藤酒――（痛风）<br>痛风即痛痹。虞抟云：“夫古之所谓痛痹者，即今之痛风也。诸方书又谓之白虎历节风，以其走痛于四肢骨节，如虎咬之状，而以其名名之耳”。<br>痛风多因感寒而致，寒凝血瘀，不得流通，所以作痛，故适于用药酒治疗。常用附子、皂刺及藤类药物配制，如附子酒、九藤酒。<br>（《医学正传》）<br>【配方】青藤、钓钩藤、红藤（即理省藤也）、丁公藤（又名凤藤）、桑络藤、菟丝藤（即无根藤）、天仙藤（即青木香）、阴地蕨（名地茶，取根）各四两，忍冬藤、五味子藤（俗名红内消）各二两。<br>【制法】上细切，以无灰老酒一大斗，用磁罐一个盛酒，其药用绵包裹，放酒中浸之，密封罐口，不可泄气，春秋七日，冬十日，夏五日。<br>【主治】远年痛风，及中风左瘫右痪，筋脉拘急，日夜作痛，叫呼不已等证，其功甚速。<br>【用法】每服一盏，日三服，病在上食后及卧后服，病在下空心食前服。
酒煎饮方	酒煎饮方――（疟疾）<br>（《圣济总录》）<br>【配方】常山一两，鳖甲（去裙醋炙令黄）一两，知母三分，白头翁三分，桂（去粗皮）半两，青蒿一握，甘草（生）三分，桃李枝头心各七枚，葱薤白各七茎，柴胡（去苗）三分。<br>【制法】上一十二味，细如麻豆大，每服五钱匕，以酒一盏半，浸一宿。<br>【主治】治足太阳疟，腰痛头重，寒热互作。<br>【用法】平旦煎取一盏去滓，空服顿服，当吐痰出，再煎滓服。
菊花酒（三）	菊花酒（三）――（眩晕）<br>（验方）<br>【配方】甘菊花500克，地黄、当归、枸杞各200克，米1000克，曲适量。<br>【制法】将菊花、地黄、当归、枸杞煎汁，滤渣；米煮半熟沥干；曲压成粉。再将米、曲入汁内搅匀，装坛内，周围保温，令发酵，7日后可服用。<br>【主治】头风，耳鸣、耳聋，目眩，痿痹，有消百病之功。<br>【用法】每服20-30毫升，日服2次。<br>说明：本方原于《本草纲目》，其卷二十五附诸药酒条下云：“治头风，明耳目，去痿痹，消百病。用甘菊花煎汁，同曲、米酿酒。或加地黄、当归、枸杞诸药亦佳”。
菊花酒（五）	菊花酒（五）――（眩晕）<br>（验方）<br>【配方】甘菊花250克（或加生地、当归15克，杞果30克），曲、米适量。<br>【制法】用菊花煎汁，同曲、米如常法酿酒，酒熟压去槽。若久服可用菊花加生地、当归、杞果用白夏布袋盛，江米酒1公斤浸于净瓶中，封口，5日后开封，去渣。<br>【主治】头目眩晕，目赤肿痛，痛肿疔疮。<br>【用法】徐徐服15-30毫升，不拘时候。
菊花酒法	菊花酒法――（眩晕）<br>眩晕病出《内经》至真要大论等篇，眩者目眩眼花，晕即头晕头旋，发作时轻者闭目即止，片刻便过，重者不能站立，并常伴恶心、呕吐、汗出，以致昏仆等症。病因可外感六淫，亦可内伤七情，脏腑气血阴阳失和。对一些久病内伤，反复发作的患者，可选用药酒治疗，尤其对于血压高、肝肾阴虚，风阳上亢而又嗜酒的眩晕患者，最为适宜。常用的药物有：甘菊花、地黄、枸杞子、生地、当归、百灵藤、防己、秦艽、黄芩、杜仲、山茱萸、茵芋、山药、葛根、茯神、龙眼肉、天麻、石菖蒲、桑椹、五味子、白术、丹参、防风等。<br>（《备急千金要方》）<br>【配方】甘菊花。<br>【制法】九月九取邓州甘菊花暴干，作末，以米饣贲中蒸作酒。<br>【主治】用来送服治疗头目眩远，屋转旋倒的天雄散。<br>【用法】送服天雄散，日二。
菊花酒方（一）	菊花酒方（一）――（痹证）<br>（《太平圣惠方》）<br>【配方】菊花、五加皮、枸杞根、白术各八两，甘草、秦艽（去苗）各四两，生地黄（切）一斤。<br>【制法】上都捣令碎，以水三硕，煮至一硕，以槽挤压取汁，用糯米一硕炊熟，细曲一十斤捣碎，拌和令匀，入于瓮中，密封三七日。<br>【主治】八风十二痹，补虚损不足。<br>【用法】取饮任性，不得过醉。
菊花醪	菊花醪――（眩晕）<br>（验方）<br>【配方】甘菊花10克，糯米适量。<br>【制法】洁净的甘菊花剪碎，与糯米酒酿适量放在小铝锅内拌匀，煮沸。<br>【主治】肝热型高血压，眩晕等症食之甚宜。<br>【用法】顿食，每日2次。
菊花酝酒方	菊花酝酒方――（眩晕）<br>（《太平圣惠方》）<br>【配方】甘菊花（开者）。<br>【制法】上药，九月九日取曝干者作末，以糯米饭中蒸熟，每一豆+斗米用五两菊花末，溶拌如常酝法，多用细曲为良，候酒熟，即压去滓。<br>【主治】治风头旋。<br>【用法】每一小盏服。
菊杞调元酒	菊杞调元酒――（筋骨诸病）<br>（验方）<br>【配方】甘菊花（去茎）、枸杞子（去蒂）、巴戟天（去心）、肉苁蓉各90克，酒2公斤。<br>【制法】上药捣为粗末，夏布袋盛，置于净器中，用酒浸之，封口，7日后再添冷开水1.5公斤。<br>【主治】筋骨酸痛，下元虚冷。<br>【用法】每次空心温饮1-2小杯，每日早、晚各一次。
橘核药酒	橘核药酒――（疝气）<br>（《中医验方汇选》）<br>【配方】橘核、荔枝核、川楝子（盐炒）各9克，小茴香、牡蛎粉各15克，葫芦芭9克，肉桂6克，青皮9克，高梁酒500克。<br>【制法】将上药粉碎，装入瓶内，用酒浸泡3-4月，过滤去渣即成。<br>【主治】肝肾阴寒，疝气偏坠，阴囊肿大，起消无常，痛引脐腹，因劳累或受冷即发等症。<br>【用法】每日2次，每次适量而饮。小儿禁用。
橘子酒	橘子酒――（跌打损伤）<br>（《三因极一病证方论》）<br>【配方】橘子（炒去皮）。<br>【制法】上一味，研细；或用猪腰子一只，去筋膜，破开，入药，同葱白、茴香、盐、湿纸裹。煨熟。<br>【主治】治打扑腰痛，恶血蓄瘀，痛不可忍。<br>【用法】每服二钱匕，酒调服；或细嚼煨熟猪腰子，温酒下。
巨胜浸酒方（二）	巨胜浸酒方（二）――（痹证）<br>（《圣济总录》）<br>【配方】巨胜（炒）一升半，薏苡仁（炒）半升，生干地黄二两。<br>【制法】上三味，v令匀细，生绢囊贮，以酒二斗浸，春夏三五日，秋冬六七日。<br>【主治】风湿痹、脚膝无力，筋挛急痛。<br>【用法】每服五合，空心临卧温服。
巨胜浸酒方（一）	巨胜浸酒方（一）――（痹证）<br>（《普济方》）<br>【配方】巨胜（炒）一升，薏苡仁（炒）半升，生姜一两，地黄一两。<br>【制法】上v令匀细，生绢袋贮，以酒二斗浸，春夏三五日，秋冬各六七日。<br>【主治】风湿痹，脚膝无力，筋挛急痛。<br>【用法】每服五合，空心临卧温服。<br>说明：《普济方》注出《圣济总录》。
巨胜酒（二）	巨胜酒（二）――（痹证）<br>（《老老余编》）<br>【配方】巨胜一升，薏苡仁二升，干地黄（切）半斤。<br>【制法】上以绢袋盛，无灰酒一斗渍之，勿令泄气，满七日。<br>【主治】老人风痹虚弱，四肢乏力，骨节疼痛。<br>【用法】空心任意服。
巨胜酒（一）	巨胜酒（一）――（痹证）<br>（《寿亲养老新书》）<br>【配方】巨胜、苡仁各200克，干地黄250克，无灰酒4000克。<br>【制法】将上药入绢袋中，用酒浸泡，密封，勿使泄气，一周后即可饮用。<br>【主治】筋脉拘急，风湿痹症。<br>【用法】每次10-20毫升，日1-2次。<br>说明：巨胜即芝麻，又称胡麻，黑者为佳。
巨胜子酒	巨胜子酒――（痹证）<br>（《本草纲目》）<br>【配方】巨胜子（炒）250克，薏苡仁（炒）125克，生干地黄30克，酒1公斤。<br>【制法】将上药捣为粗末，生白布袋盛，以酒浸之，封口，春夏3、5日，秋冬6、7日后开封，去渣。<br>【主治】风湿痹痛，脚膝无力，筋挛急痛。<br>【用法】每日临卧空心温饮1-2小杯。
康壮酒	康壮酒――（乌须黑发）<br>（验方）<br>【配方】枸杞子、炒陈曲、甘菊花、熟地黄、肉桂各45克，肉苁蓉36克，醇酒1.5公斤。<br>【制法】将上药捣碎为粗末，用夏白布袋盛，置于净瓶中，注酒浸之，春夏5日，秋冬7日，开口后再加冷开水1公斤合均，备用。<br>【主治】肝肾不足，须发早白，身疲乏力，腰膝软弱。<br>【用法】空心任意徐徐温饮，不拘时候。
苦参解毒酒	苦参解毒酒――（食物中毒）<br>食物中毒是因进食有毒食物引起的疾病。因酒能发散，有可能促进毒物吸收，一般较少用药酒治疗。但酒可致吐，故在特定情况下，急需吐出有毒食物时，亦非绝对不可用。此处选录的“苦参解毒酒”，用苦参解毒，制酒性之燥热，又借酒致吐，使毒物吐出，以达邪去正存之目的，值得进一步研究。<br>（验方）<br>【配方】苦参45克，醇酒500毫升。<br>【制法】将上药同煎至250毫升，去渣候温。<br>【主治】食物中毒。<br>【用法】任量饮之，得吐即愈。
苦参酒（二）	苦参酒（二）――（癞病）<br>（《医宗金鉴》）<br>【配方】苦参2.5公斤，露蜂房150克，刺猬皮一具，黍米三斗，细曲2.5公斤。<br>【制法】将上药细v为末，以水30升，煮取10升，去渣，浸细曲，蒸黍米，按常法酿酒，酒熟后，压榨去糟渣，取澄清酒液即成。<br>【主治】乌癞、白癞（即现代医学的麻风病）。<br>【用法】每于饭前温饮1小杯。<br>注意：后期正气已虚，肝肾不足的不宜使用此酒。
苦参酒（三）	苦参酒（三）――（疫毒）<br>（《普济方》）<br>【配方】苦参0.3克，桔梗0.1克，酒2杯。<br>【制法】将上药捣碎为末，以酒煎取1杯，去渣。<br>【主治】时气热毒在胸膈。<br>【用法】候酒不冷不热，不计时候饮之，服后当闻苦参气，即吐毒如羊胆汁便愈。
苦参酒（一）	苦参酒（一）――（疥癣病）<br>（《证治准绳》）<br>【配方】苦参150克，露蜂房15克，刺猬皮（酥炙）1具，曲150克，黍米1.5公斤。<br>【制法】将上药共研粗末，用水2.5公斤，煎汤至500克，去渣，浸曲、米相拌，如常法酿酒，酒熟压去糟，收贮备用。<br>【主治】疥疮，周身搔痒，阴痒带下，身白癞疮。<br>【用法】每于食前温饮1小杯（约10毫升）。<br>注：遍身白点，搔之屑落，或痒或痛，色白渐展，称为白癞。
苦参酒方	苦参酒方――（癞病）<br>（《圣济总录》）<br>【配方】苦参（去上皮心v）二斤，露蜂房（v）五两。<br>【制法】上二味，用水三斗，煮取一斗五升，去滓浸法曲三斤。经三宿，炊黍米二斗，酝如常法。<br>【主治】治白癞。<br>【用法】酒熟每食后，饮一合，日二夜一，加至三合，以差为度。
苦参酿酒方	苦参酿酒方――（癞病）<br>癞病又名“大风”、“疠风”、“大风恶疾”、“癞大风”、“大风癞”、“大麻风”、“麻风”。本病为慢性传染性皮肤病。主要因体虚感受暴疠风毒，或接触传染，内侵血脉而成。初起患处麻木不仁，次成红斑，继而肿溃无脓，久之可蔓延全身肌肤，出现眉落、目损、鼻崩、唇裂、足底穿等重症。“白癞”和“乌癞”均是由于恶风侵袭皮肤血分之间，郁遏化火，耗伤血液而成。白癞初起皮肤逐渐变白，四肢顽麻，肢节发热，手足无力，患部肌肉如针刺样疼痛，声音嘶哑，两眼视物不清，类似结核型麻风；乌癞，初起皮肤变黑，发若隐疹，痒如虫行，继而则手足顽麻，针刺不痛，心中常惊恐不安，时有谵语，饮食或说话时，开口出气发出鸣声，类似疣型麻风（包括麻风反应）。解放以来由于采取了积极的预防措施，本病在我国发病已得到了有效的控制。以下介绍几种治疗本病的药酒，仅供参考。<br>（《太平圣惠方》）<br>【配方】苦参五斤，露蜂房五两，皮一枚，曲半（三斤）。<br>【制法】上诸药，细v，以水五，合药浸四日，炊米五　并药曲，同酿酒如常法，熟。<br>【主治】治遍身白屑，搔之则痛，变作大风癞。<br>【用法】即每服暖饮一中盏，日三服。
苦参天麻酒	苦参天麻酒――（疥癣病）<br>（验方）<br>【配方】苦参500克，露蜂房75克，天麻80克，白藓皮200克，曲750克，黍米5公斤。<br>【制法】将上药用水7.5公斤，煮取1半，去渣，浸曲，经3宿，炊米醢如常法，酒熟压去糟渣，贮存备用。<br>【主治】遍身白屑，搔之则痛。<br>【用法】饭后饮1小杯，日2次，夜1次，渐加至3小杯，以愈为度。
苦参酝酒方	苦参酝酒方――（癞病）<br>（《太平圣惠方》）<br>【配方】苦参五斤，露蜂房五两，猬皮一具。<br>【制法】上诸药，细v，以水三　，煮取一，去滓，浸细面五斤，炊秫米三　拌如常酝法，酒熟，压去滓糟。<br>【主治】治周身白点，如脂如榆荚，搔之白屑落，或痒或痛，色白渐展，世呼为白癞。<br>【用法】每于食前，暖饮一小盏。<br>说明：《圣济总录》、《普济方》、《医部全录》同上。
苦酒汤方	苦酒汤方――（咽疮）<br>以下介绍宋代《宋济总录》的苦酒汤方，本源于东汉张仲景的《伤寒论》312条：“少阴病，咽中伤，生疮，不能语言，声不出者，苦汤汤主之”。“咽中伤，生疮”：即咽部溃烂，是痰热相结之故。“苦酒”：据后人考证系“醋”。关于本方制法，《伤寒论》：“上二味，内半夏苦酒中，以鸡子壳置刀环中，安火上，令三沸，去滓，少少含咽之。不差，更作三剂”。此与《圣济总录》所载略有不同。“刀环”即古钱，形狭长如刀，柄端有环。古人为了煮药方便，取刀环中空，便于架蛋壳，放火上。《圣济总录》作剪刀环，因宋时已难以找到这种古钱，故以剪刀环代替。本方以苦酒为主，半夏、蛋清为辅。苦酒苦酸，能消肿敛疮；半夏辛滑，能祛痰散结，蛋清甘寒入肺，能润燥利窍，故本方有祛痰散结、消肿利窍之功效。本方严格说不属今之药酒范畴，录此以供借鉴。<br>（《圣济总录》）<br>【配方】半夏（汤洗七遍切）十四枚，鸡子（去黄留白入苦酒在内）。<br>【制法】上二味，内半夏于苦酒内，以鸡子壳，置剪刀环中，安火上，煮二沸去滓。<br>【主治】治伤寒少阴病，咽中生疮，语声不出。<br>【用法】少少含咽。
苦酒絮裹足方	苦酒絮裹足方――（霍乱）<br>（《圣济总录》）<br>【配方】苦酒一斤半。<br>【制法】取衣絮，内苦酒中，煮令温。<br>【主治】治霍乱转筋入腹。<br>【用法】从转筋处裹之。
昆布海藻浸酒	昆布海藻浸酒――（瘿瘤）<br>（《普济方》）<br>【配方】昆布（洗去咸味）、海藻（洗去咸味）各一斤。<br>【制法】上细切，好酒一升，浸七日。<br>【主治】疗颈下卒结硬核欲成瘿。<br>【用法】量力取数服。<br>说明：原书无方名，据药味及制法命名。
栝蒌甘草酒	栝蒌甘草酒――（痈疽、疮疡、发背）<br>（《圣济总录》）<br>【配方】栝蒌1枚，甘草2克。<br>【制法】将上药粗碎，用酒、水各1小杯，量人虚实入腻粉少许，煎3、5沸，去渣。<br>【主治】痈疔多日不消者。<br>【用法】临睡前温服。
栝蒌酒	栝蒌酒――（产后缺乳）<br><br>（《圣济总录》）<br>【配方】栝蒌（黄大者捣碎）1枚，好酒5杯。<br>【制法】将上药，熟捣令烂，用酒煎3杯，剩2杯，去渣。<br>【主治】乳汁不下。<br>【用法】每温服1杯，不拘时候。
栝蒌酒方（二）	栝蒌酒方（二）――（痈疽、疮疡、发背）<br>（《圣济总录》）<br>【配方】栝蒌一枚，甘草二寸。<br>【制法】上二味v碎，用酒一盏，水一盏，量人虚实，入腻粉少许，煎三五沸，去滓。<br>【主治】治痈疖多日不熟无头者。<br>【用法】临卧温服，夜半疏动一行，其疮自消。
栝蒌酒方（一）	栝蒌酒方（一）――（产后缺乳）<br><br>（《圣济总录》）<br>【配方】栝蒌（黄大者v碎）一枚。<br>【制法】上一味，熟捣令烂，用好酒五盏，煎取三盏去滓。<br>【主治】治产后乳汁不下或少。<br>【用法】每服一小盏暖服，不拘时。
栝蒌醴	栝蒌醴――（乳病）<br>（验方）<br>【配方】全栝蒌30克，黄酒100毫升。<br>【制法】栝蒌捣碎，与黄酒100毫升，同放瓷杯中，再将瓷杯放在有水的蒸锅中以小火蒸炖20分钟。<br>【主治】乳腺炎初起红肿痛热者宜用。<br>【用法】每次温饮20毫升，每日2次。
喇嘛酒方	喇嘛酒方――（半身不遂）<br>半身不遂名出《金匮要略・中风历节病脉证并治》，通常为中风后遗症，亦有先起手足麻木，逐渐形成者。古又称偏枯、偏风，或作半身不遂。其病机多系营卫俱虚，真气不能充于全身，并常兼夹风寒湿邪侵袭及痰瘀阻络，病久则肾虚精亏。表现为一侧上下肢偏废不用，或兼疼痛，日久患肢肌肉不仁、枯萎，神志无异常变化，可伴见口眼?斜、语言謇涩等。药酒疗法，常用当归、川芎、牛膝、生干地黄、首乌、附子、细辛、续断、狗脊、虎骨、杜仲、五加皮、川乌、防风、秦艽、g莶草、独活、肉桂、天雄、川椒、芍药、桂枝、黄芪、石菖蒲、蛇床子、益智仁、肉苁蓉、白术、茯苓、薯蓣等药，组成酒方，长期饮用，取其养血祛风、温经通络、化瘀宣痹、益气活血、补贤益精之功，久治缓图，多有效验。<br>（《随息居饮食谱》）<br>【配方】胡桃肉、龙眼肉各四两、杞子、首乌、熟地各一两，白术、当归、川芎、牛膝、杜仲、g莶草、茯苓、丹皮各五钱，砂仁，乌药各二钱五分。<br>【制法】上十六味，绢袋盛之，入瓷瓶内，浸醇酒五斤，隔水煎浓候冷，加滴花烧酒十五斤，密封七日饮。<br>【主治】半身不遂，风痹麻木。<br>【用法】饮之。
莱菔酒（二）	莱菔酒（二）――（鼻衄）<br>鼻衄又名“鼻中出血”、“鼻衄血”。若鼻中出血不止，名为“鼻洪”。该病主要因肺热上壅、胃热熏蒸、肝火偏旺、头风、伤酒肺胃积热、肺肾阴虚、浮阳上越以及外伤等原因所致。肺热上壅者，症见鼻衄而鼻孔干燥；胃热熏蒸者，症见鼻干口臭，烦渴引饮；肝火偏旺者，症见头痛眩晕，目赤善怒；头风鼻衄，症见血出如注；伤酒肺胃积热者，鼻出血不止，苔黄气粗；肺肾阴虚者，症见潮热盗汗，头晕耳鸣，咳嗽少痰；阴虚浮阳不潜上浮而越者，名日格阳鼻衄，症见六脉浮大无力、两尺犹弱。以下两种药均以莱菔子入酒为药，莱菔子和胃下气，化痰消食，对于食积胃火上熏所致之鼻衄可能效果更为理想。以下二方可以互参。<br>（《普济方》）<br>【配方】莱菔。<br>【制法】上莱菔不拘多少，每细v一合，用酒一盏，先煎令酒百沸，再下莱菔，再煎一两沸。<br>【主治】大衄不止。<br>【用法】俟温滤去滓顿服。
莱菔酒（一）	莱菔酒（一）――（鼻衄）<br>（验方）<br>【配方】莱菔汁100毫升，酒50毫升。<br>【制法】先将酒煎百沸至20毫升，同莱菔汁和合，再煎1、2沸，候凉。<br>【主治】口、鼻、耳皆出血不止。<br>【用法】1次饮尽。
兰陵酒方	兰陵酒方――（腹胀腹痛）<br>（《鲁府禁方》）<br>【配方】白面八十斤，糯米面二十斤，沉香、木香各五钱，砂仁二两，当归一两，陈皮二两，杏仁四两，鲜姜八两，郁金五钱，花椒二两，白芷一两。<br>【制法】上为末，和作曲，二十一日下吊翻覆如常法。<br>【主治】心腹胀满冷痛。<br>【用法】随饮之。
老疟久不断方	老疟久不断方――（疟疾）<br>（《肘后备急方》）<br>【配方】常山三两，鳖甲、炙升麻、附子、乌贼骨各一两。<br>【制法】以酒六升渍之，小令近火一宿，成。<br>【主治】治老疟久不断者。<br>【用法】服一合，比发可数作。
老蛇盘酒	老蛇盘酒――（瘰疠）<br>（《陕甘宁青中草药选》）<br>【配方】老蛇盘2两，白酒1斤。<br>【制法】浸泡5日去滓。<br>【主治】淋巴结结核，甲状腺肿大。<br>【用法】每服15毫升，每日2次。
类叶牡丹酒	类叶牡丹酒――（跌打损伤）<br>（《陕甘宁青中草药选》）<br>【配方】类叶牡丹3钱，白酒300毫升。<br>【制法】浸泡7日后服用。<br>【主治】关节痛，跌打损伤。<br>【用法】每服10毫升，日服2次。
藜芦酒	藜芦酒――（子痫）<br><br>（《陕甘宁青中草药选》）<br>【配方】藜芦6钱，白酒（60°）300毫升。<br>【制法】切碎浸酒6天后过滤备用。<br>【主治】先兆子　。<br>【用法】每次服0.6毫升加水10毫升，日服2-3次。
良姜酒	良姜酒――（霍乱）<br>（《普济方》）<br>【配方】良姜（火炙令焦香打破）三两。<br>【制法】上以酒一升，煮三四沸。<br>【主治】治急霍乱，吐利不止。亦治腹痛气恶。<br>【用法】顿服。<br>说明：《普济方》注“出十便良方”。方名为笔者所加。
两皮独活酒	两皮独活酒――（腰脚疼痛诸病）<br>（《普济方》）<br>【配方】海桐皮、五加皮、独活各30克，制附子10克，石斛（去根）、桂心、防风（去芦头）、当归、杜仲（炒断丝去粗皮）、仙灵脾、萆、牛膝（去苗）各30克，虎胫骨（酥炙令黄）45克，薏苡仁、生地黄各30克，白酒1.5公斤。<br>【制法】将上药共捣碎，生白布袋盛，浸于酒中，春夏7日，秋冬14日后即可饮用。<br>【主治】脚膝软弱疼痛，四肢麻木，关节不利，不得屈伸。<br>【用法】每空腹温饮1-2杯，常令微醉，不得大醉，重者不过两剂，若酒尽，旋旋添之，以药味尽即止。
两皮酒	两皮酒――（痈疽、疮疡、发背）<br>（《证治准绳》）<br>【配方】海桐皮、五加皮、独活、玉米（炒）、防风、干蝎（炒）、杜仲、牛膝各30克，生地90克，好酒1250克。<br>【制法】将上药共碎细，夏白布袋盛，同酒浸于瓷瓶中密封，秋夏3日，春冬7日，开封去渣。<br>【主治】热毒风结成疡肿，痛不得安。<br>【用法】每食前温服1～2杯，甚者不拘时候饮之，常令酒气相续。
疗白癞酒	疗白癞酒――（癞病）<br>（《肘后备急方》）<br>【配方】苦参五斤。<br>【制法】酒三斗渍。<br>【主治】疗白癞。<br>【用法】饮勿绝，并取皮根末服。
疗肠痔方	疗肠痔方――（肠痔）<br>肠痔是类似肛痛的一种病症。《诸病源候论》说：“肛边肿核痛，发寒热而出血者肠痔也。”相当于肛门周围脓肿。本病多因热毒下注所致。以下介绍一种药酒。方中生地黄凉血滋阴，清热解毒。据载饮之即瘥。<br>（《普济方》）<br>【配方】生地黄（切）一斤，酒二斗。<br>【制法】上以酒渍地黄三日。<br>【主治】疗肠痔。<br>【用法】随意饮多少即瘥。<br>说明：《普济方》注出“肘后方”。
疗中蛊毒吐血或下血皆如烂肝又方	疗中蛊毒吐血或下血皆如烂肝又方――（蛊毒）<br>（《肘后备急方》）<br>【配方】皂荚（炙去皮子）三挺。<br>【制法】酒五升渍上件一宿，去滓。<br>【主治】中蛊毒吐血或下血皆如烂肝。<br>【用法】分三服。
灵脾地黄酒	灵脾地黄酒――（阳萎）<br>（验方）<br>【配方】仙灵脾250克，熟地150克，醇酒1.25公斤。<br>【制法】将上药共碎细，纱布包贮，用酒浸于净器中，密封，勿通气，春夏3日，秋冬5日后方可开取饮用。<br>【主治】肾虚阳萎，宫冷不孕腰膝无力，筋骨酸痛。<br>【用法】每日随量温饮之，常令有酒力相续，但不得大醉。<br>说明：若酒尽，再重泡制。
灵脾肉桂酒	灵脾肉桂酒――（胃脘痛）<br>（《普济方》）<br>【配方】仙灵脾100克，陈橘皮15克，豉30克，连皮大腹槟榔3枚，黑豆皮、肉桂各30克，生姜3片，葱白（切）3根，黄酒1公斤。<br>【制法】将上药捣碎，以生白布袋盛，酒浸，挂药不令到底，灰火（热灰火）外煨24小时，取出候冷即可饮用。<br>【主治】脾肾两虚，脘腹冷痛，食欲不佳，腰酸体弱。<br>【用法】早、晚各温服1杯。
灵脂酒	灵脂酒――（心痛）<br>（《奇效良方》）<br>【配方】五灵脂（去砂石，炒）、加玄胡索、没药（炒）各等分。<br>【制法】上为细末。<br>【主治】热气乘心作痛。<br>【用法】每服二钱，温酒调下。
岭南瘴脚气酒方	岭南瘴脚气酒方――（脚气）<br>（《普济方》）<br>【配方】白矾石二斤（亦可和钟乳末），附子三两，豉三升。<br>【制法】上用酒三斗渍四五日，若有气加苏子二升，肘后用矾石。<br>【主治】专治岭南瘴脚气。<br>【用法】稍饮之。<br>说明：《普济方》注出《肘后方》。
鲮鲤甲酒	鲮鲤甲酒――（疟疾）<br>（《奇效良方》）<br>【配方】鲮鲤甲（酒浸，炙黄）、鳖甲（去裙，醋浸，炙黄）各半两，乌贼鱼骨（去甲）、常山各三分，乌梅肉（微炒）一分，竹叶一握，豉一合，桃仁（汤浸，去皮尖，双仁，麸炒）二十四枚，葱白（切）七茎，酒三升。<br>【制法】上药如麻豆大，用生绢袋盛，入酒浸一宿即成。<br>【主治】疟久不瘥。<br>【用法】每日空腹温服半盏，良久取吐，如不吐，至已午时再服三两，服如不瘥，隔日更依前服之。<br>说明：与《圣济总录》、《普济方》同。
鲮鲤甲酒方	鲮鲤甲酒方――（疟疾）<br>（《圣济总录》）<br>【配方】鲮鲤甲（炙）五枚，鳖甲（去裙醋炙黄）、乌贼鱼骨（去甲）、附子（炮裂去皮脐）各一分，常山半两。<br>【制法】上五味，细　，以酒二升半，渍一宿。<br>【主治】治瘴疟，南方山岭瘴气，令人寒热发作无时，萎黄肿满，四肢痹弱。<br>【用法】疟发前，稍稍服之，勿绝药味也。兼以酒涂身体，服药良久，方可进饮食。<br>说明：《普济方》注出《太平圣惠方》，同上。
刘寄奴酒	刘寄奴酒――（产后瘀血）<br><br>（验方）<br>【配方】刘寄奴、甘草各等分。<br>【制法】将上药共碎细，每服20克，先以水2小杯，入药煎至1小杯，再入酒1小杯，再煎至1小杯，去渣。<br>【主治】女子产后瘀阻血滞。<br>【用法】1次温服。
硫黄酒（二）	硫黄酒（二）――（癞病）<br>（《奇效良方》）<br>【配方】明硫黄适量，酒适量。<br>【制法】将硫黄研细，酒调，饮清汁，或添大枫子油更好。<br>【主治】杀癞风虫。<br>【用法】每日空心饮清汁，明日不顾硫黄再研，入酒，如前服。<br>说明：《普济方》明硫黄用三钱，注出《直指方》，余同上。
硫黄酒（三）	硫黄酒（三）――（癞病）<br>（《奇效良方》）<br>【配方】透明锋芒硫黄二钱。<br>【制法】上药入乳钵内研细，加入醇酒再研，取出清酒服之，将渣又研细，再入酒饮之，连日如是。<br>【主治】恶风，头面肢体瘾疹魁瘰。<br>【用法】地取清酒空心饮之，连日如是，硫黄能杀恶虫，自大便下。
柳根酒方	柳根酒方――（瘿瘤）<br>（《圣济总录》）<br>【配方】柳根（须水所经露出者v）三斤。<br>【制法】右一味，用水一斗，煮取五升，用米三升酿之，酒成。<br>【主治】治瘤瘿。<br>【用法】每服饮半升，空心日牛夜卧各一服。<br>说明：《普济方》同上。
龙葵酒	龙葵酒――（哮喘）<br>（《陕甘宁青中草药选》）<br>【配方】龙葵果4两，白酒半斤。<br>【制法】浸泡30天左右，取酒饮服。<br>【主治】气管炎，哮喘。<br>【用法】每日1茶匙，日服3次。
漏通酒	漏通酒――（乳病）<br>（《验方新编》）<br>【配方】漏芦、木通、川贝母各10克，甘草6克。<br>【制法】将上药用水、酒各1大杯，煎至1杯，去渣候温，分2份。<br>【主治】乳疖初起。<br>【用法】每日晚饭后温饮1份。
露蜂房酒方	露蜂房酒方――（癞病）<br>（《圣济总录》）<br>【配方】露蜂房五两，苦参四斤。<br>【制法】上二味，v细，用水三斗，煮取一斗五升，去滓浸曲四斤半，炊黍米二斗，如常酝法。<br>【主治】治乌癞。<br>【用法】酒熟每服三合至五合，日二夜一，稍增无妨。
鲁公酿酒	鲁公酿酒――（半身不遂）<br>（《备急千金要方》）<br>【配方】干姜、踯躅、桂心、甘草、芎、续断、细辛、附子、秦艽、天雄、石膏、紫苑各五两，葛根、石龙芮、石斛、通草、石南、柏子仁、防风、巴戟天、山茱萸各四两，牛膝、天门冬各八两，乌头二十枚，蜀椒半升。<br>【制法】上二十五味口父咀，以水五升渍三宿，法曲一斤合渍，秫米二斗合酿，三宿去滓，饮糯米一斗酿三宿药成。<br>【主治】主风偏枯半死，行劳得风，若鬼所击，四肢不遂，不能行步，不自带衣，挛五缓六急，妇人带下，产乳中风，五劳七伤。<br>【用法】先食服半合，日再，待米极消尽，乃去滓暴干末服。
鲁王酒	鲁王酒――（眩晕）<br>（《备急千金要方》）<br>【配方】茵芋、鸟头、踯躅各三十株，天雄、防己、石斛各二十四株。细辛、柏子仁、牛膝、甘草、通草、桂心、山茱萸、秦艽、黄芩（胡洽作黄芪）、茵陈、附子、矍麦、杜仲、泽泻、王不留行（胡洽作天门冬，千金翼作王荪）石南、防风、远志、干地黄各十八铢。<br>【制法】上二十五味口父咀，以酒四斗，渍之十日。<br>【主治】治风眩心乱，耳聋目暗泪出，鼻不闻香臭，口烂生疮，风齿瘰疬，喉下生疮，烦热厥逆上气，胸胁肩胛痛，手不上头，不自带衣，腰脊不能俯仰，脚酸不仁，难以久立，八风十二痹，五缓六急，半身不遂，四肢偏枯，筋挛不可屈伸，贼风咽喉闭塞，哽哽不利，或如锥刀所刺，行人皮肤中，无有常处，久久不治，入人五脏，或在心下，或在膏盲，游走四肢，偏有冷处，如风所吹，久寒积聚，风湿，五劳七伤，虚损百病恶主之。<br>【用法】一服一合，加至四五合，以知为度。<br>说明：《普济方》、《奇效良好》同上。
镥豆酒	镥豆酒――（产后瘀血）<br><br>（《普济方》）<br>【配方】镥豆（炒令黑及热）。<br>【制法】上投酒中。<br>【主治】治妇人产后冷血。<br>【用法】渐渐饮之。
鹿备酒（三）	鹿备酒（三）――（阳萎）<br>（《中国药膳学》）<br>【配方】鹿血200克，白酒1000克。<br>【制法】新鲜鹿血最佳，注入坛内，再加白酒，搅匀，24小时后取上层澄清液饮用。<br>【主治】阳虚怕冷，腹痛，阳萎，寒虚带下，崩漏等症。<br>【用法】每服10毫升，日服1-2次。<br>说明：阴虚火旺或素有痰热者不宜用。
鹿茸虫草酒	鹿茸虫草酒――（阳萎）<br>（《河南省秘验单方集锦》）<br>【配方】鹿茸20克，冬虫夏草90克，高梁酒1500毫升。<br>【制法】将上药制成软片，浸入酒中泡10天，过滤后即可饮用。<br>【主治】肾阳虚衰，精血亏损所致的腰膝酸软无力，畏寒肢冷，男子阳萎不育等症。<br>【用法】每日饮20-30毫升。<br>说明：阴虚者禁用。
鹿茸酒（二）	鹿茸酒（二）――（阳萎）<br>（《本草纲目》）<br>【配方】嫩鹿茸（去毛切片）、山药（末）各一两。<br>【制法】上药绢袋裹，置酒瓶中，七日开瓶，将茸焙作丸服。<br>【主治】阳事虚萎，小便频数，面色无光。<br>【用法】日饮三盏。<br>说明：本方见《本草纲目》卷五十一鹿条引普济方。
鹿茸酒（三）	鹿茸酒（三）――（阳萎）<br>（《古今图书集成》）<br>【配方】鹿茸10克，山药30克，好酒0.5公斤。<br>【制法】将鹿茸切片，同山药置于净瓶中，注入酒，封口，7日后取用。<br>【主治】男子虚劳精衰，精血两亏，阳萎不举，腰膝酸痛，畏寒无力，骨弱神疲，遗尿滑精，眩晕耳聋，小儿发育不良；妇女宫冷不孕，崩漏带下（属虚寒症状）。<br>【用法】每次空腹饮1-2杯，每日3次。
鹿茸酒（一）	鹿茸酒（一）――（阳萎）<br>（《普济方》）<br>【配方】好鹿茸（多用一两去皮切片）五钱，干山药（为末）一两。<br>【制法】上以生薄绢裹，用好酒一瓶，浸七日后，饮之。<br>【主治】虚弱阳事不举，面色不明，小便频数，饮食不思。<br>【用法】开瓶饮酒，日三盏为度。酒尽再将酒一瓶浸。吃了却将鹿茸焙干，留为补药用之，又妙。<br>说明：《奇效良方》同上。
鹭鸶藤酒	鹭鸶藤酒――（痈疽、疮疡、发背）<br>（《备急炙法》）<br>【配方】鹭鸶藤（嫩苗叶，不得犯铁器，用木棰捶碎）五两，甘草（v为粗末，生用）一两。<br>【制法】上二味同入瓦器内，用水二，文武火缓缓煎至一　。入好无灰醣酒一大，用煎十数沸，滤去滓。<br>【主治】痈疽初起。<br>【用法】分为三服，微温连进，一日一夜噬尽。病势重者，连进数剂。即云可作补药，必然无虚伤脾，服至大小肠通为度。
驴皮胶酒方	驴皮胶酒方――（背强口噤）<br>（《圣济总录》）<br>【配方】驴皮胶（炙燥）二斤，清酒一斗。<br>【制法】上以酒煮胶令化。<br>【主治】中风身如角弓反张。<br>【用法】取六升，分十二服，空心细细服之。<br>说明：《普济方》）
瘰疬酒药方	瘰疬酒药方――（瘰疠）<br>（《外科正宗》）<br>【配方】鹤风草半斤，忍冬藤六两，野蓬蒿四两，野菊花四两，五爪龙三两，马鞭草一两五钱。<br>【制法】上药切碎，用老酒十五斤，袋贮药悬于酒内，封口，煮三香为度；取起水顿，浸一伏时。<br>【主治】治年久瘰疬结核，串生满项，顽硬不穿破者。病愈不发。<br>【用法】初服尽醉出汗为效。已后随便应之，其酒一料。
络石藤酒	络石藤酒――（痹证）<br>（验方）<br>【配方】络石藤60克，仙茅、川萆各15克，骨碎补60克，狗脊、大生地、当归身、苡仁各30克，白术、黄芪、玉竹、枸杞、山萸肉、白芍、木瓜、红花、牛膝、川续断、杜仲各15克，黄酒5000克。<br>【制法】将上药切片，绢袋装，浸酒内，封固，隔水加热半小时，静置数日即可饮用。<br>【主治】肝肾不足，脾虚血弱，夹有风湿的肢体麻木，疼痛，腰膝酸软，体倦身重等症。<br>【用法】视酒量，每日饮1-2小杯，不可过服，所余药渣还可依法再浸一次。
麻风药酒方	麻风药酒方――（癞病）<br>（《外科正宗》）<br>【配方】防风、当归、虎骨、秦艽、羌活、苦参、牛膝、僵蚕、松节、鳖甲、苍术、枸杞子、白茅根各三两，蓖麻子仁一两。<br>【制法】用好雪酒二十五斤，用药袋盛浸酒内，封坛口，煮香二枝取起，水内浸一伏时。<br>【主治】麻风。<br>【用法】取服数杯。
麻根汁酒方	麻根汁酒方――（跌打损伤）<br>（《普济方》）<br>【配方】大麻根、叶。<br>【制法】上捣取汁，天生麻，酒煮干麻汁。<br>【主治】治腕折骨损，痛不可忍，兼打扑损，或坠堕瘀血，腹满短气者。<br>【用法】饮一升，或取汁温酒服。<br>说明：《普济方》注“出圣惠方”。
麻黄醇酒汤	麻黄醇酒汤――（黄疸）<br>（《普济方》）<br>【配方】麻黄三两。<br>【制法】以醇酒五升，煮取一升半。<br>【主治】治伤寒热出表发黄疸。<br>【用法】尽服之，温覆汗出，即愈，冬月寒时用清酒，春月宜用水。<br>说明：《普济方》注出《备急千金要方》。
麻黄酒	麻黄酒――（中风）<br>（《普济方》）<br>【配方】麻黄、木鳖、杏仁、大黄。<br>【制法】上等分好酒一斗，煎一升。<br>【主治】诸风左瘫右痪，历节走痊疼痛。<br>【用法】浸别酒频服。<br>说明：《普济方》注出《鲍氏方》。
麻仁酒	麻仁酒――（腰脚疼痛诸病）<br>（《本草纲目》）<br>【配方】大麻子中仁。<br>【制法】上味炒香，袋盛浸酒。<br>【主治】骨髓风毒痛，不能动者。<br>【用法】饮之。<br>说明：本方见《本草纲目》卷二十五诸药酒条。
麻子酒（二）	麻子酒（二）――（呃逆呕吐）<br>（《普济方》）<br>【配方】麻子（熬令香熟）一升。<br>【制法】上捣取酒三升，熟研滤取一升。<br>【主治】治恶心。<br>【用法】日二服，尽一石瘥，一切病自能饮食，不能酒，任性多少。<br>说明：《普济方》注出“千金方”。方名为笔者所命名。
麻子酒方	麻子酒方――（产后瘀血）<br><br>（《备急千金要方》）<br>【配方】麻子（捣）五升。<br>【制法】以酒一斗渍一宿，明旦去滓。<br>【主治】产后血不去。<br>【用法】温服一升，先食服，不差，夜服一升不吐下，忌房事一月，将养如初产法。<br>说明：《普济方》同上。
麻子仁酒方	麻子仁酒方――（半身不遂）<br>（《圣济总录》）<br>【配方】麻子仁（炒）二合，黑豆（紧小者炒）二合，鸽粪（炒）二合，垂柳枝二握（v半寸长）。<br>【制法】上四味，先以酒七升，煮柳枝及五升，炒鸽粪麻仁黑豆等令黄，乘热便投于柳枝酒内，须臾去滓令净。<br>【主治】偏风手足不随，口面?斜。<br>【用法】每服旋取，温服二合至三合，空心临卧各一服。
马齿苋酒方	马齿苋酒方――（难产）<br><br>（《圣济总录》）<br>【配方】马齿苋（捣绞取自然汁）三分。<br>【制法】上一味，入酒二分。<br>【主治】催产。<br>【用法】微暖服之，立产。
蛮夷酒（三）	蛮夷酒（三）――（半身不遂）<br>（《普济方》）<br>【配方】矾石、白术、狼毒、半夏、石楠、龙胆、续断、芫花、白石英、代绪、茹、石苇、白石脂、玄参、天雄、防风、山茱萸、桔梗、藜芦、卷柏、寒水石、白芷、秦艽、菖蒲各一两，矾石、远志各二两，石膏二两半，蜈蚣一枚，芒硝、恒山、黄芩、黄连、大黄、麻黄、干地黄、前胡、生甘草、菟丝子、芍药、紫苑各一两，杏仁二十枚。<br>【制法】同捣筛，绢袋盛，用水三斗，曲三斤，黍米三斗作饭，依酿酒法，以药袋置酿中，春秋七日，冬十日，夏三日酒成。<br>【主治】八风十二痹，偏枯不遂，宿食久寒虚冷，五劳七伤，及妇人产后余疾，月水不调。<br>【用法】服半鸡子壳，日三服，曝药为末，酒服方寸匙，以身体暖为度。
蛮夷酒1（三）	蛮夷酒（三）――（癞病）<br>（《备急千金要方》）<br>【配方】独活、丹参、矾石、干地黄各一两，附子、麦门冬各二两，白芷、乌啄、鸟头、人参、狼毒、蜀椒、防风、细辛、矾石、寒水石、牛膝、麻黄、芎　、当归、柴胡、芍药、牡蛎、桔梗、狗脊（千金翼作枸杞）、天雄各半两，苁蓉、茯神（千金翼作茯苓）、金牙、薯蓣、白术、杜仲、石南、款冬各十八株，干姜、芜荑、芫花、柏子仁各一合，山茱萸、牡荆子各十八铢，石斛、桂心各六铢，甘遂二两，苏子一升，赤石脂二两半。<br>【制法】上四十五味口父咀，以酒二斗渍，夏三日，春秋六日，冬九日。密室中合药，勿令女人六畜见之，三日清斋乃合。<br>【主治】主久风枯挛，三十年著床，及诸恶风眉毛堕落。<br>【用法】一服半合。<br>说明：《普济方》一方同上。
蔓荆酒	蔓荆酒――（耳聋）<br>（《普济方》）<br>【配方】蔓荆子（微炒）一升。<br>【制法】以酒二升浸，寒七日，暑三日，去滓。<br>【主治】治耳聋。<br>【用法】任性饮之，虽久聋亦瘥。
蔓荆子酒	蔓荆子酒――（感冒）<br>（验方）<br>【配方】蔓荆子200克，醇酒500克。<br>【制法】将上药捣碎，用酒浸于净瓶中，7日后，去渣备用。<br>【主治】外感风热所致头昏头痛及偏头痛。<br>【用法】每次徐饮10-15毫升，每日3次。
毛鸡药酒	毛鸡药酒――（产后血晕）<br><br>（药典）<br>【配方】干毛鸡（或鲜毛鸡320克，均除去毛，去内脏）、当归、红花各160克，赤芍、桃仁各15克，白芷160克，茯苓20克，川芎、千年健各160克，白酒16960毫升。<br>【制法】先将干毛鸡（鲜毛鸡不蒸）用蒸气蒸15分钟，放凉，用适量白酒浸泡25天后，再将其余各药同置容器中，加剩余白酒密封，约45-55天，滤过即得。<br>【主治】妇女产后血晕，或肢体疼痛，及痛经、闭经等症。<br>【用法】每次饮15-30毫升，日3。<br>说明：感冒发烧、喉痛目赤禁用。
没药鸡子酒方	没药鸡子酒方――（跌打损伤）<br>跌打损伤指跌打、打伤、摔伤、金刃伤、竹木伤等外伤病和烧伤、冻伤、毒虫咬（螯）伤、毒蛇咬伤、狂犬病等损伤性疾病的范畴。选择药酒，应注重辨证论治。<br>（《太平圣惠方》<br>【配方】没药（研末）半两，生鸡子三枚，细酒一升。<br>【制法】上药先将鸡子开破，取白去黄，盛碗内，入没药，以酒暖令热，投于碗中令匀。<br>【主治】治坠落车马，筋骨疼痛不止。<br>【用法】不计时候温服。<br>说明：《普济方》方中细酒作“陈酒”，余皆同上。
没药酒方	没药酒方――（产后血晕）<br><br>（《圣济总录》）<br>【配方】没药半两。<br>【制法】上一味，用酒三盏，将没药磨尽。<br>【主治】治产后血晕，及腹疼。<br>【用法】每服一盏，煎沸温服。<br>说明：《普济方》同上。
玫瑰露酒	玫瑰露酒――（胃脘痛）<br>胃脘痛是以胃脘部疼痛为主要症状的一种病症。多因忧思郁怒，肝气犯胃，饮食不节，脾胃虚弱等造成。临床表现有实有虚，实记以寒凝气滞、饮食积滞、肝郁气滞，瘀血阻络为多，虚记以脾胃虚寒为多。对于寒凝气滞、脾胃虚寒者，药酒用之尤宜，常用者如温脾酒、灵脾肉桂酒；对于肝胃不和者，常用佛手、玫瑰花等行气药配制，借酒以行其药势，如佛手酒，玫瑰露酒等；血瘀者，亦可用活血药制成药酒服用。<br>（《全国中药成药处方集》）<br>【配方】鲜玫瑰花3500克，白酒15000克，冰糖2000克。<br>【制法】将花浸入酒中，同时放入冰糖，浸月余，要用瓷坛或玻璃瓶贮存，不可加热。<br>【主治】肝胃不和所致胃脘胀痛或刺痛、连及两胁，嗳气频繁，食欲不振等症。<br>【用法】每次饮1-2盅。
美髯醑	美髯醑――（乌须黑发）<br>（《摄生秘剖》）<br>【配方】桑椹子（火烧干）十两，何首乌（用黑芝麻煮过）十两，冬青子（盐水炒）二两，旱莲草（晒干）三两，熟地黄（怀庆者）七两，乌饭叶（切碎）三两，黑豆皮（不用豆）三两，干茄花（净瓣）三两，乌犀角（用铜罐河水熬，滴水成珠）三两。<br>【制法】上用无灰酒六十斤，将药用绢袋盛之，投入酒内，封固坛口煮三炷香，放土地上出火气。<br>【主治】此酒乌须神良。<br>【用法】不拘时，多少随意饮之，每饮加青盐少许，引入肾经为佳。<br>“夫人生世间，顶天立地称丈夫者，惟藉此须眉尔，岂可任其枯槁，皓白而慢不为理乎，此乌须之术，宜亟讲也。斯用桑椹、首乌、冬青、旱莲、熟地、茄花、犀角、青盐、乌饭叶、黑豆皮、皆乌须之圣药，而渍之以酒者，使循经络达毛窃也。向之，枯者润，白者黑，复为一美髯丈夫矣。且考桑椹等品，仙经圣典极称其妙用，故能补肾填精、驻颜益寿，岂区区乌须而已哉。
麋骨酒（二）	麋骨酒（二）――（悦色驻颜）<br>（《普济方》）<br>【配方】麋骨（煮作汁）。<br>【制法】以上味酿酒。<br>【主治】令人肥白，美颜色。<br>【用法】饮之。<br>说明：方名系笔者所加。
秘传药酒	秘传药酒――（手足不遂）<br>（《万病回春》）<br>【配方】当归、白芍（炒）、生地、牛膝、秦艽、木瓜、黄柏（盐炒）、杜仲（姜炒）、防风、陈皮各30克，川芎、羌活、独活各25克，白芷30克，槟榔18克，肉桂、炙甘草各10克，油松节15克，酒1.5公斤。如久痛，可加虎胫骨（酥炙）25克，苍术（炒）30克。<br>【制法】将上药共捣碎，入绢袋中，用酒浸于瓮内，火上煮1小时，去渣备用。<br>【主治】瘫痪腿痛，手足麻痒不能动者。<br>【用法】早、晚随量饮。
蜜膏酒	蜜膏酒――（失音）<br>（《备急千金要方》）<br>【配方】蜜、饴糖各250克，生姜汁、生百部汁各12毫升，枣肉（捣泥）、杏仁（捣泥）各75克，橘皮末60克。<br>【制法】先将杏仁和水1公斤，煮取减半，去渣，再将其余各味入内，文火再熬，取1公斤。<br>【主治】肺气虚寒，风寒所伤语声嘶塞，咳唾上气，喘嗽及寒郁热邪，喑哑。<br>【用法】每次用温酒调服2勺，细细咽之，每日3次。
蜜酒	蜜酒――（风瘾疹）<br>（《本草纲目》）<br>【配方】沙蜜120克，糯米饭120克，干曲150克，熟水1.5公斤。<br>【制法】将沙蜜同糯米饭、曲、水共入瓶内，封7日成酒，去渣备用。寻常以蜜入酒代之，亦良。<br>【主治】风疹风癣。<br>【用法】每次食前，温服1杯，每日3次。
牡荆酒方	牡荆酒方――（耳聋）<br>（《圣济总录》）<br>【配方】牡荆子（微炒）一升。<br>【制法】上一味，以酒二升浸，寒七日，暑三日，去滓。<br>【主治】治耳聋。<br>【用法】任性饮之，虽久聋亦差。
牡荆子酒	牡荆子酒――（耳聋）<br>（验方）<br>【配方】牡荆子50克，白酒500毫升。<br>【制法】将牡荆子入酒内浸泡七日后服用。<br>【主治】年久耳聋。<br>【用法】每服20-30毫升，日服2次。
木防己酒	木防己酒――（小儿痫证）<br>（《普济方》）<br>【配方】木防己一钱四分，铅丹、防风、桂心、龙齿各八分，丹砂、甘草（炙）各六分，独活二分，细辛、当归、干姜各五分，莽草一分。<br>【制法】上切，入绢袋中，酒五升浸五熟。<br>【主治】治小儿风痫发动，手足不仁。<br>【用法】初服半合，日三服。
木瓜酒速溶剂	木瓜酒速溶剂――（痹证）<br>（《科技简报》）<br>【配方】木瓜18750克，桑枝25000克，川芎6250克，桑寄生16250克，天麻6250克，当归、川断各12500克，甘松6250克，红花12500克，怀牛膝18750克，生玉竹31250克，制狗脊18750克，50%乙醇适量，蔗糖适量。<br>【制法】上药除红花外，均打成粗粉，过直径1厘米筛，加入红花充分混匀，用适量乙醇湿润，按常规渗漉，收渗漉液，减压回收乙醇，至乙醇全部蒸尽，得浸膏，加适量糖粉，充分搅匀，制成颗粒，干燥，包装，每袋50克。<br>【主治】风寒湿气侵入筋骨肌肉、关节四肢，疼痛、筋脉拘急者。<br>【用法】每袋加烧酒500克溶解，适量饮用。
内消浸酒方	内消浸酒方――（瘰疠）<br>（《圣济总录》）<br>【配方】仙人杖草根并苗一斤，羌活（去芦头）二两，杏仁（去皮尖研炒）二两。<br>【制法】上三味，将前二味细v，入研杏仁，以醇酒一斗，于瓶内密封，七日后取开。<br>【主治】治风热毒气，结成瘰疠。<br>【用法】每日空心暖服一盏，临睡再服。<br>说明：《普济方》载本方三味药的用量分别为三斤、一斤和一两。余同上。
南藤酒	南藤酒――（痹证）<br>（《本草纲目》）<br>【配方】石楠藤1公斤，曲200克，糯米5公斤。<br>【制法】用石楠藤煎汁，同曲、米如常法酿酒。<br>【主治】风寒湿痹，腰膝无力，跌打瘀痛。<br>【用法】每服1-2杯，每日3次。<br>说明：本方源于《本草纲目》，其卷二十五附诸药酒条云：“治风虚，逐冷气，除痹痛，强腰脚。石南藤煎汁，同曲、米酿酒饮”。
牛蒡酒（二）	牛蒡酒（二）――（风疾诸病）<br>（《普济方》）<br>【配方】牛蒡子、生干地黄、枸杞子各三两，牛膝五两（去苗）。<br>【制法】上药细v，用生绢袋盛，以好酒二斗，于瓷器内浸，密封，春夏七日，秋冬二七日后。<br>【主治】柔风，久不瘥，四肢缓弱。<br>【用法】每日空心温服一小盏，晚食后再服，常令醺醺妙。
牛蒡酒（一）	牛蒡酒（一）――（风疾诸病）<br>（《普济方》）<br>【配方】牛蒡根（细切）一升，生地黄（细切）、牛膝（细切）、枸杞子（微碎）各三升。<br>【制法】上取无灰酒三升渍药，以　绢袋盛之，春夏一七日，秋冬二七日。<br>【主治】疗一切风，乃至十年二十年不瘥者。<br>【用法】每服皆须在空腹服，仍须稍稍令有酒色。
牛蒡子浸酒方（二）	牛蒡子浸酒方（二）――（风疾诸病）<br>（《普济方》）<br>【配方】牛蒡子、牛膝（去苗）、生地黄、枸杞子、干桑椹、大麻子以上各半斤。<br>【制法】上细v，用生绢袋盛，以无灰酒三斗浸之，春夏七日，秋冬三七日开。<br>【主治】治一切风。<br>【用法】每饮一小盏，常以酒气相继，日三五度饮之。忌生冷、毒滑动风物。
牛蒡子酒浸酒方（一）	牛蒡子酒浸酒方（一）――（风疾诸病）<br>（《太平圣惠方》）<br>【配方】牛蒡子、牛膝（去苗）、生地黄、枸杞子、干桑椹、大麻子各半斤。<br>【制法】上件药，细v，用生绢袋盛，以无灰酒三豆+斗浸之，春夏七日，秋冬二七日开。<br>【主治】治一切风。<br>【用法】每饮一小盏，常以酒气相接，日三五度饮之。忌生冷毒滑动风物。
牛黄酒	牛黄酒――（小儿痫证）<br>（《普济方》）<br>【配方】牛黄、钟乳（研）各八分，麻黄（去节）、秦艽、人参各八分，桂心七分，龙角、白术、甘草、当归、细辛各五分，杏仁四分，蜀椒、蜣螂（炙）九枚。<br>【制法】上切以绢袋中，酒五升浸之，随时月数。<br>【主治】治小儿惊痫，经年小劳辄发。<br>【用法】半合，日三。
牛膝参归酒	牛膝参归酒――（闭经）<br><br>闭经中医习惯称为“经闭”。凡年过18岁仍未行经者，称为“原发性闭经”；在月经初潮之后至正常绝经之前的任何时间内（除外妊娠及哺乳期），出现月经闭止，并超过3个月者，称为继发性闭经。中医将以上情况也称为“不月”。对妇女身无他病而月经又不按月来潮者，如两个月来一次月经，称“半月”；三个月来一次者，称“居经”或“季经”；一年才来一次者，称“避年”；甚者有终身不行经，或每月届期仅有腰酸感觉而能受孕者，称为“暗经”。以上均属正常，不能与经闭同样对待。闭经的主要原因为血虚和血滞两大类。以下介绍治疗经闭的五种药酒，望临证分清虚实而用之。<br>（《四川中草药通讯》）<br>【配方】牛膝30克，党参、当归、香附各15克，红花、肉桂各9克，白酒半公斤。<br>【制法】将上药切碎，浸入酒中，容器密封7天即成。<br>【主治】妇女闭经。<br>【用法】早、晚各服1次，早5-10毫升，晚10-20毫升，服至月经来潮为止。如果身体强壮，能够耐受，也可适度增饮20-30毫升，有利于缩短疗程。<br>说明：先天性生殖器官质性疾病，如无子宫、无卵巢、阴道闭锁等用此酒难以奏效。孕妇及心脏病、支气管哮喘、白带过多者，不宜服用此酒。
牛膝蚕沙酒	牛膝蚕沙酒――（半身不遂）<br>（《普济方》）<br>【配方】牛膝70克，牛蒡子（微炒）36克，防风30克，牛蒡根40克，萆30克，大麻子、晚蚕沙各40克，枸杞子、羌活、海桐皮各30克，秦艽20克，黑豆（炒熟）、苍耳子、制附子各30克，五加皮、茄子根各60克，虎胫骨（涂酥炙微黄）30克，好酒2.5公斤。<br>【制法】将上药共捣细，以纱袋盛，置于坛内，用酒浸之，密封口，7天后即可取用。<br>【主治】半身不遂，腰膝疼痛，四肢麻木，血气凝滞，少腹冷痛。<br>【用法】每次空心温饮1-2杯，每日午、晚各服1次，随饮随添新酒，味淡即换药。<br>说明：勿食猪、鸡、毒鱼、黏滑物。
牛膝大豆浸酒方	牛膝大豆浸酒方――（痹证）<br>【配方】牛膝（酒浸切焙）一斤，大豆（紧小者炒熟）一斤地黄（洗切）一斤。<br>【制法】上三味，拌匀，同蒸一　倾出，绢囊贮，以酒三斗浸经宿。<br>【主治】久患风湿痹，筋挛膝痛，兼理胃气结聚，止毒热，去黑痣面黑＋干，润皮毛。<br>【用法】每服三合至五合，空心日午夜卧温服。<br>说明：《普济方》同上。
牛膝丹参酒方	牛膝丹参酒方――（脚气）<br>（《圣济总录》）<br>【配方】牛膝、丹参、薏苡仁炒）、生干地黄各半斤，五加皮、白术各五两，侧子（炮裂去皮脐），萆　、赤茯苓、防风各四两，独活、石斛（去根）各六两，茵芋（用叶）、桂、天雄（炮去皮脐）、人参、芎　、石南叶（炙）各三两，细辛（去茵叶）、升麻各二两，磁石（煅酒碎七遍）一斤，生姜五两。<br>【制法】上二十二味，v如小豆大，绢袋盛，以无灰酒五斗，浸一七日，密封勿令通气。<br>【主治】治脚气入冬即苦脚痹弱，或筋骨疼不能屈伸，皮肤麻痹不仁，手脚指节肿满闷，或四肢肿腰胫直。<br>【用法】日满空心取半盏一盏，温饮之，日五服，不饭酒者，频频少服，以知为度。<br>说明：《普济方》前四味药有得为各半两，细辛、升麻各三两，余均同上。
牛膝独活酒	牛膝独活酒<br>【来源】《千金方》<br>【原料】桑寄生30g牛膝45g独活25g秦艽25g杜仲40g人参10g当归35g白酒1000ml。<br>【制作】1将所有药材洗净后切碎；2放入纱布袋中，缝口；3放入酒中，浸泡30天；4将药渣取出，过滤备用。<br>【功效】补养气血，益肝强肾，除祛风湿，止腰腿痛。<br>【用法】每次10～30ml，每日1次(上午9～11点服用为佳）。<br>【药材功效解析】杜仲、牛膝、桑寄生：补益肝肾，强筋壮骨。当归、人参：养血益气。秦艽：法湿宣痹止痛。此酒主治腰膝发凉、麻木、酸软疼痛，腿足屈伸不利，痹着不仁，肝肾两亏，风寒湿痹。<br>【宜忌】
牛膝附子酒	牛膝附子酒――（痹证）<br>（《圣济总录》）<br>【配方】牛膝、秦艽、天冬各15克，薏苡仁、独活、细辛（炙）、制附子、巴戟天各10克，五加皮15克，肉桂10克，杜仲15克，石楠叶10克，清酒1公斤。<br>【制法】将上药共捣细，用酒浸于瓶中，冬十日，春七日，秋五日，夏三日后，去渣备用。<br>【主治】手臂麻木不仁，腰膝酸痛，行步脚弱，屈伸挛急，四肢不温及阳痿，便溏，肌肉酸痛。<br>【用法】每次服15毫升，渐加至25毫升，每日早、中、晚各1次。
牛膝浸酒（二）	牛膝浸酒（二）――（半身不遂）<br>（《普济方》）<br>【配方】牛膝一两，秦艽一两，天门冬（去心）一两半，薏苡仁一两，独活一两，细辛半两，附子（炮裂去皮脐）一两，五加皮一两，桂心一两，丹参一两，杜仲（去粗皮）一两，酸枣仁一两，仙灵脾一两，晚蚕沙（微炒）二两。<br>【制法】上细v，以生绢袋盛，好酒一斗五升，浸经七日。<br>【主治】妇人中风偏枯，一边手足不收，顽麻不仁，筋脉拘急，不能运动。<br>【用法】每日不计时候温饮一小盏，常令有酒气为佳。
牛膝浸酒（一）	牛膝浸酒（一）――（Y瘕）<br>（《普济方》）<br>【配方】牛膝二斤。<br>【制法】上以酒二斗渍，密封热火灰中温，令味出。<br>【主治】卒暴症腹中有如刺，昼夜啼。<br>【用法】服五合至一升，量力服。<br>说明：此方名系笔者据药用制法所命名，原书无方名。
牛膝浸酒方（二）	牛膝浸酒方（二）――（腰脚疼痛诸病）<br>（《太平圣惠方》）<br>【配方】牛膝（去苗）、菖蒲、酸枣仁（微炒）、芎、石斛（去根）、仙灵脾、赤箭、虎胫骨（涂酥炙微黄）、桂心、附子（炮裂去皮脐）、萆各三两。<br>【制法】上药细v，以生绢袋盛，用好酒一斗，于瓷瓶中浸，密封，经七日后开取。<br>【主治】诸风，腰脚疼痛，及皮肤不仁，筋脉挛急。<br>【用法】每温饮一盏，常令醺醺，不得大醉，酒尽更添，以药味薄即换之。忌生冷毒滑物。
牛膝浸酒方（三）	牛膝浸酒方（三）――（半身不遂）<br>（《普济方》）<br>【配方】牛膝（去苗）、茄子根各八两，防风（去芦头）、鼠粘子（微炒）各三两，萆　、枸杞子、羌活、海桐皮、苍耳子（捣碎）、附子（炮裂去皮脐）、五加皮、虎胫骨（涂酥炙黄）各二两，牛蒡子四两，大麻子（捣碎）、晚蚕沙、黑豆（炒熟捣碎）各三合（两），秦艽（去苗）一两。<br>【制法】上细v，以生绢袋盛，用好酒三斗，密封头，浸经七日。<br>【主治】风及偏枯，腰膝疼痛。<br>【用法】每日空心午时及夜临卧，温饮一小盏，其酒旋添，味淡即换药，忌猪肉鸡毒鱼粘滑物。<br>说明：《奇效良方》无鼠粘子，主治风菲偏枯，腰膝疼痛，余同上。
牛膝浸酒方（四）	牛膝浸酒方（四）――（腰脚疼痛诸病）<br>（《太平圣惠方》）<br>【配方】牛膝（去苗）三两，萆三两，桂心二两，羌活二两半，附子（炮裂去皮脐）二两，当归二两，防风（去芦头）二两，虎胫骨（涂酥炙微黄）三两。<br>【制法】上诸药细v，以生绢袋盛，以酒二豆+斗，于瓷瓶中浸，密封，经七日开。<br>【主治】腰脚疼痛，不任行立。<br>【用法】每于食前，温一小盏服。
牛膝浸酒方（一）	牛膝浸酒方（一）――（半身不遂）<br>（《太平圣惠方》）<br>【配方】牛膝（去苗）、茄子根各八两，鼠粘子（微炒）三两，防风（去芦头）、萆　、枸杞子、羌活、海桐皮、苍耳子（捣碎）、附子（炮裂去皮脐）、虎胫骨（涂酥炙微黄）各二两，牛蒡根四两，大麻子（捣碎）、晚蚕沙各三合，黑豆（炒熟捣碎）二合。<br>【制法】上药细v，以生绢袋盛。用好酒三斗，密封瓮头，浸经七日。<br>【主治】风及偏枯，腰膝疼痛。<br>【用法】每日空心午时及夜临卧温饮一小盏，其酒旋添，味淡即换药，忌猪鸡毒鱼粘滑物。
牛膝酒（九）	牛膝酒（九）――（风疾诸病）<br>（《千金翼方》）<br>【配方】牛膝、石南、乌头（去皮）、天雄（去皮）、茵芋各二两，细辛五分。<br>【制法】上六味切，以酒一斗二升渍之，春秋五日，夏三日，冬七日。<br>【主治】主八十三种风著人头，面肿痒，眉发陨落，手脚拘急不得行步，梦与鬼神交通，或心烦恐怖，百脉自惊，转加赢瘦等。<br>【用法】初服半合，治风癫宿　服之即吐下，强人日三，老少日一，不知稍加。惟禁房室及猪肉等。
牛膝酒（六）	牛膝酒（六）――（脚气）<br>（《普济方》）<br>【配方】生牛膝、生地黄各半斤（洗净控干曝两日）。<br>【制法】上捣如泥，作团，以纸裹，外更以黄泥固济，微火炙令泥有裂处，待干，即于地炉中灰火养半日，次以灰火渐渐烧之，加至火三斤，烧一伏时，取出候冷，去泥纸罗为散。<br>【主治】治脚气极冷，着厚绵衣盖覆不觉暖者。<br>【用法】每服五钱，酒一盏半，以瓷器煎七分，和滓，食前顿服之。老小以意加减服之。
牛膝酒（三）	牛膝酒（三）――（疟疾）<br>（《普济方》）<br>【配方】牛膝茎叶。<br>【制法】用牛膝茎叶一把，切，以酒三引渍一宿。<br>【主治】疟疾。<br>【用法】分三服，令微有酒气，不即断更作，不过三服止。
牛膝酒（五）	牛膝酒（五）――（小儿口疮）<br>小儿口疮多由心脾二经积热上熏所致。可见口颊或唇舌边发生白色溃烂小泡，红肿疼痛，间有微热。中医也称“口疳”、“口破”。实火所致者色鲜红，烂斑密布，甚者腮舌俱肿，小便黄赤，大便干；虚火上炎所致者，其色淡红，有白斑而无其他热证。小儿口疮多可由疳积所致，故有“口疳”之称。以下介绍牛膝酒治疗小儿口疮，其意在于引火下行，临证可供试用。<br>（《圣济总录》）<br>【配方】牛膝（切）一两。<br>【制法】上以清酒二盏，煎至七分。<br>【主治】治小儿口疮。<br>【用法】去滓分温三服，日二，以瘥为度。<br>说明：《普济方》牛膝用二两，余同上。
牛膝酒方（七）	牛膝酒方（七）――（脚气）<br>（《太平圣惠方》）<br>【配方】牛膝（切炒）、侧子（炮裂去皮脐）、丹参、山茱萸（炒）、蒴　、杜仲（去粗皮）、石斛（去根）各二两，防风（去叉）、蜀椒（去目并合口炒出汗）、细辛（去苗叶）、独活（去芦头）、秦艽（去苗土）、桂（去粗皮）、薏苡仁（捣碎）、芎、当归（切焙）、白术、茵芋（炙）各一两半，五加皮（炙）二两半，干姜（炮）一两。<br>【制法】上十二味，口父咀如麻豆大，以绢袋盛。内净瓮中，清酒三斗浸，寒七日，暑三日。<br>【主治】治脚气温痹不仁，脚弱不能行走。<br>【用法】初服半盏，稍加以知为度，患目昏头旋者，服之弥佳。
牛膝酒方（三）	牛膝酒方（三）――（筋骨诸病）<br>（《圣济总录》）<br>【配方】牛膝（去苗v）、薏苡仁各半斤，酸枣仁（微炒）、赤芍药、附子（炮裂去皮脐）、干姜（炮）、柏子仁、石斛（去根）各三两，甘草（微炙）二两。<br>【制法】上九味，细v和匀，用生绢袋盛，以好酒二斗浸七日。<br>【主治】肝风筋脉抽掣疼痛。<br>【用法】不拘时温饮一盏，旋添酒渍药，至味薄即止。
牛膝木瓜酒	牛膝木瓜酒――（手术后肠粘连）<br>手术后肠粘连引起的症状较多，病情较急，中医学认为肠粘连多因术后创伤，正气不足，肝脾不和，气滞血凝而成。治宜疏肝畅脾，行气活血。俾肝脾得理，气血运行，瘀滞得化，疼痛缓解。<br>（《新中医》）<br>【配方】牛膝、木瓜各50克，白酒500克。<br>【制法】将上药浸于酒中，7天后即可饮用。<br>【主治】手术后肠粘连。<br>【用法】每晚临睡前服1次，视个人酒量而定，以能够耐受为度。<br>说明：牛膝、木瓜的用量可供连续浸3次酒，即前后共泡白酒1500克。
牛膝人参酒	牛膝人参酒――（阳萎）<br>（《圣济总录》）<br>【配方】牛膝、山萸肉、川芎、制附子、巴戟天、五味子、黄芪、人参各20克，五加皮、肉苁蓉、生姜、防风各25克，肉桂15克，海风藤（原方茵芋）10克，生地、蜀椒各15克，磁石（醋煅淬）20克，无灰酒1.5公斤。<br>【制法】将上药共捣细，用酒浸于瓶中，春夏3日，秋冬7日即可开取，去渣备用。<br>【主治】腰脚疼痛，下元虚冷，阳萎滑泄，便溏腹痛，气虚无力。<br>【用法】每日服15-20毫升，不拘时，频频温饮，常令有酒气相续。
牛膝肉桂酒	牛膝肉桂酒――（阳萎）<br>（《圣济总录》）<br>【配方】牛膝、秦艽、川芎、防风、肉桂、独活、丹参、云苓各30克，杜仲、制附子、石斛、干姜、麦冬、地骨皮各25克，五加皮40克，薏苡15克，大麻仁10克，清酒1.5公斤。<br>【制法】将上药共捣细，用酒浸于瓷瓶中，春夏3日，秋冬7日后开取，去渣备用。<br>【主治】腰膝酸痛，阳萎滑泄，大便溏，腿脚虚肿，关节疼痛，四肢不温，腹部冷痛。<br>【用法】每次服15毫升，空心温服，每日3次。
牛膝石斛酒	牛膝石斛酒――（痹证）<br>（《圣济总录》）<br>【配方】石斛（去根）85克，牛膝（酒浸切焙）15克，杜仲（炒断丝去粗皮）120克，丹参90克，熟地黄（焙）150克，肉桂（去粗皮）60克，酒2公斤。<br>【制法】将上药共为粗末，用酒浸于瓷瓶内，密封口，以开水煮沸百回，取出令冷，开封，去渣备用。<br>【主治】风寒湿气痹阻腰脚，软弱无力，麻木不仁。<br>【用法】每温饮1-2杯，不拘时，常令如微醉。
牛膝玉米酒	牛膝玉米酒――（痹证）<br>（《圣济总录》）<br>【配方】牛膝、薏苡仁、酸枣仁、赤芍药、制附子、炮姜、石斛、柏子仁各30克，炙甘草20克，好酒1.5公斤。<br>【制法】将上药共捣细和匀，置瓶中，酒浸，封口，七日后即可取用。<br>【主治】手臂麻木不仁腰膝冷痛，筋脉抽挛，肢节不利，大便溏，精神萎靡。<br>【用法】每温饮15-20毫升，不拘时，旋添酒渍药，味薄即止。
女贞皮酒	女贞皮酒――（腰脚疼痛诸病）<br>（《本草纲目》）<br>【配方】女贞皮30克，白酒500毫升。<br>【制法】女贞皮切片，浸泡于酒内，7日后可服用。<br>【主治】风虚，腰膝无力等症。<br>【用法】每服20-30毫升，日服2-3次。<br>说明：煮热服用。
排风酒方（二）	排风酒方（二）――（产后风痉）<br><br>（《圣济总录》）<br>【配方】羌活（去芦头）、防风（去叉）各一两，大豆（拭去土熬令皮拆声出）半斤。<br>【制法】上三味，以醇酒三升，浸羌活防风经一宿，即炒大豆令有声，乘热投于酒中，搅匀封盖，经半日，于铛中重汤文火煮一时。<br>【主治】治产后中风，口噤四肢麻痹不仁，或角弓反张。<br>【用法】乘热尽量顿服，被衣覆盖，当有微汗。如不能饮，即量性服之，使令微似醉状。若要急用即以酒煎羌活防风汁淋豆服之，变痢。服不尽一剂，即瘥。
泡酒方	泡酒方――（眩晕）<br>（《慈禧光绪医方选议》）<br>【配方】鲜石菖蒲、鲜木瓜各20克，桑寄生30克，小茴香10克，九月菊20克，烧酒1.5公斤。<br>【制法】将上药用纱袋盛，悬于净器中，注酒浸之，7日后即可取用。<br>【主治】眩晕，耳鸣，阳虚恶风，消化不良，行走无力。<br>【用法】每日早晨温饮1小杯。
霹雳酒	霹雳酒――（崩漏）<br><br>（验方）<br>【配方】铁器1小块，酒适量。<br>【制法】将铁器烧赤，投入酒中，候温备用。<br>【主治】妇女血崩，胎产不下。<br>【用法】温饮。<br>说明：本方来原于《本草纲目》，其卷二十五附诸药酒条云：“治疝气偏坠，妇人崩中下血，胎产不下。以铁器烧赤，浸酒饮之。
葡萄酒方（二）	葡萄酒方（二）――（悦色驻颜）<br>（《太平圣惠方》）<br>【配方】干葡萄末一斤，细曲末五斤，糯米五斗。<br>【制法】上饮糯米令熟，候稍冷，入曲并葡萄末，搅令匀，入瓮盖覆，候熟，即时饮一盏。<br>【主治】驻颜，暖腰肾。<br>【用法】即时饮一盏。<br>说明：《医部全录》同上。
葡萄酒方（一）	葡萄酒方（一）――（乳病）<br>（《圣济总录》）<br>【配方】葡萄一枚。<br>【制法】上一味，于灯焰上燎过，研细。<br>【主治】治吹乳。<br>【用法】热酒调服。<br>说明：《普济方》同上。
蒲公英酒	蒲公英酒――（乳病）<br>乳病是乳房部位多种病证的总称。乳房可出现不同程度、不同性质的疼痛、肿胀、结块、溃烂，或乳头糜烂、乳窍溢液、出血等证候。属于外科临床常用疾病。妇女的发病率明显高于男子。治疗乳病的药酒，多有疏肝解郁，通乳散结，清热解毒，活血化瘀等功效。根据证候，选择药酒，有一定疗效。<br>（《景岳全书》）<br>【配方】鲜蒲公英1握，酒1小茶杯。<br>【制法】将上药捣烂入酒，去渣。<br>【主治】乳痈，乳房肿痛。<br>【用法】随量温饮，不拘时候。渣贴患处。
蒲黄酒方	蒲黄酒方――（流产）<br><br>（《圣济总录》）<br>【配方】蒲黄（炒）一合，槐子（为末）十四枚。<br>【制法】上二味，以酒三盏，煎至二盏，去滓。<br>【主治】治妊娠堕胎。<br>【用法】分温二服，未下更服。<br>说明：《普济方》注本方出“《大全良方》，一名槐子丸，治妊娠堕胎，胞衣不出”。余皆同上。
蒲金酒	蒲金酒――（乳病）<br>（《验方新编》）<br>【配方】蒲公英、金银花各15克，黄酒2杯。<br>【制法】将上药同酒煎至半，去渣候温，分2份。<br>【主治】吹乳结痛（乳腺炎）。<br>【用法】早、晚饭后各1份。以药渣敷患处。<br>说明：如不愈，再依法配制。
千金疗乍寒乍热，乍有乍无，山瘴疟酒方	千金疗乍寒乍热，乍有乍无，山瘴疟酒方――（疟疾）<br>（《外台秘要》）<br>【配方】常山三两，鳖甲（炙）、升麻、附子、乌贼鱼骨（去甲）各二两。<br>【制法】上五味并切，绢袋盛，以酒六升渍之，小令近火转之，一宿成。<br>【主治】疗乍寒热，乍有乍无，山瘴疟。<br>【用法】一服一合，比发可数服，或吐，忌猪肉、生葱、生菜、苋菜。
千金翼蓟根酒方	千金翼蓟根酒方――（崩漏）<br><br>（《外台秘要》）<br>【配方】大小蓟根各一斤。<br>【制法】以酒一斗渍五宿。<br>【主治】疗妇人崩中去血不止。<br>【用法】饮服之，任意多少。
牵牛酒	牵牛酒――（水肿臌胀）<br>（《本草纲目》）<br>【配方】干鸡矢（炒黄）一升。<br>【制法】上以好酒三碗，煮一碗，滤汁。<br>【主治】治一切肚腹、四肢肿胀，不拘鼓胀、气胀、湿胀、水胀等。<br>【用法】饮之，少顷，腹中气大转动，利下，即自脚下皮皱消也。未尽，隔日再作。仍以田螺二枚，滚酒沦食，后用白粥调理。<br>说明：本方见《本草纲目》卷四十八鸡条，引积善堂经验方。谓：“有峨嵋一僧，用此治人得效，其人牵牛来谢，故名”。
牵正独活酒	牵正独活酒――（口眼?斜）<br>（验方）<br>【配方】独活50克，大豆（紧小者炒熟）200克，白附子10克，清酒1公斤。<br>【制法】将上药粗碎，以酒煎数沸，去渣。<br>【主治】口眼歪斜。<br>【用法】每次饮10毫升，日2次，夜1次。
铅酒方	铅酒方――（痈疽、疮疡、发背）<br>（《圣济总录》）<br>【配方】铅五两，酒（无灰者）一斗。<br>【制法】上二味，将铅熔成汁，投入酒中，又取铅熔，再投酒中，如此十度，然后净滤澄清。<br>【主治】治热毒肿，或身生癌浆。<br>【用法】时饮三合至五合，不可过醉，醉甚则吐。损正气。<br>说明：《普济方》同上。
铅酒方1	铅酒方――（痈疽、疮疡、发背）<br>（《圣济总录》）<br>【配方】黑铅一斤，甘草（炙v）三两。<br>【制法】上二味，用酒一斗，置一空瓶在傍，先以甘草入酒中，然后熔铅投之，却滤出酒，在空瓶内，取铅依前熔投，如此九度，并甘草去之。<br>【主治】治发背。<br>【用法】留酒恣饮，醉寝即愈。
茜草酒	茜草酒――（关节疼痛）<br>（《陕甘宁青中草药选》）<br>【配方】鲜茜草根1-2两，白酒2斤。<br>【制法】洗净，浸入2斤好白酒中，7日后可服用。<br>【主治】关节疼痛。<br>【用法】每日1次，空腹热服。第1次喝七、八成醉，盖被取汗，以后酌减。
羌活酒（二）	羌活酒（二）――（产后腹痛）<br><br>（（圣济总录》）<br>【配方】羌活（去芦头v）。<br>【制法】上一味，以醇酒煎半两。<br>【主治】产后中风腹痛。<br>【用法】候浓温服。<br>说明：可用羌活15克，用醇酒一杯煎约半杯（35毫升），候浓温服，主治同上。
羌活酒（六）	羌活酒（六）――（半身不遂）<br>（《圣济总录》）<br>【配方】羌活（去芦头）半两，独活（去芦头）半两，芎　半两，大麻子仁（炒研）一合，黑豆（去尘土不捣）一合。<br>【制法】上五味，内四味，粗捣筛，以黍米酒四升浸，夏月三日，秋冬七日。日满更煎十余沸，炒黑豆烟起，乘热倾于酒中，窨经小时净，绞去滓。<br>【主治】偏风才得，冒闷不知人，手足戈，便速服此，神效。<br>【用法】每服二合至三合，日二夜一。<br>说明：《普济方》一方同上。
羌活酒（四）	羌活酒（四）――（子痫）<br><br>（《太平圣惠方》）<br>【配方】羌活一两半，防风（去芦头）一两，黑豆每服一合。<br>【制法】上诸药，前二味捣粗罗为末，以好酒五升，渍一宿。<br>【主治】治妊娠中风痉，口噤，四肢强直，反张。<br>【用法】每服，用黑豆一合炒令烟出，投入药，酒一大盏，候沸住，去滓，拗开口，分两度灌之。<br>说明：《医部全录》制法为“上三味口父咀，入酒内浸一宿，每服用黑豆（炒令熟）一合，投入药酒一大盏，候沸即住，去渣，分二服，灌之”。余同上。
羌活酒（一）	羌活酒（一）――（产后腹痛）<br><br>（《普济方》）<br>【配方】羌活（切）四两。<br>【制法】以酒二升，煮取一升。<br>【主治】疗产后腹痛不止。<br>【用法】分服。
茄子酒方	茄子酒方――（肠风）<br>（《圣济总录》）<br>【配方】茄子种（大者）三枚。<br>【制法】上一味，乘将一枚湿纸裹，于痘鹉冢煨熟取出，入瓷罐子，乘热以无灰酒一升半沃之，便以蜡纸封闭，经三宿去茄子。<br>【主治】治久患肠风泻血。<br>【用法】暖酒空心分服，如是更作，不过三度差。
秦艽桂苓酒	秦艽桂苓酒――（痹证）<br>（验方）<br>【配方】秦艽、牛膝、川芎、防风、肉桂、独活、茯苓各30克，杜仲、丹参各60克，制附子、石斛炮姜、麦冬（去心）、地骨皮各35克，五加皮60克，薏苡仁30克，大麻仁（炒）15克，酒2公斤。<br>【制法】将上药碎细，用酒浸于净瓶中，春秋7日，夏3日，冬10日即可，去渣备用。<br>【主治】腰膝虚冷，久坐湿地，风湿痹痛。<br>【用法】每日空腹温饮1-2杯，每日3次。
秦艽酒（二）	秦艽酒（二）――（痿证）<br>（《普济方》）<br>【配方】秦艽、天门冬、五加皮、牛膝、附子、桂心各三两，巴戟天，杜仲、石南、细辛各二两，独活五两，薏苡仁一两。<br>【制法】上为口父咀，每服二两，酒一碗，浸一宿，滤去滓。<br>【主治】四肢风，手臂不收，髀脚疼弱，或有拘急挛缩，屈指偏枯，痿不仁，顽痹者悉主之。<br>【用法】分为二服，不拘时候，温热服之。
秦艽酒（三）	秦艽酒（三）――（腹胀腹痛）<br>（《圣济总录》<br>【配方】秦艽、牛膝、川芎、防风、桂仲、亦苓、丹参、独活、地骨皮、薏苡仁、大麻仁各30克，肉桂25克，石斛、干姜各20克，五加皮50克，制附子24克，麦冬25克，酒1.5公斤。<br>【制法】将上药碎细，夏白布袋盛，用酒浸于净瓶中，春夏5日，秋冬7日开封。<br>【主治】小腹胀满，疼痛拒按，小便艰涩不利，大便不通，鼻流清涕。<br>【用法】每日空腹温饮10-20毫升，以愈为度。
秦艽酒（一）	秦艽酒（一）――（痿证）<br>（《备急千金要方》）<br>【配方】秦艽、牛膝、附子、桂心、五加皮、天门冬各三两，巴戟天、杜仲、石南、细辛各二两，独活五两，薏苡仁一两。<br>【制法】上十二味口父咀，以酒二斗渍之得气味。<br>【主治】四肢风，手臂不收，髀脚疼弱，或有拘急，挛缩屈指，偏枯痿，h小不仁顽痹者悉主之。<br>【用法】服三合，渐加至五六合，日三夜一服。
秦艽酒方（二）	秦艽酒方（二）――（疟疾）<br>（《圣济总录》）<br>【配方】秦艽（去苗土）、柴胡（去苗）、甘草（炙）、鳖甲（去裙醋炙）各半两，常山、葱白各二两，豉一分。<br>【制法】上七味，如麻豆，用无灰酒三升浸一宿，于近火处安顿，常令微温。<br>【主治】治劳疟。<br>【用法】每服一盏，未发时，不拘时服。既服又添酒一盏于药中，添至三升即止。<br>说明：《普济方》一方同上。
秦艽酒方（一）	秦艽酒方（一）――（胞痹）<br>胞痹是由风寒湿邪侵犯膀胱，影响膀胱气化，以小腹胀痛，小便艰涩不利为主要表现的一种病证。它属于中医学痹证中的一种。<br>由于本病是由风寒湿邪所致，主要影响水湿运化，故治疗本病的药酒，亦以祛风散寒，活血利水为主。<br>（《圣济总录》）<br>【配方】秦艽（去苗土）、牛膝（酒浸切焙）、芎、防风（去叉）、桂（去粗皮）、独活（去芦头）、丹参、赤茯苓（去黑皮）各二两，杜仲（去粗皮v炒炮）侧子（炮裂去皮脐）、石斛（去根）、干姜、麦门冬（去心焙）、地骨皮各一两半，五加皮五两，薏苡仁一两，大麻子（仁炒）一合。<br>【制法】上一十七味，细v如麻豆，以生绢夹囊盛之，用酒一斗，浸七日。<br>【主治】胞痹。<br>【用法】每日空腹温服半盏，日再。
青蒿酒	青蒿酒――（疟疾）<br>（《本草纲目》）<br>【配方】嫩鲜青蒿适量，米适量。<br>【制法】将上药捣汁煎过，和曲同酿，酒成即可。<br>【主治】疟疾寒热。<br>【用法】病发前饮用。
青蒿醪	青蒿醪――（疟疾）<br>（验方）<br>【配方】鲜青蒿1000克，糯米500克。<br>【制法】鲜青蒿洗净，捣汁（或以干品200克煎汤去渣），再将药汁与糯米共同烧煮，做成糯米干饭，待冷，加酒曲适量，拌匀，发酵成为酒酿。每日适量佐餐食用。<br>【主治】本方出自《本草纲目》，称其可治疗疟疾。<br>【用法】目前作为夏季的清凉食品，能解暑，辟秽。
青梅煮酒	青梅煮酒――（虫证）<br>虫证是指寄生于人体的各种虫类所引起的病证，本节介绍的两个药酒方，用以治疗蛔虫所致的“虫心痛”、“虫积腹痛”。<br>（验方）<br>【配方】青梅30克（无青梅可用食品店出售的糖渍青丝代替，用量酌增）黄酒100毫升。<br>【制法】用青梅和黄酒用放瓷杯中，再将瓷杯放在有水的蒸锅中加热蒸炖20分钟。<br>【主治】食欲不振，蛔虫性腹痛，以及慢性消化不良性泄泻者饮用甚益。<br>【用法】每次温饮30毫升。
青松叶浸酒方	青松叶浸酒方――（口眼?斜）<br>（《圣济总录》）<br>【配方】青松叶（细v如大豆）一斤。<br>【制法】上一味，木石臼中，捣令汁出，用生绢囊贮，以清酒一斗浸二宿，近火煨一宿。<br>【主治】治中风口面?斜。<br>【用法】初服半升，渐加至一升，头面汗出即止。
清宫焕春酒	清宫焕春酒――（阳萎）<br>（中国中医研究院西苑医院）<br>【配方】巴戟天、枸杞子、肉苁蓉及人参等。<br>【制法】本酒是根据清代宫廷秘方，用传统工艺方法精制而成，属低度酒。<br>【主治】身体虚弱，神疲健忘，腰膝软，阳萎，遗精，性功能减退等诸肿虚损之症。<br>【用法】午饭、晚饭后饮用，每次20毫升，或作佐餐用。<br>说明：常饮此酒精神焕发，强身益寿。
曲末酒	曲末酒――（下痢泄泻）<br>（《普济方》）<br>【配方】曲末。<br>【制法】用好曲末五升，微熬令香，温情醇酒令至熟，和曲末一升。<br>【主治】治久冷痢不纯白者，由积卧冷处，经久病发，遂令脾胃俱冷，日夜五六十行，大小腹痛不可忍，凡白痢属冷，赤痢属热。<br>【用法】空腹顿服之，日三服，若至食时，捣蒜一升令至熟，下姜、椒末调和如常食之法，惟须稠，勿加盐，以水和面二升作淳饼，极烂煮之，干漉，热内蒸蒜，臼中相和，一顿食之，少与余食，至饥时仍准前食曲末酒，比至瘥来，少食余食，以此法治，不过两日，无有不瘥。
祛寒通络药酒	祛寒通络药酒――（血栓闭塞性脉管炎）<br>（《张八卦外科新编》）<br>【配方】熟附子45克，细辛15克，红花、丹参各60克，土元、苏木、川芎各30克，大枣20枚，白酒1500克。<br>【制法】将上药浸于酒中，1周后即可使用。<br>【主治】适用于寒湿、血瘀所致的脉管炎，表现为患肢肢端疼痛，苍白或紫暗，触之发凉，受寒加剧。<br>【用法】每次30克，每天2次。<br>说明：未发生溃疡者方可使用该酒。
全蝎酒	全蝎酒――（口眼?斜）<br>（《杨氏家藏方》）<br>【配方】白附子、僵蚕、全蝎各30克，醇酒0.25公斤。<br>【制法】将上药碎细，用酒浸于瓶中，三宿后即可开取饮用。<br>【主治】中风，口眼歪斜，口目p动。<br>【用法】每次饮10毫升，不拘时候，常令有酒气。
逡巡酒	逡巡酒――（悦色驻颜）<br>（验方）<br>【配方】3月3日收桃花106克，5月5日收马兰花175克，6月6日收芝麻花211克，9月9日收黄菊花317克，12月8日取腊水10升，春分日取桃仁49枚（去皮尖），白面5000克，曲适量。<br>【制法】骨前花和作曲，纸包49日。<br>【主治】一切风痹湿气，久服益寿延年，美容。<br>【用法】用时，白水1瓶，曲1丸，面1块，如嫌味淡，可加服1丸。<br>说明：本方原于《本草纲目》，其卷二十五附诸药酒条云：“补虚益气，去一切风痹湿气。久服益寿耐老，好颜色。造法：三月三日收桃花三两三钱，五月五日收马蔺花五两五钱，六月六日收脂麻花六两六钱，九月九日收黄甘菊花九两九钱，阴干，十二月八日取腊水三斗，待春分，取桃仁四十九枚好者，去皮尖，白面十斤正，同前花和作曲，纸包四十九日，同时，白水一瓶，曲一丸，面一块，封良久成矣，如淡，再加一丸。<br>
蚺蛇酒	蚺蛇酒――（痹证）<br>（验方）<br>【配方】蚺蛇1条，羌活30克，曲适量。<br>【制法】将上药共捣碎，袋盛，同曲置于缸底，糯饭酌量盖之，10日酒酿成。亦可用酒1公斤浸上药。<br>【主治】诸风痛痹，瘴气，癞气，疥癣，恶疮。<br>【用法】徐徐饮之，不拘时候。<br>说明：本方源于《本草纲目》，其卷二十五附诸药酒条下云：“治诸风痛痹，东虫辟瘴，治癞风疥癣恶疮。用蚺蛇肉一斤，羌活一两，袋盛，用曲置于缸底，糯饭盖之，酿成酒饮，亦可浸酒。”
人参枸杞子酒	人参枸杞子酒<br>【来源】民间方<br>【原料】人参20克枸杞子350克熟地100克冰糖400克白酒10公斤<br>【制作】将人参烘烤切片，枸杞除去杂质，用纱布袋装上扎口备用。冰糖放入锅中，用适量水加热溶化至沸，炼至色黄时，趁热用纱布过滤去渣备用。白酒装入酒坛内，将装有人参、枸杞的布袋放入酒中，加盖密封浸泡10-15天，每日搅拌1次，泡至药味尽淡，取出药袋，用细布滤除沉淀物，加入冰糖搅匀，再静置过滤，澄明即成。<br>【功效】强壮抗老，补阴血，乌须发，壮腰膝，强视力，活血通经。适用于病后体虚及贫血、营养不良、神经衰弱、糖尿病等患者饮用。无病常饮，亦有强身益寿之功。<br>【用法】饮用时，可根据自己的酒量，每次饮10-12克。
人参固本酒	人参固本酒<br>【来源】《录竹堂集验方》<br>【原料】人参、枸杞、天门冬、生地、熟地各60克，当归、麦冬、何首乌各60克，茯苓30克，白酒5千克。<br>【制作】诸药细锉，纱袋盛，入酒坛浸泡，密封，下用桑枝文火煨半小时，熄火后置阴凉处，7日后取用。<br>【功效】补益气血，调经助孕。妇女气血亏虚，头晕腰酸，月经不调，白带日久，体弱不孕；男子身体羸弱，气血亏虚，腰酸腿软，久不生育等症。<br>【用法】每次30毫升，早、晚钣后各1次。<br>【宜忌】<br>【注释】本酒偏重于滋肾补血，对于体虚者尤宜，方中人参补元气；生地、熟地、当归补血养血，据《本草纲目》记载：“熟地填骨髓，长肌肉，生精血，补五脏内伤不足”；何首乌滋肾补血；麦冬、天门冬、枸杞滋阴润肺，养肝明目；茯苓健脾安神。全方能使人身强力盛，健身长寿。
人参酒	人参酒<br>【来源】经验方<br>【原料】人参30克，白酒500克。<br>【制作】将人参切成段或薄片，浸入优质白酒中，加盖密封，置于阴闵处，每日振摇1次，浸泡7天后饮用。<br>【功效】大补元气，补脾益沛，生津固脱，安神益智。适用于久病气虚，脾肺不足，食欲不振，动则气喘，自汗乏力，面色黄白少华，或脉虚，津伤口渴、消渴，神经衰弱，失眠多梦，疲倦心悸，健忘，阳痿等患者服用。<br>【用法】每日早、晚各1次，每次服10-10毫升。<br>【注意事项】服用期间，不宜喝茶，忌食萝卜,反藜芦，阳盛者忌服。
人参酒方	人参酒方――（筋骨诸病）<br>（《备急千金要方》）<br>【配方】人参、防风、茯苓、细辛、秦椒、黄芪、当归、牛膝、桔梗各一两半，干地黄、丹参、薯蓣、钟乳、矾石各三两，山茱萸、芎各二两，白术、麻黄各二两半。大枣三十枚，五加皮一升，生姜（切，炒干）、乌麻（碎）各二升。一本无乌麻用杜仲二两半。<br>【制法】上二十二味口父咀，钟乳别以小袋子盛，以清酒二斗半浸五宿。<br>【主治】筋虚极，则筋不能转，十指爪皆痛，数转筋，或交接过度，或病未平复交接，伤气内筋绝，舌卷唇青，引卵缩疼急，腹中绞痛，或便欲绝不能饮食。<br>【用法】温服三合，日再，无所闻，随意增进。<br>说明：《医部全录》干地黄、丹参、薯蓣，钟乳、矾石各用二两，余同上。
人头七酒	人头七酒――（失眠）<br>（《陕甘宁青中草药选》）<br>【配方】人头七（即人参果）1两，白酒1斤。<br>【制法】浸泡10-15日后服用。<br>【主治】神经衰弱，头昏，失眠，肾虚所致的须发早白，不思饮食，烦躁不渴，月经不调。<br>【用法】每服10-20毫升，日服2日。
忍冬酒（二）	忍冬酒（二）――（痈疽、疮疡、发背）<br>（《普济方》）<br>【配方】忍冬藤（生取，以叶一把入砂盆内，烂研入饼子，酒少许，生酒尤佳，调和稀稠得所，涂敷四周，中心大留一口，泄其毒气；其藤用木棰微微捶，不可儿犯铁器）五两，大甘草节（生v）一两。<br>【制法】上入砂瓶内，以水二斛，用文武火慢慢煎至一斛，入无灰好酒一大斛，再煎十数沸去滓。<br>【主治】治痈疽发背，初发时便当服此。不问疽发何处，发眉发头，或头或项，或背或腰或胁，或妇人乳痈，或在手足，服此效。<br>【用法】上分为三次温服，一日一夜连进吃尽；如病势重，一日一夜要两剂服，至大小肠通利，则药力到。外仍兼以麦饭石膏及神异膏涂敷妙。<br>沈内翰云：如无生者（指忍冬藤）只用千者，但不及生者力大而效速。又木莲子叶四十九片，揩去毛研细，酒解温服，功与忍冬草不相上下。又龙鳞薛荔而青，故又名左缠藤，二月开花，五出微香，蒂红色，花初开则色白，经一二日则色黄，故又名金银花，又名鹭鹭藤，又名金钗股，又名老翁。善治痈疽发背，尤胜红内消，又大治五种飞尸，以滓傅肿毒。
忍冬酒（三）	忍冬酒（三）――（产后虚损）<br><br>（《医部全录》）<br>【配方】忍冬藤生取一把，以叶入砂盆研烂，入酒少许，调和得所，涂敷四周，中心留一口，又取二两用木槌捣碎，不犯铁器；甘草生v一两。<br>【制法】将上二味，入砂瓶内，用水二碗，文武火煎至一碗，入好酒一大碗，煎十数沸，去渣，分为三服。<br>【主治】病后产后体虚，气短乏力，老年人用之皆宜。<br>【用法】三服一日连夜进尽，病势重，一日夜可进二剂。
忍冬酒（一）	忍冬酒（一）――（痈疽、疮疡、发背）<br>（《三因极一病证方论》）<br>【配方】忍冬草（取嫩苗）一握，甘草（炙v）八钱。<br>【制法】上同研，入酒一升半，砂瓶塞口煮，去滓。<br>【主治】治痈疽肿毒，甚效。<br>【用法】温服，仍以滓敷肿毒上。
忍冬酒附方（二）	忍冬酒附方（二）――（痈疽、疮疡、发背）<br>（《三因极一病证方论》）<br>【配方】龙鳞薛荔一握。<br>【制法】上件细研，以酒解汁。<br>【主治】治痈疽肿毒，亦能泻下恶物，去其根本。<br>【用法】温服。
忍冬酒附方（一）	忍冬酒附方（一）――（痈疽、疮疡、发背）<br>（《三因极一病证方论》）<br>【配方】木莲叶四十九片。<br>【制法】上件楷去毛，研细，酒解。<br>【主治】功与忍冬草不相上下，治痈疽肿毒。<br>【用法】温服。
忍冬藤酒	忍冬藤酒――（关节疼痛）<br>（《陕甘宁青中草药选》）<br>【配方】忍冬藤、乌梅、川乌、甘草、大青盐各2钱，白酒1斤。<br>【制法】浸泡21天，取酒饮服。<br>【主治】风湿性关节炎。<br>【用法】每次取5毫升，日服3次。
肉桂酒	肉桂酒――（感冒）<br>（《费氏食养三种》<br>【配方】肉桂末二钱<br>【制法】温酒调。<br>【主治】治感寒身疼痛<br>【用法】温服之。<br>腹痛泄泻，俗以生姜捣酒饮，俱好，如打扑伤坠，瘀血疼痛，用桂枝（《食鉴本草》）
如意酒	如意酒――（痈疽、疮疡、发背）<br>（《潘佩侯方》）<br>【配方】如意草（新鲜肥大者）50克，酒70毫升。<br>【制法】将如意草捣烂，滚酒冲入，少顷挤汁。<br>【主治】痛疽，疮毒。<br>【用法】取汁温服，渣敷肿处，用纱布盖。<br>说明：如意草为牛蒡草。
三角枫酒	三角枫酒――（跌打损伤）<br>（《陕甘宁青中草药选》）<br>【配方】三角枫2两，白酒半斤。<br>【制法】浸泡7-10天后服用。<br>【主治】骨折，跌打损伤，外伤出血。<br>【用法】每服10-20毫升，日服3次。
三仁酒	三仁酒――（湿温）<br>湿温是因外感湿热邪气或脾虚湿停，又感外邪，内外相引而引起的外感热病。其病机主要为湿邪浊热阻滞气机，郁遏清阳。临床有偏于湿者，有偏于热者。酒能宣通阳气。散除湿气，故用健脾燥湿、渗湿利湿，清热化湿药物制成的药酒，可用于治疗湿温，但以治疗偏于湿者为佳。<br>（《温病条辨》）<br>【配方】杏仁、滑石（另包）各50克，白通草、竹叶、厚朴各30克，生薏苡50克，半夏30克，白蔻仁20克，江米酒1.5公斤。<br>【制法】将上药共捣碎细，用酒浸于净瓶中，7宿后开封，去渣备用。<br>【主治】湿温初起，暑热挟湿，头痛身重，脑闷，食欲不振。<br>【用法】每次饮20毫升，每日3次。<br>说明：避风，孕妇忌服。
三蛇酒	三蛇酒――（痹证）<br>（《中国药膳学》）<br>【配方】乌稍蛇1500克，大白花蛇200克，脆蛇100克，生地黄500克，冰糖5000克，白酒100公斤。<br>【制法】将三种蛇去头，用酒洗润切成短节干燥，生地洗净切碎备用；冰糖置锅中，加入适量的水置火上加热溶化，待糖汁至黄色时，趁热用一层纱布过滤去渣备用；将白酒装入坛内，三蛇、生地放入酒中，加盖密封，每天搅拌一次。10-15天开坛过滤，加入冰糖汁充分拌匀，再过滤1次即可服用。<br>【主治】风寒湿痹之筋骨疼痛，肢体麻木，屈伸不利，半身不遂，跌打损伤之瘀肿，疼痛及风寒入络之抽搐，惊厥等症，亦适用于骨结核，中风后遗症患者。<br>【用法】每服10-20毫升，日服2-3次。<br>说明：可按原方比例缩小10倍或20倍制做
三味地黄酒	三味地黄酒<br>【来源】《山居备用》<br>【原料】生地黄（切）100克，大豆（炒）200克，牛蒡根（切）100克，酒2升。<br>【制作】将药用白纱布袋盛之，置于净器中，入酒浸泡，密封，5日后开启，过滤后装瓶备用。<br>【功效】补肾除烦，祛风止痛。适应症肾虚，心烦，关节疼痛。<br>【用法】不拘时，随量饮之。每日1-2次，每次饮服1-2小盅。<br>【注释】方中生地黄性味甘、苦、寒，功能清热凉血，养阴生津，用于热入营血、血热妄行、热病伤阴及消渴心烦等症。王好古言其用说：“主心病，掌中热痛，痹气痿厥，嗜卧，足下热而痛”。《本草经百种灵》云其功效说：“地黄，专于补血，血补则阴气得和而无枯燥拘牵之疾矣”。大豆性味甘，平，有活血，利水，祛风，解毒之功，治水肿胀满，风毒脚气，黄疸浮肿，风痹筋挛，产后风痉、口噤，痈肿疮毒；解药毒。牛膝根性味苦寒，有祛风热、消肿毒之功，治风毒面肿，头晕，咽喉热肿，齿痛，咳嗽，消渴，痈疽疮疥。三味相伍补肾除烦，祛风止痛，虚烦可医，骨痛可止。生地滋肾清心，以水济火，则烦可除；大豆去风散热，是以风痹烦渴可用；牛蒡根祛风热，亦可治风痹烦渴。酒浸为饮，其效益佳。
三味牛膝酒方	三味牛膝酒方――（脚气）<br>（验方）<br>【配方】生牛膝、生地黄（净洗控干切暴两日）、虎骨各6克。<br>【制法】上二味和捣如泥作团，以纸裹，外更以黄泥固济，微火炙，勿令泥有裂处，待干即于地炉中灰火养半日，次日炭火渐渐烧之，加至火三斤，烧一复时，取出候冷，去泥纸，捣罗为散。<br>【主治】治脚气极冷，著厚棉衣盖复不觉暖者。<br>【用法】每服五钱匕，酒一盏半，以瓷器煎至七分，和滓食前顿服，老小以意加减。
三香酒	三香酒――（疝气）<br>（秘方）<br>【配方】南木香、小茴香、八角茴香、川楝肉各三钱。<br>【制法】上药为一服，同入锅入炒，入葱白（连须）五根，水一碗，淬入锅，将碗罩住，候煎至半碗，取出去渣，加陈酒半碗，合和入炒盐一茶匙。<br>【主治】偏坠气。<br>【用法】空心热服，神效。
桑根白皮酒	桑根白皮酒――（哮喘）<br>（验方）<br>【配方】桑白皮250克，吴萸根皮150克，黄酒1.5公斤。<br>【制法】将上药细切，用酒煮至500克，去渣，收贮备用。<br>【主治】肺热咳喘，痰多而黄，身热口渴，甚者吐血。<br>【用法】上药酒分作3服，每日空腹时饮1服。
桑菊酒	桑菊酒――（风温）<br>风温是由风热之邪引起的一种以肺系病变为中心的外感热病。临床以起病急骤，传变迅速、发热、恶寒、口渴、咳嗽为主要表现，根据其病程，有邪在卫、气、营、血等不同。<br>以药酒治疗本病者，一般是邪在卫分时用，常用桑叶、菊花、薄荷、连翘等辛凉解表药配制，如桑菊酒。<br>（验方）<br>【配方】桑叶、菊花各30克，薄荷10克，连翘30克，芦根35克，杏仁30克，桔梗20克，甘草10克，江米酒1公斤。<br>【制法】将上药捣细，用酒浸于瓶中，封口，5宿开取饮用。<br>【主治】风温初起，邪客上焦，发热不重，微恶风寒，咳嗽鼻塞较重，口微渴。<br>【用法】每次15毫升，每日早、晚各1次。
桑椹酒（二）	桑椹酒（二）――（眩晕）<br>（《中国医学大辞典》）<br>【配方】桑椹1公斤，曲200克，糯米5公斤。<br>【制法】将桑椹捣汁，煎过，同曲、米如常法酿酒。<br>【主治】眩晕，失眠，耳鸣目暗，须发早白，便秘消渴。<br>【用法】徐徐饮之，不拘时候。<br>说明：脾胃虚寒作泻者忌用。
桑椹酒（四）	桑椹酒（四）――（水肿臌胀）<br>（《本草纲目》）<br>【配方】桑椹（捣汁煎过）。<br>【制法】上味同曲、米如常酿酒。<br>【主治】补五脏，明耳目，治水肿，不下则满，下之则虚，入腹则十无一活。<br>【用法】饮用。<br>说明：本方见《本草纲目》卷二十五附诸药酒条下。
桑椹酒（一）	桑椹酒（一）――（水肿臌胀）<br>（《普济本事方》）<br>【配方】桑心皮（即桑白皮），桑椹，糯饭五升。<br>【制法】将桑心皮切，以水二斗，煮汁一斗，入桑椹再煮，取五升，以糯饭酿酒。<br>【主治】肝肾不足、水热交阻的浮肿。这种浮肿病兼有头弦耳鸣，小便不利等症。<br>【用法】适量饮用。
桑椹醪（一）	桑椹醪（一）――（瘰疠）<br>（《偏方大全》）<br>【配方】鲜桑椹1000克，糯米500克，酒曲适量。<br>【制法】先将桑椹洗净，捣烂，以纱布绞汁，将汁与糯米按常法煮焖成干饭，待凉，加入酒曲，拌匀，发酵成酒酿。<br>【主治】瘰疬，关节不利，便秘等症。<br>【用法】每日随量佐餐食用。
桑枝浸酒方	桑枝浸酒方――（风疾诸病）<br>（《太平圣惠方》）<br>【配方】花桑枝、垂柳枝、槐枝各一斤，羌活、牛膝（去苗）、附子（炮裂去皮脐）、桂心、熟干地黄各三两，黑豆（炒熟）一升。<br>【制法】上件药细v和匀，以生绢袋盛，用好酒五斗，经浸七日后饮用。<br>【主治】治风疾。<br>【用法】每日食前后，任性饮一二小盏，不得令过度，但醺醺然，长有酒气为妙。忌生冷毒鱼猪肉。<br>说明：《普济方》同上。
山峰酒	山峰酒――（牙痛）<br>牙痛又名“齿痛”。其主要原因有阳明伏火与风热之邪相搏，风火上炎所致的牙痛，其特点为患牙得凉痛减；有因于风寒之邪客于牙齿致痛者，其特点为患齿得热痛减；有因肝肾两亏、虚火上炎所致者，其特点牙齿浮动隐痛。此外因蛀牙作痛者亦极为常见。以下介绍三种治牙痛药酒，供对证选用。<br>（《普济方》）<br>【配方】蜂窝大如斗者。<br>【制法】上烧灰存性，麝香少许，用煮酒调，以绵纸覆盖，勿令药气漏。<br>【主治】治牙疼。<br>【用法】酒灌漱，冷时吐了，再呷温者含口中，不可咽了。<br>说明：《普济方》注出“海上方”。
山药酒（二）	山药酒（二）――（小便频数）<br>（《寿亲养老新书》）<br>【配方】生薯药半斤。<br>【制法】上药刮去皮，以刀切碎，研令细烂。于铃中著酒，酒沸下薯，不得搅，待熟著盐、葱白，更添酒。<br>【主治】治下焦虚冷，小便数，瘦损无力。
山楂酒	山楂酒――（痛经）<br><br>（验方）<br>【配方】干山楂片一斤，60度白酒300毫升。<br>【制法】把干山楂片洗净、去核，放入一斤装的细口瓶内约半瓶，再添加白酒至瓶满，密封瓶口，每日振摇一次，一周后可饮用。<br>【主治】活血、舒筋，可治劳动过力身痛疲倦和妇女痛经等症。<br>【用法】每次10-20毫升，边用边添加白酒（约200毫升）。
山瘴疟酒	山瘴疟酒――（疟疾）<br>（《普济方》）<br>【配方】常山三两，鳖甲（炙）、升麻、乌贼鱼骨（去甲）、附子各一两。<br>【制法】上并切，绢袋盛，以酒六升渍之，少令近火，转之一宿。<br>【主治】疗乍寒乍热，乍有乍无，及劳疟发歇不定，久不瘥。<br>【用法】每服一合，比发可数服。或吐，忌猪肉、生菜、生葱、苋菜。<br>说明：①《普济方》注“出鲍氏方”。②《奇效良方》同上。
闪挫止痛酒	闪挫止痛酒――（跌打损伤）<br>（《疑难急症简方》）<br>【配方】当归6克，川芎3克，红花1.8克，茜草、威灵仙各1.5克，白酒适量。<br>【制法】将上药加适量白酒煎服。<br>【主治】闪v伤，包括皮下组织、肌肉、肌健、筋膜、关节囊、韧带（腱鞘、滑液囊、椎间盘纤维环、关节软骨盘）血管、周围神经等组织，受伤后，发生肿胀，疼痛，功能活动障碍等现象。<br>【用法】以不醉为度，其渣外用敷伤处。<br>说明：有明显出血现象者，不宜使用此酒。
商陆酒（二）	商陆酒（二）――（水肿臌胀）<br>（《普济方》）<br>【配方】商陆根。<br>【制法】用商陆根一斤，薄切，以醇酒二斗渍三宿。<br>【主治】风水肿，　癖，酒癖。<br>【用法】服一升，量小者服半斤，日三服。
商陆酒（三）	商陆酒（三）――（水肿臌胀）<br>（《普济方》）<br>【配方】商陆（切）一升。<br>【制法】上以酒三升，渍三宿。<br>【主治】治卒肿身面皆洪大者。凡此满或是虚气，或是水饮气化，此方皆治之。<br>【用法】服五合至一升，日三服之。<br>说明：《普济方》注“出肘后方”。方名为笔者所加。
商陆酒（一）	商陆酒（一）――（癞病）<br>（《普济方》）<br>【配方】曲二十五斤，商陆根二十五斤（马耳切之）。<br>【制法】上合于瓮中，水一斛渍之，炊黍米一石，酿如家法，使曲米相淹，三毕，密封三七日开，视曲浮酒熟，澄清。<br>【主治】大风眉须落，赤白癞病，八风十二痹，筋急肢节缓弱，飞尸遁注，水肿痈疽，疥癣恶疮，脚挛手折，眼暗洞泄，痰饮宿癖寒冷方。<br>【用法】温服三升，轻者二升，药发吐下为佳，宜食粥饮、牛、羊、鹿肉羹，禁生冷、醋滑及猪、犬、鸡、鱼等物。<br>说明：《普济方》注出《备急千金要方》）。
商陆酒方	商陆酒方――（灭瘢痕）<br>（《太平圣惠方》）<br>【配方】商陆末（白色者）、天门冬末各五斤，细曲（捣碎）十斤，秫米（净淘）一硕。<br>【制法】上先炊米熟，放如人体温温，别煎熟水一硕，放冷，都拌和令匀，入不津瓮中密封，酿六十日成，去滓。<br>【主治】灭瘢痕。<br>【用法】随性饮之，五日食减，廿日腹满绝谷，不腹用食，尸虫并去，瘢痕皆天。<br>说明：注“此方出五符中，忌大肉”。
商陆酿酒方	商陆酿酒方――（癞病）<br>（《太平圣惠方》）<br>【配方】商陆（切）二十五斤，曲（捣碎）十五斤。<br>【制法】上诸药，以水二，拌渍炊黍米一硕，酿如常法，三酝讫，封七日开看酒熟澄清。<br>【主治】治大风，眉鬓堕落，皮肉顽痹，筋脉不利。<br>【用法】随性温服之，病重者服至三，轻者二　、药发得吐下佳，宜吃鹿肉羹　。<br>说明：《圣济总录》同上。
烧盐酒	烧盐酒――（产后腹痛）<br><br>（《永乐大典》）<br>【配方】白盐。<br>【制法】新布数重包裹白盐一合，炭火烧存性。<br>【主治】血闭腹痛，产后瘀血腹痛。<br>【用法】上研细温酒调下（新布即青麻也能逐瘀血）。<br>说明：《永乐大典》注出《大全良方》，《普济方》注出《直指方》，内容同上。
芍药黄芪酒	芍药黄芪酒――（月经过多）<br><br>经量超过正常，或经来日子延长，超过七天以上而经血过多，但仍不失一月一次的周期性，概称“月经过多”。本症主要是因血热、冲任受损或气虚不摄血等因素所致。经血深红，质稠浓或有秽臭者，多因血热；月经绵延不断，经色暗淡而质稍薄者，为冲任受损所致；经色淡，量多而伴有气弱懒言、面色淡白者，为气虚所致。以下介绍两种治疗本症的药酒。芍药黄芪酒可用于气虚、冲任受损引起的月经过多；地榆酒可用于血热所致的月经过多。<br>（验方）<br>【配方】白芍药、黄芪、生地黄各100克，艾叶（炒）30克，酒1公斤。<br>【制法】将上药粗捣碎，如麻豆大，以夏白布袋盛，酒浸于净器中，封口，经宿可用。<br>【主治】妇女月经过多，兼赤白带下。<br>【用法】每食前随量温饮。
芍药浸酒方	芍药浸酒方――（赤白带下）<br><br>赤白带下是指从妇女阴道流出赤白夹杂的粘液，连绵不断的病证。多因肝郁犯脾，湿热下注冲任、带脉所致。以下收载治疗本病的药酒配方，主要是治妇人血伤兼赤白带下，故入酒药物以益气养血为主。<br>（《圣济总录》）<br>【配方】芍药、黄芪、生地黄各三两，艾叶一两。<br>【制法】上四味，口父咀如麻豆大，以绢袋盛，浸酒一斗经宿后用之。<br>【主治】治妇人血伤兼赤白带下。<br>【用法】每食前随量温饮之。
芍药酒	芍药酒――（关节疼痛）<br>（验方）<br>【配方】赤芍药180克，生地100克，虎骨（酒浸炙）35克，酒1公斤。<br>【制法】将上药碎细，用酒浸于净器中，7宿后即可开取饮用。<br>【主治】骨节酸痛，足痿无力。<br>【用法】每次空心饮15毫升，每日3次。
芍药酒方	芍药酒方――（风疾诸病）<br>（《普济方》）<br>【配方】芍药二分，虎骨一两（炙）。<br>【制法】上为细末，夹绢袋盛，酒三升，渍五日。<br>【主治】风毒，骨髓疼痛。<br>【用法】每服二合，日三服。<br>说明：《普济方》注一名虎骨酒，出《十便良方》。
身直不得屈伸者又方	身直不得屈伸者又方――（痹证）<br>（《肘急备急方》）<br>【配方】枳树皮一升。<br>【制法】刮枳树皮取一升，以酒一升渍一宿。<br>【主治】身直不得屈伸反复者。<br>【用法】服五合至一升，酒尽更作。
神曲酒（二）	神曲酒（二）――（跌打损伤）<br>（《奇效良方》）<br>【配方】陈久神曲一大块，老酒适量。<br>【制法】将神曲烧通红，淬老酒，去神曲。<br>【主治】挫闪腰痛，不能转侧。<br>【用法】通口吞青蛾丸两服顿愈，一方不用青蛾丸，只服酒后，仰卧片时，未效再服。
神效酒	神效酒――（痈疽、疮疡、发背）<br>（《景岳全书》）<br>【配方】人参、没药（别研）、当归尾各30克，甘草15克，栝蒌（全者半生半炒）1枚，黄酒3碗。<br>【制法】将上药用酒煎取2碗，分4份。<br>【主治】疮痈。<br>【用法】细细饮之，每日服1份。
神验酒煎散	神验酒煎散――（痈疽、疮疡、发背）<br>（《普济方》）<br>【配方】人参、没药、当归各一两、甘草（炙）一分，栝蒌（半生半炒）一钱。<br>【制法】上口父咀，以酒五升，煮至二升，净瓷瓶贮之；或以上药浸酒；或将药滓焙干，加当归为末，酒煮面糊，丸如梧桐子大。<br>【主治】治痈疽发背诸疖毒，定痛，顺气活血。<br>【用法】每服半盏；或浸酒半盏温服，无时候，或每服五十丸，用浸药酒吞下。
神应酒方	神应酒方――（癞病）<br>（《圣济总录》）<br>【配方】茵芋（炙）、附子、天雄（并生用去皮脐）、丹参、蜀椒（去目并闭口炒出汗）、踯躅花、甘草（炙）、石菖蒲、桂（去粗皮）、干姜（生用）、乌头（生用去皮脐）、独活（去芦头）、地骨皮、秦艽<br>（去苗土）、防风（去叉）、芎　人参、当归、白芷、藁本（去苗土）、生干地黄各二两，白鲜皮、栾荆（炙）各二两。<br>【制法】上二十三味，并细v，以无灰酒二斗，密器中浸。经七日成。<br>【主治】治大风疾及诸风疾。<br>【用法】每日空腹饮半盏，渐渐加饮。每饮了，以饭三两匙压之，每饮一盏，即添一盏浸药，药味尽即止。忌热肉面鸡鱼牛肉油腻果子陈臭豉汁等物。<br>说明：《普济方》同上。
生菖蒲酒	生菖蒲酒――（白癜风）<br>（《外台秘要》）<br>【配方】陆地菖蒲（细切，别煮）一石天门冬（去心），苦参各一斤，天雄（去皮生用）、茵芋、干漆、干地黄、远志（去心）各三两，麻子仁、大蓼子各一升，露蜂房、独活、石斛各五两，黄芪半斤，柏子仁二升，蛇皮长三尺。<br>【制法】上十六味口父咀之，以绢囊盛著，先以水二斛五斗煮菖蒲根，取八斗，以酿一斛五斗米许，用七月七日造，冬月酒成，漉糟停药，著器中下消减。<br>【主治】疗举体苦白驳，经年不差，此风虚。又令人延年益寿，耳目聪明，气力兼备。<br>【用法】服一剂不觉，更作尤妙，当以差为期，更重煮菖蒲，去滓取汁，以渍洗悉益佳，禁食羊肉鲤鱼肉芜荑鸡犬生冷。
生地黄酒	生地黄酒――（脚气）<br>（《普济方》）<br>【配方】生地黄（干）一斤，杉木节五两，牛蒡子（去皮）一斤，丹参二两，牛膝（去苗）五两，大麻仁半斤，防风（去叉）三两，独活、地骨皮各三两。<br>【制法】上v，用生绢袋盛，以酒三斗浸六七日。<br>【主治】治脚气肿满，烦疼少力。<br>【用法】每于食前随性饮之。
生地酒	生地酒――（跌打损伤）<br>（《圣济总录》）<br>【配方】生地黄汁500毫升，酒500克，桃仁（去皮尖，另研膏）30克。<br>【制法】先将地黄汁并酒煎令沸，下桃仁膏再煎数沸，去渣，收贮备用。<br>【主治】倒仆跌损筋脉。<br>【用法】每温服1杯，不拘时候。孕妇忌服。
生枸杞子酒	生枸杞子酒――（悦色驻颜）<br>（《外台秘要》）<br>【配方】枸杞子二升。<br>【制法】上一味，以上清酒二升搦碎，更添酒浸七日，漉去滓。<br>【主治】主补虚，长肌肉，益颜色，肥健。<br>【用法】任情饮之。<br>说明：《太平圣惠方》用生枸杞子五斤，谓能去劳热。用法：饮之，初以三合为始，后即任性饮之，余同上。<br>
生鸡子酒	生鸡子酒――（心痛）<br>（《普济方》）<br>【配方】破生鸡子一枚。<br>【制法】酒和。<br>【主治】治妊娠心痛，或八九月堕树，或牛马惊伤，得心痛者。<br>【用法】服之。<br>说明：《普济方》注出《备急千金要方》。
生姜酒（一）	生姜酒（一）――（疥癣病）<br>（《陕甘宁青中草药选》）<br>【配方】生姜1斤，白酒（60度）8两。<br>【制法】将生姜捣烂，浸入酒内48小时后，将患指（趾）浸泡30-60分钟取出，局部涂甘油。<br>【主治】鹅掌风，甲癣。<br>【用法】每日早晚各1次。
生姜酒方	生姜酒方――（霍乱）<br>（《圣济总录》）<br>【配方】生姜（切）五两。<br>【制法】上一味，用无灰酒一升，煎取八合。<br>【主治】治霍乱转筋入腹欲死。<br>【用法】顿服便瘥。<br>说明：《普济方》注出《肘后方》，亦治痢不止，余同上。
生牛蒡根酒	生牛蒡根酒――（疫毒）<br>（《太平圣惠方》）<br>【配方】生地30克，独活15克，黑豆100克，海桐皮30克，生牛蒡根100根，肉桂15克，火麻仁100克，好酒1.5公斤。<br>【制法】将上药捣碎细，用酒浸于净器中，密封口，3日后取用。<br>【主治】南方瘴气侵入人体形成的风盛热毒，心神烦闷，脚膝酸痛。<br>【用法】每饭前，随量温饮。
生牛膝酒	生牛膝酒――（产后腹痛）<br><br>（《备急千金要方》）<br>【配方】生牛膝五两。<br>【制法】以酒五升，煮取二升，去滓。若用干牛膝根，以酒渍之一宿，然后可煮。<br>【主治】产后腹中苦痛。<br>【用法】分二服。<br>说明：《普济方》同上。
十七味药酒	十七味药酒――（痹证）<br>（《柳森可用方》）<br>【配方】牛膝90克，白石英、磁石各120克，石斛、制附子各90克，萆、丹参、防风、山萸肉、黄芪、羌活、羚羊角、酸枣仁各30克，生地、肉桂、去苓各60克，杜仲45克，酒3.5公斤。<br>【制法】将上药共碎为细末，白布袋盛，悬于瓷瓶中，用酒浸之，10日后即可取用。<br>【主治】风湿痹痛，筋脉挛急，腰脚软弱无力，视听不明。<br>【用法】每次空心温饮1小杯，每日早、晚各1次，旋饮旋添酒，味薄止。
十味侧子酒方	十味侧子酒方――（脚气）<br>（《太平圣惠方》）<br>【配方】侧子（炮裂去皮脐），五加皮（炙v）、丹参、续断、牛膝（切焙）、桑根白皮（炙v）各半斤，细辛（去苗叶）、桂（去粗皮）各四两。<br>【制法】上十一味，口父咀如麻豆大，以生绢袋盛，内净瓷瓮中，用无灰酒三斗浸密封，春夏五日，秋冬七日。<br>【主治】脚气。<br>【用法】量人性空心饮之，日三。
石膏飞罗酒	石膏飞罗酒――（痹证）<br>（《笔峰杂兴》）<br>【配方】石膏三钱，飞罗面七钱。<br>【制法】上药为末，水和，煅红，冷定流酒化服。<br>【主治】因风热，筋骨疼痛。<br>【用法】滚酒化服，被盖取汗，连服三日，即除根。
石斛浸酒方（二）	石斛浸酒方（二）――（产后中风）<br><br>（《太平圣惠方》）<br>【配方】石斛（去根）二两，附子（炮裂去皮脐）、牛膝（去苗）、茵芋、桂心、芎、羌活、当归（v微炒）、熟干地黄各一两。<br>【制法】上诸药细v，用生绢袋盛，以清酒一斗，浸三日。<br>【主治】治产后中风，四肢缓弱，举体不仁者。<br>【用法】每服不计时候，暖一小盏服之。<br>说明：《普济方》一方同上。
石斛浸酒方（三）	石斛浸酒方（三）――（脚气）<br>（《太平圣惠方》）<br>【配方】石斛（去根）二两半，丹参二两半，侧子（炮裂去皮脐）二两，桂心一两半，芎一两半，干姜（炮裂）一两，五加皮二两半，独活一两半，牛膝（去苗）二两，杜仲（削去皱皮微炙令黄）一两，秦艽（去苗）二两，薏苡仁五合，山茱萸二两，陈橘皮（汤浸去白瓤焙）一两，黄芪一两半，白前一两半，茵芋二两半，当归一两半，钟乳粉四两，川椒（去目及闭口者微炒去汗）一两半。<br>【制法】上诸药都细v，以生绢袋盛，用清酒三　，于瓷瓶中渍一宿。<br>【主治】治脚气　挛及风虚肿满，不能行李。<br>【用法】每于食前，暖一小盏服。
石斛浸酒方（五）	石斛浸酒方（五）――（腰脚疼痛诸病）<br>（《太平圣惠方》）<br>【配方】石斛（去根）、牛膝（去苗）各半两，五加皮、羌活、防风（去芦头）、海桐皮、木香、桂心、芎、甘菊花、川椒（去目及闭口者）各二两，附子（炮裂去皮脐）、天麻各三两，虎胫骨（涂酥炙令微黄）五两。<br>【制法】上药细v，以生绢袋盛，用好酒三斗，以瓷瓮子盛，密封头，浸经七日后开取。<br>【主治】风冷气攻腰脚行立无力。<br>【用法】每日三度，温饮一小盏，每取却一盏，即添一盏，直候药味薄，即更换之。
石斛浸酒方（一）	石斛浸酒方（一）――（手足不遂）<br>（《太平圣惠方》）<br>【配方】石斛（去根）一两，天麻一两，芎一两，仙灵脾一两，五加皮一两，牛膝（去苗）、萆各一两，桂心一两半，当归一两，鼠黏子一两，杜仲（去粗皮）一两，附子（炮裂去皮脐）一两半，虎胫骨（涂酥炙令黄）二两，乌蛇肉（微炒）一两，茵芋一两，狗脊一两，丹参一两，川椒（去目及闭口者微炒去汗）一两半。<br>【制法】上诸药，细v，以生绢袋盛，用好酒豆+斗，于瓷瓮中浸，密封，经七日后服用。<br>【主治】治中风，手足不遂，骨节疼痛，肌肉顽麻。<br>【用法】每日旋取一小盏，不计时候温饮之，常令酒气相续。其酒取一盏，入一盏，以药味薄即止。<br>说明：《普济方》一方同上。
石斛酒	石斛酒――（痹证）<br>（《备急千金要方》）<br>【配方】石斛、丹参、五加皮各五两，侧子、秦艽、杜仲、山茱萸、牛膝各四两，桂心、干姜、羌活、芎　、橘皮、黄芪、白前、蜀椒、茵芋、当归各三两，薏苡仁一升，防风二两，钟乳（捣碎，别绢袋盛，击大药袋内）八两。<br>【制法】上二十一味，口父咀，以清酒四斗渍三日。<br>【主治】风虚气满，脚疼痹挛，弱不能行。<br>【用法】初服三合，日再稍稍加，以知为度。<br>说明：《普济方》同上。
石斛酒方（二）	石斛酒方（二）――（脚气）<br>（《圣济总录》）<br>【配方】石斛去根）四两，丹参、芎、杜仲（去粗皮）、防风（去芦头）、白术、人参（去芦头）、桂心、五味子、白茯苓、陈橘皮（汤浸去白焙）、黄芪、薯蓣、当归各二两，干姜（炮裂），牛膝（去苗）各三两，甘草（炙微赤v）一两。<br>【制法】上十七味细v，以生绢袋盛，用清酒五斗，于瓮中渍七日开。<br>【主治】治脚气痹弱，筋骨疼痛。<br>【用法】初温服三合，日再服，渐加至一盏为度。
石斛酒方（五）	石斛酒方（五）――（痹证）<br>（《太平圣惠方》）<br>【配方】石斛（去根）十两，牛膝（去苗）半斤，杜仲（削去粗皮）、丹参各四两，生地黄（切曝令水气干）一升。<br>【制法】上都细v，以生绢袋盛，用清酒五斗，于瓮子中密封，浸七日开。<br>【主治】风痹脚弱，腰g冷疼，利关节，坚筋骨，令人强健悦泽。<br>【用法】每服一中盏，日可二三服。
石斛牛膝酒方	石斛牛膝酒方――（腰脚疼痛诸病）<br>（验方）<br>【配方】石斛（去根）、牛膝（去苗）各6克，五加皮、羌活、防风（去芦头）、海桐皮、木香、桂心、芎、甘菊花、川椒（去目及闭口者）各24克，附子（炮裂去皮脐）、天麻各36克，虎胫骨（涂酥炙令微黄）15克。<br>【制法】上诸药，捣碎，以生绢袋盛，用好酒1500毫升，以瓷瓶盛，密封口，浸经七日后开取服用。<br>【主治】风冷气攻腰脚，行立无力。<br>【用法】每日三次，温饮一小杯。每取用一杯，即添酒一杯，直候药味稍薄，即更换之。
石灰酒（二）	石灰酒（二）――（生毛发）<br>（《普济方》）<br>【配方】石灰三升。<br>【制法】上细筛水拌令湿，炒令极熟至焦，以木柴投入，火即着为候，停冷取三升，绢袋贮之，以酒三斗浸三宿。一方密封，冬浸十四日，春秋七日取服。<br>【主治】治头发落不止方，及治眉须。<br>【用法】初服半合，日四夜二，稍加至一合神效。常令酒气相接，服之一月，即新生者也。
石灰酒（一）	石灰酒（一）――（生毛发）<br>（《备急千金要方》）<br>【配方】石灰（拌水和湿，蒸令气足）、黍米各一石，松脂成炼（末之）十斤，上曲一斗二升。<br>【制法】上四味，先于大内炒石灰，以木札著灰中火出为度，以枸杞根v五斗，水一石五升，煮取九斗去滓，以淋石灰三遍澄清，以石灰汁和渍曲，用汁多少一如酿酒法，讫，封四七日开服。此酒九月做二月止，恐热。其松脂末初酿酒，摊饭时均散著饭上，待饭冷乃投之，此酒饭宜冷，不尔即酸，宜知之。<br>【主治】主生毛发眉须去大风，妇人不能食饮，黄瘦积年及蓐风，不过一石即瘥。<br>【用法】常令酒气相及为度，百无所忌，不得触风，其米泔及饭糟一事，已上不得使人畜犬鼠食之，皆令深埋却，膈上热者，服后进三五口冷饭压之。<br>说明：《普济方》同上。
石灰酒方	石灰酒方――（生毛发）<br>发为血之余，一般脱发属血虚者多。大病后气血亏损也可出现脱发。“油风”、“鬼剃头”也可头发干枯，成片脱落，属于血虚风燥，不能荣养肌肤。眉毛脱落多见于“麻风”病。以下介绍三种以石灰为主要成份的药酒，据载有较好的生发作用，可用于脱发等影响美容的疾病。<br>（《备急千金要方》）<br>【配方】石灰（细筛）三升。<br>【制法】上件水拌令湿，极熟蒸之，炒令至焦，以木札投之，火即著为候，停冷取三升绢袋贮之，以酒三斗渍三宿。<br>【主治】治头发落不止，甚神验。<br>【用法】初服半合，日四夜二，稍加至一合。<br>说明：《普济方》注一方密封，冬浸十四日，春秋七日取服。乃治眉须。常令酒气相接，服之一月，即新者生也。
石榴浸酒方	石榴浸酒方――（疫毒）<br>（《普济方》）<br>【配方】酸石榴（和皮捣烂）、甜石榴各七枚（和皮捣烂），人参（去芦头）、苦参（）、沙参（去芦头）、丹参、苍耳子、羌活各二两。<br>【制法】上细、绵裹，以无灰酒一斗，于瓷瓶中浸之，密封头，春夏七日，秋冬二七日。<br>【主治】大风，头面热毒，皮肤生疮，面上生结，如眉落者。<br>【用法】每于食前，暖服一中盏，旋旋添酒，味薄再合。<br>说明：《普济方》注出《太平圣惠方》。
石南酒方	石南酒方――（风瘾疹）<br>（《圣济总录》）<br>【配方】石南叶（去粗茎生用）三两。<br>【制法】上一味，捣罗为末。<br>【主治】治风瘾疹，经旬不解。<br>【用法】每服半钱，至一钱匕。用酒三合，煎一沸，空心温服。<br>说明：《普济方》同上。
石楠肤子酒	石楠肤子酒――（风瘾疹）<br>（验方）<br>【配方】石楠叶（去粗茎）、地肤子、当归、独活各50克。<br>【制法】将上药捣罗为末，收贮备用。<br>【主治】风毒瘾疹。<br>【用法】每次用末5-6克，用酒1杯（约15毫升）相煎数沸，候温，连末空心饮服，每日依法3次。
石燕酒方	石燕酒方――（难产）<br><br>（《圣济总录》）<br>【配方】石燕子。<br>【制法】以童子小便三分，磨取自然汁。<br>【主治】催产。<br>【用法】微暖下赤小豆七粒，立产。
史国公浸酒方	史国公浸酒方――（中风）<br>（《医门法律》）<br>【配方】当归、虎胫骨（酥油炙）、川羌活、川萆、防风各二两，秦艽四两，鳖甲（醋炙）一两，川牛膝（酒浸）、松节、晚蚕沙（炒）各二两，枸杞子五两，干茄根（饭上蒸熟）八两，苍耳子（炒，捶碎）四两。<br>【制法】上十三味，用无灰酒在大坛，将绢袋盛药，悬于酒内，密封固。<br>【主治】治诸风五痹，左瘫右痪，口眼?斜，四肢疼痛。七十二般风，二十四般气，其效不可尽述。<br>【用法】候十四日后，开坛取酒，取时不可面对坛口，恐药气冲人面目。每饮一盏，勿令药力断绝。饮尽病痊，将药渣晒为末，米糊丸，梧桐子大。每服八十丸，空心温酒下，忌食动风辛热之物，此药可以常服。
史国公药酒（二）	史国公药酒（二）――（痹证）<br>（《扶寿精方》）<br>【配方】藿香、虎胫骨、茄根各60克，羌活、秦艽、鳖甲、红曲各30克，当归、桂枝、红花、檀香各90克，生姜120克，红枣1120克（煎汁5000克），白蜜1500克，烧酒15公斤。<br>【制法】将上药浸入酒中，采用冷浸法制备成酒。<br>【主治】风湿痹痉而兼有脾胃干和，胸膈不利者。<br>【用法】酌量饮用。
史国公药酒（三）	史国公药酒（三）――（痹证）<br>（《简明中医辞典》）<br>【配方】玉竹48克，神曲36克，牛膝、白术各18克，桑寄生15克，蚕沙、防风、川芎各12克，木瓜、当归、红花各9克，甘草、羌活、独活、续断各6克，鹿角胶、鳖甲胶各3克。<br>【制法】上为粗末，与二胶稀释液混匀，加白酒5625克，冰糖1000克，搅匀过滤，制成药酒。<br>【主治】四肢麻木，骨节疼痛，风寒湿痹。<br>【用法】每服9-15克，日二至三次。<br>说明：原书注“本方来自《证治准绳》原方加减”。
手掌参酒	手掌参酒――（失眠）<br>（《陕甘宁青中草药选》）<br>【配方】手掌参、党参各5钱，黄精1两，白酒1斤。<br>【制法】浸泡一个月后服用。<br>【主治】身体虚弱，神经衰弱，阳萎，久泻。<br>【用法】每服10-20毫升，日服2次。
首乌酒（三）	首乌酒（三）――（瘰疠）<br>（《偏方大全》）<br>【配方】生何首乌或夜交藤适量，白酒适量。<br>【制法】将首乌切细，以60度白酒浸泡于磁瓶中，密封，隔水炖3-5小时即成。<br>【主治】瘰疬结核症及各种痈疽肿毒。<br>【用法】随时适量饮用。
薯蓣酒	薯蓣酒――（眩晕）<br>（《本草纲目》）<br>【配方】薯蓣粉。<br>【制法】同曲、米酿酒。或同山茱萸、五味子、人参诸药浸酒煮饮。<br>【主治】治诸风眩运，益精髓，壮脾胃。<br>【用法】饮之。
薯蓣酒（二）	薯蓣酒（二）――（眩晕）<br>（《本草纲目》）<br>【配方】薯蓣1000克，米1000克，曲适量。<br>【制法】薯蓣压粉，米煮半熟沥干，曲压细末，合在一起拌匀，入坛内密封，注意保温，令发酵，10日后启封，即可饮用。<br>【主治】诸风眩症。<br>【用法】每服20毫升，日服2次。
薯蓣酒（一）	薯蓣酒（一）――（眩晕）<br>（《本草纲目》）<br>【配方】薯蓣50克，山茱萸30克，五味子30克，人参30克，白酒3斤。<br>【制法】将上药入酒内，浸泡10日后服用。<br>【主治】诸风眩运，神疲乏力，食欲不振，腰酸，耳鸣。<br>【用法】每服20-30毫升，日服2-3次。
薯蓣酒方	薯蓣酒方――（眩晕）<br>（《太平圣惠方》）<br>【配方】薯蓣、山茱萸、白术、五味子各八两，防风（去芦头）十两，人参（去芦头）、丹参、生姜各六两。<br>【制法】上都细v，以生绢袋盛，用清酒三斗，入瓷瓮中，浸七日开。<br>【主治】治头风眩，不能食，补益气力。<br>【用法】每度温饮一盏，日二杯为度。
术膏酒	术膏酒――（脚气）<br>（《普济方》）<br>【配方】生白术一石五斗（洗净捣取汁三斗煎取半），青竹三十束别三尺围，各长二尺五寸径一寸（烧取沥三斗煎取半），蔓荆子二十五束别三尺，围各长二尺五寸，径头二寸，（烧取沥三斗煎取半），生五加皮根（净洗讫于大内以水四石煎之，去滓澄清取汁七斗，以铜器中盛大内水上煎之，取汁三斗五升，煎诸药法，一准五加例）三十六斤，生地黄根五六斗（粗大者捣取汁三斗煎取半）。<br>【制法】上白术等五种药，总计得汁九斗五升，加糯米一石五斗，上小麦曲八斤，曝干为末，以药汁六斗，浸面五日，待曲起第一投次淘米七斗，令得三十遍，下米置净席上，以生布拭之，勿令不净，然后下于席上，调强弱，冷热，如常酿酒法，酝之瓮中，密盖，头三日然后第二投更淘米四斗，一如前法投之，三日后，即加药如下：<br>桂心、甘草、白芷、细辛、防风、当归、麻黄、芎各六两，附子五两，牛膝九两，干姜、五加皮各一斤，前口父咀讫，第三投以半四斗，净淘如前法，还以余汁烧馈重蒸，待上生痂，下置席上，调冷热，如常酿法，和上件药投之，三日外，然后尝甘苦得中讫，密封头二七日，乃压取清酒。<br>【主治】脚气弱风虚，五劳七伤，万病皆主之方。<br>【用法】一服四合，日再服，细细加以知为度，温酒不得过热，慎生冷醋滑猪鲤鱼蒜牛肉等。<br>说明：①同《备急千金要方》。②《外台秘要》名“白术膏酒”。
术酒（二）	术酒（二）――（筋骨诸病）<br>（《本草纲目》）<br>【配方】术（去皮捣）三十斤。<br>【制法】以车流水三石，渍上药三十日，取汁，露一夜，浸曲、米酿成。<br>【主治】一切风湿筋骨诸病，驻颜色，耐寒暑。<br>【用法】饮之。<br>说明：本方见《本草纲目》卷二十五附诸药酒条下。
术酒（三）	术酒（三）――（筋骨诸病）<br>筋骨诸病为感受风寒湿邪或肝肾不足所致的筋骨疼痛，腰膝软弱无力，以及手足拘挛等疾患的总称，治疗此类疾患的药酒多具疏风散寒除湿，舒筋通络缓急，滋补肝肾等功能。常用虎骨、羊胫骨等祛风湿、补肝肾之药为主，如羊胫骨酒、虎骨酒、浸酒方、治风毒骨痛酒方等；或以白术、薏苡仁等健脾除湿药为主，如术酒、薏苡仁酒等；或以天雄、蜀椒、附子、等壮阳散寒药为主，如天雄浸酒方；或以地黄、牛膝、天麦门等滋补肝肾药为主，如地黄汁酒、牛膝酒、定风酒等；或以当归等活血养血之药为主，如当归酒等；或以五加皮、羌活、防风、人参、丹参、地黄等诸药配成既能祛风湿、散寒凝，又可补肝肾、通血络，益气血，具有多种作用的药酒，如史国公药酒、人参酒、五加皮酒等。临床可根据病情分别选用。<br>（《本草纲目》）<br>【配方】白术30斤，米30斤，曲适量。<br>【制法】将术去皮捣，以东流水三石，渍30日，取汁，露一宿，浸曲、米酿成饮。<br>【主治】一切风湿筋骨诸病，有驻颜色，耐寒暑之功。<br>【用法】每服20-30毫升，日服2-3次。
术酒（一）	术酒（一）――（乌须黑发）<br>（《永乐大典》）<br>【配方】术（去黑皮）三十斤。<br>【制法】上净洗捣碎，以东流水三石，于不漏器中渍之。二十日压漉去滓，以汁于瓷器中盛贮，夜间候流星过时，抄自己姓名置于汁中，如是五夜，其汁当变如血，旋取汁以浸曲，如家酝法造酒，酒熟饮之。<br>【主治】饮十日万病除，百日发白再黑，齿落再生，面有光泽，久服延年不老。<br>【用法】任性饮之。忌桃、李、蛤肉。服此酒者，真康节所谓频频到口微成醉，拍满怀却是春也。
水菖蒲酒	水菖蒲酒――（疥癣病）<br>（验方）<br>【配方】水菖蒲1.5公斤，米、曲适量。<br>【制法】将上药用3.5公斤，煮取500克，去渣，入米、曲，如常法酿酒，候熟，压去糟，收瓶备用。<br>【主治】癣疮。<br>【用法】随量饮之，不拘时候。
水蓼酒方	水蓼酒方――（疫毒）<br>（《圣济总录》）<br>【配方】水蓼不拘多少。<br>【制法】上一味，捣取汁，与酒调匀服。<br>【主治】治中水毒寒热。<br>【用法】取汁，每服一合，酒半盏，调匀服，日三。
水蓼酿酒	水蓼酿酒――（水肿臌胀）<br>（验方）<br>【配方】水蓼1公斤，曲、米适量。<br>【制法】水蓼煎汁，和曲、米如常法酿酒，酒成去糟渣。<br>【主治】水肿，泄泻痢疾，月经过多。<br>【用法】每饮1-2杯，每日3次。
蒴根浸酒	蒴根浸酒――（Y瘕）<br>Y瘕始见于金匮要略・疟病脉证并治》，指腹内痞块。一般以隐见腹内，按之形证可验，坚硬不移，痛有定处者为Y瘕；聚散无常，推之游移不定，痛无定处者为瘕。Y病在气分，多系腑病，以气郁食积多见。治当消积、攻瘀，行气，扶正诸法合参，常用药如蒴根、牛膝、桂心、牡丹、芍药、干　、水蛭、鳖甲、虻虫、虫等。酒有辛通之力，故药酒治疗本病有较好效果。<br>（《普济方》）<br>【配方】蒴　根一小束。<br>【制法】上洗沥去水，细擘，酒二升渍三宿。若欲速得服，于热灰中温，令药味出。<br>【主治】治卒暴疒微，腹中有物，坚如石，痛欲死。此方无毒，已愈十六人，神验。<br>【用法】温服五合至一升，日三。药尽复作服之。
蒴酒方	蒴　酒方――（水肿臌胀）<br>水肿是因感受外邪，劳倦内伤，或饮食不节，损伤脾胃，使气化不利，津液输布失常，导致水液潴留，泛溢于肌肤，引起以头面、眼睑、四肢、腹痛甚至全身浮肿等为临床特征的病证。臌胀以腹部胀大，皮色苍黄，甚则腹皮青筋暴露，四肢不肿或微肿为特征。多因酒食不节，情志所伤，感染血吸虫、劳欲过度，以及黄疸、积聚失治，使肝、脾、肾功能失调，气、血、水淤积于腹内而成。从病变部位看，水肿以肺、脾、肾为中心，臌胀以肝、脾、肾为中心，二者虽有区别，但亦有不少相同之处，故归于一处。<br>以药酒治疗水肿、臌胀，已有很久的历史，并有丰富的内容。常用大豆、商陆、皂荚、葶葶、芫花、桃皮、水蓼、桑白皮、抽葫芦等药配制而成。有以利尿消肿为主者，有以补肾为主者，有攻补兼施者，有表里同治者，临床可根据病情选用。对因酒食不节之臌胀，在应用药酒治疗时应慎重。<br>（《圣济总录》）<br>【配方】蒴　根。<br>【制法】上一味，捣汁一盏，酒一盏和之，置暖处一宿。<br>【主治】治水气通身黄肿。<br>【用法】旦起空心服之，瘥。
丝瓜酒	丝瓜酒――（黄疸）<br>（《验方新编》）<br>【配方】丝瓜根5根。<br>【制法】将上药捣烂，用水一碗煎八分，去渣候温。<br>【主治】黄疸，眼睛周身黄如金色。<br>【用法】用黄酒冲服。
松花浸酒方	松花浸酒方――（痹证）<br>（《太平圣惠方》）<br>【配方】松花半石。<br>【制法】上药，春三月取五六寸如鼠尾者，不计多少，蒸，细切一升，用生绢囊贮，以酒三升，浸五日。<br>【主治】风头旋脑皮肿痹。<br>【用法】每服，空腹饮五合，晚食前再服。<br>说明：《普济方》、《奇效良方》同上。
松节浸酒（二）	松节浸酒（二）――（风疾诸病）<br>（《普济方》）<br>【配方】当归、熟地黄一两，松节一两，列节一两，牛膝一两。<br>【制法】上为粗末，以绢袋盛药，用无灰酒二百盏，浸三日方可吃。<br>【主治】诸风。<br>【用法】如药酒一盏，服时即以生酒一盏添入。<br>说明：《普济方》注书《家藏经验方》。并注云：表弟武东叔，年二十余，患历节风痛不可忍，涪城马东之，以此方疗之。<br>说明：《普济方》注出《家藏经验方》。
松节浸酒（一）	松节浸酒（一）――（脚气）<br>（《太平圣惠方》）<br>【配方】肥松节一斤，生干地黄三两，桂心一两，丹参二两，萆二两，大麻仁（别捣）一升，牛膝（去苗）三两，生牛蒡根（v去皮土）三两。<br>【制法】上诸药都细v，以生绢袋盛，用好酒二斗，于瓷瓶中渍，密封，候五日后服。<br>【主治】治风毒脚气，挛掣痛。<br>【用法】每于食前，暖中盏服。<br>说明：《普济方》一方生干地黄用二两，余同上。
松节酒（二）	松节酒（二）――（脚气）<br>（《太平圣惠方》）<br>【配方】松节一斤，生干地黄五两，桂心二两，秦艽（去苗）五两，防风（去芦）二两，牛蒡根（去皮）一斤，丹参三两，萆<br>三两，苍耳子三两，独活三两，大麻仁一升，牛膝（去苗）五两。<br>【制法】上件药v，用绢袋盛，以酒三斗，浸六七日。<br>【主治】治脚气，筋挛拘急，四肢掣痛，或至软脚。<br>【用法】每于食前，随性暖服。<br>说明：《普济方》同上。
松节酒（六）	松节酒（六）――（风疾诸病）<br>（《本草纲目》）<br>【配方】松节。<br>【制法】松节煮汁，同曲、米酿酒。松叶煎汁亦可。<br>【主治】治冷风虚弱，筋骨挛痛，脚气缓痹。<br>【用法】饮之。<br>说明：方见《本草纲目》卷二十五附诸药酒条。
松节酒（七）	松节酒（七）――（关节疼痛）<br>（《本草纲目》）<br>【配方】松节二十斤。<br>【制法】上以酒五斗，浸三七日。<br>【主治】历节风痛，四肢如解脱。<br>【用法】每服一合，日五六服。<br>说明：《本草纲目》卷三十四松条注“引外台”。
松节酒（三）	松节酒（三）――（关节疼痛）<br>（《太平圣惠方》）<br>【配方】松节（捶碎以水一硕煮取汁五斗去滓）十斤，糯米（炊熟）五斗，细曲（捣碎）五斤。<br>【制法】上三味拌和，入瓮密封，三七日开。<br>【主治】百节风虚，脚痹疼痛。<br>【用法】取酒温饮一盏，日三。
松节酒（四）	松节酒（四）――（关节疼痛）<br>（《普济方》）<br>【配方】松叶三十斤。<br>【制法】用酒二石五斗，渍三七日，或用松节亦可，或用松脂亦可。<br>【主治】历节风。<br>【用法】服一合、日五六度。<br>说明：《普济方》注出《千金方》。
松节酒（五）	松节酒（五）――（关节疼痛）<br>（《永乐大典》）<br>【配方】松节（捶碎，以水一石煮，取汁五斗，去滓）十斤，糯米（炊熟）五斗，细曲（捣碎）五斤。<br>【制法】上三味拌和入瓮，密封三七日，开取酒。<br>【主治】百节风虚，脚痹疼痛。<br>【用法】可温饮一盏，日三。<br>说明：注本方出《和剂局方》。
松节酒方	松节酒方――（关节疼痛）<br>（《肘后备急方》）<br>【配方】松节二十斤。<br>【制法】酒五斗渍二七日。<br>【主治】历节风，四肢疼痛如解落。<br>【用法】服一合，日五六服。
松节酿酒	松节酿酒――（关节疼痛）<br>（《外台秘要》）<br>【配方】松节2.5公斤，曲、米适量。<br>【制法】将松节煮汁，同曲、米如常法酿酒。<br>【主治】风湿性关节疼痛，筋骨挛急，腿肿。<br>【用法】不拘时，徐徐饮之。
松酒	松酒――（关节疼痛）<br>（《陕甘宁青中草药选》）<br>【配方】松节15斤，蘑菇1.5斤，红花11斤，水100斤，酒10斤。<br>【制法】将诸药水内煮沸，待水剩50斤，过滤，加白酒即可服用。<br>【主治】大骨节病。<br>【用法】每服20毫升，日服2次。
松叶浸酒（二）	松叶浸酒（二）――（癞病）<br>（《太平圣惠方》）<br>【配方】猪鬃松叶（切）一斤，麻黄（去根节）五两。<br>【制法】上诸药，细v，以生绢袋盛，以清酒二浸，秋冬七日，春夏五日，日满开取。<br>【主治】治大风疾。<br>【用法】每服，温一小盏服，常令醺醺，以效为度。<br>说明：《普济方》猪鬃松叶用二斤，余同上。
松叶浸酒（三）	松叶浸酒（三）――（脚气）<br>（《圣济总录》）<br>【配方】大麻仁一升。<br>【制法】研碎，酒三升，渍三宿。<br>【主治】脚气腹痹。<br>【用法】温服大良。<br>说明：《本草纲目》卷二十二大麻条注“引外台”，本方名系笔者所加。
松叶浸酒（四）	松叶浸酒（四）――（痹证）<br>（《永乐大典》）<br>【配方】松叶七斤，独活十两，麻黄（去根、节）十两。<br>【制法】右都细v，入生绢袋盛，以酒五豆斗，入瓮密封渍之，春秋七日，冬十日，夏五日。候日足。<br>【主治】除一切风挛，跛　疼闷，手不上头，腰痛强直，两脚　疼，顽痹不能久立，半身不遂，头风耳聋目暗，见风泪出，鼻不闻香臭，唇口生疮，恶疰流转，如锥刀所刺，皆悉主之。<br>【用法】每温饮一小盏，日三。
松叶浸酒（一）	松叶浸酒（一）――（关节疼痛）<br>（《太平圣惠方》）<br>【配方】五粒松叶（v碎净洗漉干）二十斤，清酒一硕。<br>【制法】上二味，都入于不津瓮中，密封，七七日熟。<br>【主治】去大风，治骨节疼痛。<br>【用法】量大饮之。<br>说明：《永乐大典》同上。
松叶酒（二）	松叶酒（二）――（口眼?斜）<br>（《圣济总录》）<br>【配方】青松叶，防风各250克，酒1.5公斤。<br>【制法】将松叶捣令汁出，与防风用白包，盛净器中，以酒浸两宿，近火煨一宿。<br>【主治】口眼歪斜，语声不出，关节不利。<br>【用法】初服20毫升，渐加至30毫升，不拘时候，以头面汗出为度。服药其间避风。
松叶酒（三）	松叶酒（三）――（口眼?斜）<br>（《奇效良方》）<br>【配方】青松叶一斤，清酒一斗。<br>【制法】将上药细v如豆，木石臼捣令汁出，用生绢囊贮，以酒浸二宿，近火煨一宿即成。<br>【主治】中风口眼?斜，亦治三年中风不效者。<br>【用法】初服半升，渐加至一升，头面汗出即止。<br>说明：如无酒，用水浸亦可。
松叶酒（四）	松叶酒（四）――（痹证）<br>（《奇效良方》）<br>【配方】松叶六十斤。<br>【制法】上药咬咀，以水四石，煮取四斗九升，以酿五斗米如常法，别煮松叶汁以渍米，并馈饭，泥酿封头，七日发澄。<br>【主治】脚弱十二风痹不能行。<br>【用法】饮之取醉。
松叶酒（一）	松叶酒（一）――（痹证）<br>痹者闭也，阻闭不通之意。痹证是由于风、寒、湿、热等外邪侵袭人体，闭阻经络，气血运行不畅所导致的，以肌肉、筋骨、关节发生酸痛、麻木、重者、屈伸不利，甚或关节肿大灼热等为主要临床表现的病证。古代对痹证的论述，除最常见的“风气胜者为行痹，寒气胜者为痛痹，湿气胜者为着痹”外，还有骨痹、筋痹、脉痹、肌痹、皮痹、五脏痹、血痹、历节、痛风、周痹、肠痹及八风十二痹等，名目繁多，但其基本病理则一。痹证的治疗以宣通为主，并根据具体病瘀互结，阻痹经络关节者，助以化痰祛瘀；日久肾虚精亏，真元不足者，必以益肾填精，培补正气。由于痹证常缠绵日久，反复发作，难以根治，而酒有辛温宣通之性，又可助蠲痹诸药之力，酒力引药可直达血脉诸节，故药酒治痹疗效卓著，且寓治于膳，可长期饮用，备受病家欢迎。因此，药酒已成为痹证治疗的重要手段。古今医家在长期的临床实践中研制出了许多疗效很高的药酒配方，这里介绍的配方，基本上反应了药酒治痹之大概。值得注意的是，治痹药酒中一些重要的药物，如大辛大热的附子、川草乌、马钱子等，由于毒性较大，过量服用易导致中毒，甚至危及生命，因而使用时切切不可过量，以免发生意外。<br>（《备急千金要方》）<br>【配方】松叶六十斤。<br>【制法】上件口父咀之，以水四石，煮取四斗九升，以酿五斗米，如常法，别煮松叶汁以渍米并喷饭，泥酿封头，七日发。<br>【主治】脚弱十二风，痹不能行，服更生散数剂，及众治不得力，服此一剂便能远行，不过两剂。<br>【用法】澄饮之取醉。<br>说明：《普济方》同上。
松叶酒方（二）	松叶酒方（二）――（风瘾疹）<br>（《圣济总录》）<br>【配方】松叶一斤。<br>【制法】上一味，细切，以酒一斗，煮取三升。<br>【主治】治风瘙瘾疹，三十年不瘥。<br>【用法】日夜服尽，处温室中，衣复出汗即瘥。
松叶酒方（一）	松叶酒方（一）――（痹证）<br>（《太平圣惠方》）<br>【配方】松叶十斤，独活、麻黄（去筋）各十两。<br>【制法】上都细v，入生绢袋盛，以酒五斗，入瓷密封渍之，春秋七日，冬十日，夏五日，候日足。<br>【主治】除一切风，挛跛，疼闷，手不上头，腰背强直，两脚酸疼，顽痹，不能久立，半身不遂，头风，耳聋目暗，见风泪出，鼻不闻香臭，唇口生疮，恶疰流转，如推刀所刺，皆悉主之。<br>【用法】每温饮一盏，日三。
松叶汁酒	松叶汁酒――（关节疼痛）<br>（《备急千金要方》）<br>【配方】松叶汁一斤，酒三升。<br>【制法】以酒浸松叶汁七日后即成。<br>【主治】历节风痛。<br>【用法】每服一合，每日三服。
松液酒	松液酒――（痹证）<br>（《本草纲目》）<br>【配方】松液。<br>【制法】于大松下掘坑，置瓮承取其津液，一斤酿糯米五斗。<br>【主治】一切风痹脚气。<br>【用法】取酒饮之。
松脂酒	松脂酒――（肝虚流泪）<br>（《医部全录》）<br>【配方】炼成松脂一斤，酿米二斗，水七斗，曲二斗。<br>【制法】以常法酿酒。<br>【主治】肝虚目泪。<br>【用法】频饮之。
松脂松节酒方	松脂松节酒方――（癞病）<br>（《太平圣惠方》）<br>【配方】松脂（炼成者捣罗为末）三斤，糯米二斗，曲末三斤。<br>【制法】上炊米熟，放冷，以炊米汤三斗温二斗二物拌和，入不津瓮中，封盖候熟。<br>【主治】治大风有验。<br>【用法】即量性饮之妙。
松脂酝酒方	松脂酝酒方――（癞病）<br>（《圣济总录》）<br>【配方】松脂（太山川谷者六月采）二斗五升，黍米二斗五升，细曲一十五斤半，糯米五斗。<br>【制法】上四味，以水一石，煎松脂浮上，掠取入冷水中，却又入汤，如上四五十度。每伍度煮，即须换汤暴干，捣研作粉，得一斗一或二合半，炼松脂初酝法，用水四斗浸曲，曲发黍米一斗五升，以松脂粉拌饭，一如常酝法，相次成米，每曲随常酝法，入更炊一斗黍米，拌松粉下第一料，又相次更炊糯米三斗，入松粉和。又相次更炊糯米二斗，同松粉拌和匀，取其松脂粉，并须知饭用尽，每一斗米，入松脂粉一升五合相拌，入后压去滓，取清酒，又一方，加杏仁五升，去皮及双仁者，随料均分，汤退去皮，捣破研如膏，入之佳。<br>【主治】治大风癞、皮脸搔痒。搔之落如麸片，宜安府藏。去胃中伏热，解咽干舌涩除风痹虚赢。治眉须堕落，久服轻身延年不老。<br>【用法】每服五合细饮，日夜可四五服，渐渐加至一升，温任性饮之，常令醺醺，酒势相接。<br>说明：《普济方》同上。
苏合香酒	苏合香酒――（疫毒）<br>（《永乐大典》）<br>【配方】苏合香丸（有脑子者，炙去脑子）。<br>【制法】上用十分好醇酒，每夜将五丸浸一宿，次早温饮。<br>【主治】除百病，辟四时寒邪不正之气，旧酒尤佳。<br>【用法】次早温服一杯。
苏木酒方	苏木酒方――（跌打损伤）<br>（《圣济总录》）<br>【配方】苏木（椎令烂碎）二两。<br>【制法】上一味，用酒二升，煎取一升。<br>【主治】治被打伤损，因疮中风。<br>【用法】分三服，空心午时，夜卧各一。<br>说明：《普济方》同上。
苏木行瘀酒	苏木行瘀酒――（跌打损伤）<br>（验方）<br>【配方】苏木70克。<br>【制法】将上药捣碎致细，用水、酒各500克，煎取500克，分3份。<br>【主治】跌打损伤，肿痛。<br>【用法】每日早、午、晚，临睡空心各1服。孕妇忌服。
苏唐豉酒（二）	苏唐豉酒（二）――（腰脚疼痛诸病）<br>（《外台秘要》）<br>【配方】大豆（新者）一斗。<br>【制法】上件九蒸九暴，以美酒三斗渍三宿。<br>【主治】利腰脚，祛湿气，功用同前。<br>【用法】随性多少饮，饮尽复作，常服甚佳。
苏唐豉酒（三）	苏唐豉酒（三）――（腰脚疼痛诸病）<br>（《外台秘要》）<br>【配方】香豉三升，犀角（末之）八两。<br>【制法】上二味，其豉如前，用一生绢袋贮，好美酒九升渍之五日许，其犀角末散著袋外。<br>【主治】利腰脚。<br>【用法】每服常搅，令犀角未入酒中，服三合，量性增减。日三服。其酒夏月勿作，多恐坏，可用此方；豉三合，橘皮、生姜、葱细切，任意调和，先熬油令香，次下诸物熬熟，以绵裹内铛中，著酒任意性饮之。
苏唐豉酒（一）	苏唐豉酒（一）――（腰脚疼痛诸病）<br>（《外台秘要》）<br>【配方】香豉三升，美酒香者一斗。<br>【制法】上二味，先取香豉三升，三蒸三暴干，内一斗酒中渍三宿。<br>【主治】若能常饮此酒，极利腰脚，岭南常服此酒佳，及卑湿处亦准此，又恐有脚气似著，即宜服之。<br>【用法】随人多少饮之，用滓敷脚。
苏子酒（二）	苏子酒（二）――（痰证）<br>（经验方）<br>【配方】苏子60克，酒500克。<br>【制法】苏子炒香研末，以纱布袋盛，浸好酒中，三日后取汁饮。<br>【主治】消痰下气，润肺止咳。治慢性气管炎、咳嗽咳痰、胸满短气等症。<br>【用法】每次喝一盅。
苏子酒（一）	苏子酒（一）――（痰证）<br>（《费氏食养三种》）<br>【配方】家苏子（炒香研末）。<br>【制法】上以绢袋盛，浸好酒中。<br>【主治】主消痰下气，润肺止咳。<br>【用法】每日少饮。
酸浆酒方	酸浆酒方（一）――（难产）<br><br>《圣济总录》）<br>【配方】酸浆（授自然汁）。<br>【制法】上一味，每服半盏，暖酒半盏调之。<br>【主治】难产。<br>【用法】顿服立出。<br>说明：《普济方》同上。
酸枣仁浸酒方	酸枣仁浸酒方――（腰脚疼痛诸病）<br>（《普济方》）<br>【配方】酸枣仁（微炒）、生干地黄、虎胫骨（酥涂炙微黄）各三两，羌活、牛膝（去苗）、山茱萸、桂心、天雄（炮裂去皮脐）、仙灵脾、萆、芎、天麻、肉苁蓉（刮去粗皮）各二两，甘菊花，桑寄生各一两半。<br>【制法】上v细末，以生绢袋盛，用好酒三斗，于净瓷瓶中浸，密封瓶口。<br>【主治】风气，暖脏腑，利脚膝，止疼痛。<br>【用法】五日后开取，每日三五度温饮一盏，常令醺醺，瓶中酒少，旋更添之，候药无味，即更修合，以瘥为度，忌毒滑物。<br>说明：①《普济方》注出《太平圣惠方》。②《太平圣惠方》同上。
酸枣仁酒	酸枣仁酒――（脚气）<br>（《普济方》）<br>【配方】酸枣仁三两，干葡萄五两，黄芪三两，天门冬（去心）二两，赤茯苓三两，防风（去芦）二两，独活二两，大麻仁半斤，桂心二两，羚羊角三两，五加皮三两，牛膝（去苗）五两。<br>【制法】上v，用生绢袋盛，以清酒三斗，浸六七日。<br>【主治】治脚气疼痛，及光泽肌肤，润养脏腑。<br>【用法】每于食前随性暖服之。<br>说明：《太平圣惠方》同上，方中羚羊角为羚羊屑。
蒜豉酒	蒜豉酒――（腰脚疼痛诸病）<br>（验方）<br>【配方】蒜（拍碎）400克，桃仁（去皮尖炒研）、豉（炒香）各250克，好酒2公斤。<br>【制法】将上药用夏白布包贮，入净器中，以酒浸之，密封，春夏3日，秋冬7日后可开取。<br>【主治】初感腿脚软弱无力。<br>【用法】初服10毫升，渐加至20毫升，随量饮之，每日3-4次，常令有酒气。<br>注：如酒尽，更添入酒1.5公斤，加好椒30克。
蒜姜酒方	蒜姜酒方――（疟疾）<br>（《圣济总录》）<br>【配方】独窠蒜一颗，生姜一分。<br>【制法】上二味，研碎，以酒半升调去滓。<br>【主治】治胃疟饥不能食。<br>【用法】未发时，旋旋服之。<br>说明：《普济方》同上。
蒜酒方	蒜酒方――（脚气）<br>（《圣济总录》）<br>【配方】蒜（去心切炒）二升，桃仁（去皮尖双仁炒研）一升，豉（炒香）一升。<br>【制法】上三味，以生绢袋盛，内净瓷瓮中，用好酒一斗浸，密封头，春夏三日，秋冬七日。<br>【主治】治视觉似有脚气。<br>【用法】初服半盏，加至一盏，量性饮之，日三四服，常令有酒色，右酒尽，更入酒五升，加好椒一二合良。<br>说明：《普济方》同上。
岁旦屠苏酒方	岁旦屠苏酒方――（疫毒）<br>（《备急千金要方》）<br>【配方】大黄、桔梗、署椒各十五株，白术、桂心各十八株，乌头六株，菝葜十二株。一方有防风一两。<br>【制法】上七味　咀，绛袋盛，以十二月晦日日中悬沉井中，令至泥，正月朔日平晓出药，置酒中煎数沸。<br>【主治】辟疫气，令人不染温病及伤寒。<br>【用法】於东向户中饮之，屠苏之饮，先从小起，多少自在。
缩砂酒	缩砂酒――（胃脘痛）<br>（《本草纲目》）<br>【配方】砂仁（炒研）。<br>【制法】上袋盛浸酒。<br>【主治】消食和中，下气、止心腹痛。<br>【用法】煮饮。<br>说明：本方见《本草纲目》卷二十五附诸药酒条下。
桃花白芷酒	桃花白芷酒――（祛黧黑斑）<br>（《浙江中医杂志》）<br>【配方】桃花250克，白芷30克，白酒1000毫升。<br>【制法】农历3月3日或清明前后，采集东南方向枝条上花苞初放开放不久的桃花，与白芷同浸于酒中，容器密封，1个月后即可使用。<br>【主治】面色晦黯、黑斑或因妊娠产后面黯等症。<br>【用法】每日早晚或晚上饮酒1-2盅，同时倒少许酒于掌中，双手对擦，待手发热后，来回擦面部患处，一般使用30-60天后，面部黑斑可消失，面色变红润光泽。
桃花酒	桃花酒――（悦色驻颜）<br>（《普济方》）<br>【配方】桃花（三月三采）。<br>【制法】上以酒渍。<br>【主治】除百病，好容色（一云益颜色）。<br>【用法】饮之，又桃仁服之长生。
桃皮酒（二）	桃皮酒（二）――（水肿臌胀）<br>（《本草纲目》）<br>【配方】桃皮1斤，秫米适量。<br>【制法】将桃皮煎汁，同秫米酿酒，酒成去糟渣，贮瓶备用。<br>【主治】水肿，小便不利。<br>【用法】每食前温饮2-3杯。
桃皮酒（一）	桃皮酒（一）――（水肿臌胀）<br>（《普济方》）<br>【配方】桃皮三斤（削去上黑取裹黄皮），麦曲一升，秫米一升。<br>【制法】上以水三斗，煮桃皮令得一斗，以五升汁渍麦曲五斤，汁渍饭酿如酒法，热漉去滓。<br>【主治】水肿。<br>【用法】可服一合，日三，耐酒者增之，以体中有热为候，小便多者，即是病去便愈，忌生冷一切有毒食物。
桃仁地黄酒	桃仁地黄酒――（跌打损伤）<br>（《普济方》）<br>【配方】生地黄汁一升，酒一升，桃仁（去皮尖别研）一两。<br>【制法】上将地黄汁酒煎沸，下桃仁再煎数沸。<br>【主治】治倒仆蹴损筋脉。<br>【用法】每服一盏，温服，不拘时候。<br>说明：《普济方》注出《圣济总录》）
桃仁酒方	桃仁酒方――（悦色驻颜）<br>（《太平圣惠方》）<br>【配方】桃仁（汤浸去皮尖双仁）一升二百枚，清酒三斗。<br>【制法】上先捣桃仁令碎，纳砂盆中细研，以少酒绞取汁，再研再绞，使桃仁尽即止，都纳入小瓷瓮中，置于釜内，以重汤煮，看色黄如稀饧，便出。<br>【主治】令人光悦，下三蛊，益颜色，甚妙。<br>【用法】每服一中盏，日二服，其味极美。女人服之更佳。
桃仁朱砂煎酒方	桃仁朱砂煎酒方――（风疾诸病）<br>（《太平圣惠方》<br>【配方】桃仁（汤浸去皮尖双仁麸炒微黄细v）二升，朱砂（细研）二两。<br>【制法】上以无灰好清酒三斛（豆+斗），取瓷瓶三支盛酒，逐豆+斗分桃仁朱砂入瓶内，封头，一依煮酒法度。<br>【主治】治肝风，筋脉挛急疼痛，益血长肌肉，除瘦弱，悦颜色。<br>【用法】不计时候，温饮一小盏，忌羊血。
桃仁朱砂酒	桃仁朱砂酒――（心悸）<br>（《太平圣惠方》）<br>【配方】桃仁（汤浸去皮尖，麸炒微黄细碎）100克，朱砂（细研）10克，醇酒0.5公斤。<br>【制法】将桃仁用酒浸于净器中，封口，煮沸，取下候冷，再放入朱砂细末，搅动令匀。<br>【主治】筋脉挛急疼痛，面色不华，血滞胸痹，心悸怔忡。<br>【用法】每次温饮1-2小杯，不拘时候。<br>说明：勿食羊血，孕妇不宜用。
藤黄煮酒散	藤黄煮酒散――（痈疽、疮疡、发背）<br>（《普济方》）<br>【配方】鹭鸶藤（茎叶于用花尤妙）二两，生地黄（干者）一两。<br>【制法】上为粗末，酒四升和入大瓶内，油纸竹叶牢封瓶口；悬釜内煮二三百沸，香熟后冷，就瓶纱滤出酒。<br>【主治】治痈疽肿疮，深附骨在腹，虽肿皮肤不热，颜色危恶，或痿或疳。妇人乳疽，一切血气不和，留畜疙疸挛皮于筋骨，不能行步。<br>【用法】每服一盏，日三夜一，温凉随时顺意服。
天蓼木浸酒方（二）	天蓼木浸酒方（二）――（风疾诸病）<br>（《太平圣惠方》）<br>【配方】天蓼木（去皮细v）一斤。<br>【制法】上以生绢袋盛，以好酒二斗浸之，春夏七日，秋冬二七日即开。<br>【主治】治风疾。<br>【用法】每日空心，日中初夜，各温饮一小盏，老小临时加减，如若长服，只可每朝一盏。
天麻酒	天麻酒――（痹证）<br>（《普济方》）<br>【配方】天麻（切）二两，牛膝二两，附子二两，杜仲二两。<br>【制法】上药细v，以生绢袋盛，用好酒一斗五升，浸经七日。<br>【主治】妇人风痹，手足不遂。<br>【用法】每服温饮下一小盏。<br>说明：《普济方》注本方“出十便良方”。
天麻灵脾酒	天麻灵脾酒――（半身不遂）<br>（《太平圣惠方》）<br>【配方】仙灵脾、明天麻、独活、制附子、牛膝、桂心、当归、五加皮、川芎、石斛、茵芋、萆、狗脊、海桐皮各30克，虎胫骨60克，牛蒡子、苍耳子、川椒（炒出汗）各30克，好酒2公斤。<br>【制法】将上药共为粗末，以生白布袋盛，用酒浸，密封，7日后即可开取饮用。<br>【主治】中风半身不遂，肢节疼痛无力。<br>【用法】每日温饮1-2杯，不拘时候，常令酒气相续，酒尽再添，以药味薄即止。
天麻石斛酒	天麻石斛酒――（手足不遂）<br>（《太平圣惠方》）<br>【配方】石斛、天麻、川芎、仙灵脾、五加皮、牛膝、萆、桂心、当归、牛蒂子、杜仲、制附子各20克，虎胫骨（涂酥炙黄）32克，乌蛇肉（微炒）、茵芋、狗脊、丹参各20克，川椒（去目闭口者微炒出汗）25克，好酒1.5公斤。<br>【制法】将上药共捣碎细，用酒浸于瓮中蜜封，7宿后即可开取饮用。<br>【主治】中风手足不遂，骨节疼痛，肌肉顽麻，腰膝酸痛，不能仰俯，腿脚肿胀。<br>【用法】每日1小杯，不计时候温饮，常令有酒力相续。
天门冬酒（四）	天门冬酒（四）――（脚气）<br>（《圣济总录》）<br>【配方】天门冬（去心捣绞取汁慢火煎如稀汤）、生地黄（v，粗大者洗净控干捣取汁三升煎取一升半）各五升，湿荆（每束三尺围各长二尺五寸当中心以火烧两头盛取汁一升半煎取七合）二十五束，青竹（每束三尺围各长二尺五寸当中心以火烧两头盛取汁三升煎取一升半）三十束，生五加皮（洗净控干v大内重汤煎之至三斗五升盛与前四叶汁合匀）白糯米一石五斗，曲（暴干捣末）八斤。<br>【制法】上药汁取六升浸曲末，五日曲中沸起第一酸，将末七斗净淘二十遍，置净席上，以生布干。然后内甄中蒸为馈。即以前药汁内净盆中，拌饭令匀，候冷热，如常温酒法，入净瓮中密封，经三日后，入第二，更净淘米四斗，一如前法蒸饮后，放令冷热得所，投入前酒瓮中封头，又经三日，即入后药桂（去粗皮）、甘草（炙）、白芷、当归（切焙）、芎　、麻黄（去根节）各六两，干姜（炮）、白芷、当归（切焙）、芎　、麻黄（去根节）各六两，干姜（炮）、五加皮（炙）各一斤，附子（炮裂去皮脐）五两，牛膝（去苗v）九两，白糯米（淘净控干）四斗。上十一味米除外，并v捣如米粒，入米拌匀，同内甑中，炙蒸极熟，倾出摊，候似人体冷暖，投入煎酒瓮中，三日后，可服少许尝之，若得中即密封瓮头，更候二七日后，压取清酒，入不津器中盛之。<br>【主治】治脚气疼痛，延年不老。<br>【用法】每服四合，温饮之，日再，渐加至半盏，以知为度，饮此酒只可微温，不可过热。
葶苈酒方	葶苈酒方――（水肿臌胀）<br>（《圣济总录》）<br>【配方】葶苈一升。<br>【制法】上味，用酒五升，浸三宿。<br>【主治】治大腹水肿，利小便。<br>【用法】每服半盏，日二服，小便利为度。<br>说明：《普济方》注“日二服”，治“水肿气满”，余同上。
通草酒（一）	通草酒（一）――（产后缺乳）<br><br>（验方）<br>【配方】通草（切）30克，石钟乳（研碎）60克，米酒400毫升。<br>【制法】用酒浸药于瓶中，近火煨3宿后开放。<br>【主治】乳汁不下。<br>【用法】频频饮之，不拘时候。
通草酒方	通草酒方――（跌打损伤）<br>（《普济方》）<br>【配方】通草（煮汁）。<br>【制法】酿酒。<br>【主治】治金疮及些小出血。<br>【用法】饮之。<br>说明：原书无方名，方名据药味及制法命名。《普济方》注出“本草”。
通草酿酒	通草酿酒――（水肿臌胀）<br>（《本草纲目》）<br>【配方】通草250克，灯芯30克，曲、米适量。<br>【制法】将上药共煎汁，同曲、米如常法酿酒。<br>【主治】水肿，淋病，胸热心烦，小便短少，乳汁不通。<br>【用法】徐徐饮之，不拘时候，以愈为度。<br>说明：孕妇忌服。气虚无湿热者不宜用。
通草石钟乳浸酒	通草石钟乳浸酒――（产后缺乳）<br><br>（《普济方》）<br>【配方】通草（横心者，是勿取羊桃银色黄无益）、石钟乳各等分。<br>【制法】上二味，酒五升渍一宿，明旦煮沸，去滓服。<br>【主治】治妇人乳无汁。<br>【用法】每服一升，日三。夏冷服，冬温服。<br>说明：方名为笔者所命名。
通脉管药酒	通脉管药酒――（血栓闭塞性脉管炎）<br>（《广西卫生》）<br>【配方】走马胎、七叶一枝花、归尾、桑寄生、威灵仙各30克，牛膝、桂枝、红花、桃仁、皂角刺各15克，乳香、没药各9克，黄芪、党参各15克，桂林三花酒2500-3000克。<br>【制法】将上药浸入酒中3周后即可饮用。<br>【主治】血栓闭塞性脉管炎。寒湿凝滞：寒凝血脉，阳气不达肢端，继之患肢麻木疼痛，皮色苍白，触之冰凉，遇冷加重；瘀血阻闭：瘀血阻滞，络脉闭塞，患肢紫红或青紫，足背动脉搏动消失；湿热壅滞；瘀血久郁化热，可形成湿热壅滞，使患肢红肿溃烂。此酒主要适用于寒湿或气滞血瘀而偏寒者。<br>【用法】每次20-100毫升，以不醉为度。1月为1个疗程，每服1疗程后，即停服3-5天，以后可再继续服用。<br>说明：有心脏病患者，则宜用此方剂制成水煎剂服用。
桐皮薏仁酒	桐皮薏仁酒――（痹证）<br>（《普济方》）<br>【配方】海桐皮、薏苡仁各60克，生地100克，川牛膝、川芎、羌活、地骨皮、五加皮各30克，甘草12克，白酒1.5公斤。<br>【制法】将上药共为粗末，用夏白布袋盛，以酒浸泡，封口，夏7日，冬14日后即可开封。<br>【主治】腰膝湿热痛甚，血脉顽痹臂痛，腿脚不遂，疥癣。<br>【用法】空腹饮15-20毫升，每日3次，常令微醉。
屠苏酒（二）	屠苏酒（二）――（疫毒）<br>（《杂病源流犀烛》）<br>【配方】白术54克，大黄、桔梗、川椒、肉桂各45克，虎杖根36克，川乌18克。<br>【制法】将上药　为末，装入绢袋中，元旦前一日，将盛有药物的绢袋沉入井底，第2天正月初一早晨取药，浸入一瓶清酒中，煮数沸后饮用。<br>【主治】预防瘟疫等传染病。<br>【用法】适量饮用。<br>说明：川乌含有乌头碱，属剧毒成分，应使用炮制后的乌头，并要掌握用量，以保证用药安全。
屠苏酒（三）	屠苏酒（三）――（疫毒）<br>（《景岳全书》）<br>【配方】麻黄、川椒、细辛、防风、苍术、干姜、肉桂、桔梗各等分。<br>【制法】将上药制为粗末，装入绢袋，浸入适量白酒中，容器密封，3日后可饮用。<br>【主治】祛风散寒，温中健脾，预防瘟疫。<br>【用法】适量饮用。
屠苏酒（四）	屠苏酒（四）――（腹胀腹痛）<br>（《治疗与保健药酒》）<br>【配方】厚朴、桔梗、防风、桂枝、茅术、贡术、制川乌、白芷各8克，川军、广皮各10克，檀香、紫豆蔻、川椒、藿香各6克，威灵仙、甘草各5克，冰糖520克，白酒5200克。<br>【制法】将上药浸入白酒中，加入冰糖，加热数沸后静置，过滤，将入瓷坛或下班瓶内贮存。<br>【主治】风寒邪气侵犯胃肠，肠胃之气不能顺降，积滞内停所致腹痛而胀，进食不化，恶心呕吐等症。<br>【用法】每日早、晚各一服，每次饮用2-3盅。
屠苏酒（五）	屠苏酒（五）――（疫毒）<br>（《备急千金要方》）<br>【配方】大黄、桔梗、蜀椒各十五株，白术、桂心各十八株，乌头六株，菝葜十二株。<br>【制法】上　咀，绛袋盛，以十二月晦，日中，悬沉井中，令至泥，正月朔月平晓出药，置酒中煎数沸。一方用虎杖一两一钱，无菝葜。一方有防风一两。<br>【主治】岁旦辟疫气，令人不染温病及伤寒。<br>【用法】于东向中饮之屠苏酒，待三朝，还渣置井中，能仍岁饮，可世无病，当家内外有井，皆悉著药，辟温气也。<br>说明：《普济方》注出《备急千金要方》。《三因极一病证方论》大黄、桔梗、川椒、白术、桂心各一两八分，菝葜一两二钱，乌头（炮去皮尖）六钱，余同上。
屠苏酒（一）	屠苏酒（一）――（疫毒）<br>（《小品方》）<br>【配方】肉桂22克，防风30克，菝葜15克，署椒、桔梗、大黄各17克，乌头7克，赤小豆14枚。<br>【制法】将上药　为末，装入绢袋中，元旦前一日，将盛有药物的绢袋沉入井底，第2天正月初一早晨取药，浸入一瓶清酒中，煮沸数次后饮用。<br>【主治】预防瘟疫等传染病。<br>【用法】适量饮用。<br>说明：川乌含有乌头碱，属剧毒成分，一定要使用炮制过的乌头，并应掌握用量，以保证用药安全。
土瓜根酒方	土瓜根酒方――（蛊毒）<br>（《圣济总录》）<br>【配方】土瓜根一两。<br>【制法】上一味，细v，以酒一盏一宿，次日去滓。<br>【主治】蛊毒。<br>【用法】作一服，吐下蛊即差。
兔儿伞酒	兔儿伞酒――（关节疼痛）<br>（《陕甘宁青中草药选》）<br>【配方】兔儿伞根2两，白酒150毫升。<br>【制法】浸泡7日后服用。<br>【主治】风湿性关节炎，腰腿痛，四肢麻木。<br>【用法】分3次服，日服1次。
腽肭脐酒（一）	腽肭脐酒（一）――（阳萎）<br>（《调疾饮食辨》）<br>【配方】腽肭脐1具，肉苁蓉50克，白酒500毫升。<br>【制法】将上药浸入酒中，温浸1周。<br>【主治】肾阳虚损，阳萎不起等病症。<br>【用法】每次饮用1杯，日3。
晚蚕沙浸酒	晚蚕沙浸酒――（半身不遂）<br>（《普济方》）<br>【配方】晚蚕沙一升，茄子根二两，牛膝（去苗）二两，大麻子半升，牛蒡子（微炒）二两，防风（去芦头）一两，羌活一两，秦艽一两，枸杞子一两，当归（v微炒）一两，桂心一两，虎胫骨（涂酥炙黄）二两，海桐皮一两，鼠粘子二两。<br>【制法】上细v，以生绢袋盛，用好酒二斗，浸经七日。<br>【主治】妇人中风偏枯，手足挛急，顽痹不遂。<br>【用法】每日不计时候温饮一小盏，常令酒气相接为佳。
万灵至宝酒	万灵至宝酒<br>【来源】《三补简便验方》<br>【原料】淫羊藿（酒洗净）300克，仙茅（去心，盐水炒）120克，肉苁蓉（糯米泔浸一宿，竹刀削去粗皮黑顶）120克，雄黄（碎）60克，当归（酒浸洗净）240克，黄柏（去粗皮）60克，知母（去尾）60克，白酒7.5升。<br>【制作】将上药切碎，装入瓶内封固，桑柴文武火悬瓶煮6小时，再埋地下3昼夜，取出静置49日，备饮。<br>【功效】补虚强身，生精血，益肾水，进饮食，助阳补阴，健身强体。<br>【用法】每日早、晚饮30毫升。
王瓜酒	王瓜酒――（产后缺乳）<br><br>（验方）<br>【配方】王瓜适量，酒适量。<br>【制法】用酒煮瓜烂熟。<br>【主治】乳汁不下。<br>【用法】饮酒咬王瓜下，其乳脉自通。
王益酒	王益酒<br>【来源】《民间验方》<br>【原料】蜜炙黄芪250g生炒白术各100g熟地黄250g枸杞子250g玉竹250g白酒1500ml<br>【制作】1将所有药材洗净后研细碎，装入纱布袋中；2与白酒一起放入砂锅内，上火煎煮40分钟；3过滤去渣留液，入瓶备用。<br>【功效】补气养血，滋阴补肾。<br>【用法】每次10～20ml，每日1次，临睡前饮用。<br>【药材功效解析】玉竹：甘平之味，养阴生津，润肺养胃。黄芪：甘温益气。<br>白术：健脾助运。地黄：养血活血。枸杞子：补肝肾之阴。<br>此酒力缓，久饮对先天、后天不足有不可估量的疗效。主治诸虚百损，体弱无力，头晕目眩，胃纳不佳，腰膝酸软，男子阳萎、早泄，女子月经不调，崩漏带下，以及盆腔炎等症。<br>【宜忌】
葳蕤酒	葳蕤酒――（乳病）<br>（《普济方》）<br>【配方】葳蕤、升麻、荠、人参各三两，大黄（v炒）、栀子仁、芒硝、甘草（炙v）各二两，黄芩（去黑心）、葛根（v）、紫草（去芦头）、犀角（镑）各四两，银屑二两半，猪脂（腊月者）三两，露蜂房五两，大豆（浸曝干炒去皮）一合。<br>【制法】上将猪脂银屑外，罗为细末，以无灰酒二升，密封浸一宿，次将猪脂用好酒一升开，以银屑相和，研入前药酒内，更浸一宿。<br>【主治】治乳石发动，诸药不效。<br>【用法】每服取药一二盏饮之。<br>说明：《普济方》注书《圣济总录》。
葳蕤酒方	葳蕤酒方――（乳病）<br>（《圣济总录》）<br>【配方】葳蕤、升麻、荠、人参各三两，大黄（v炒）二两，黄芩（去黑心）、葛根（刺）、紫草（去芦头）、犀角（镑）各四两，栀子仁，芒硝各二两，银屑二两半，猪脂（腊月者）三两，露蜂房五两，甘草（炙v）二两，大豆（浸一宿暴干炒去皮一合）。<br>【制法】上一十六味，除猪脂银屑外，捣罗为细末，以无灰酒二升，密封渍经一宿，次将猪脂用好酒一升炼开，以银屑相研，入前药酒内更浸一宿。<br>【主治】乳石发动，诸药不效宜服。<br>【用法】每服以酒一二盏饮之。
卫矛酒	卫矛酒――（关节疼痛）<br>（《陕甘宁青中草药选》）<br>【配方】卫矛根3两，牛滕5钱，白酒1斤。<br>【制法】浸泡一周即可饮服。<br>【主治】关节炎。<br>【用法】每日早晚各服10-20毫升。
温脾酒	温脾酒――（胃脘痛）<br>（《杂病广要》）<br>【配方】干姜、甘草、大黄各30克，人参、制附子各20克，黄酒500克。<br>【制法】将上药共捣细，用酒浸于净瓶中，5日后开取，去渣备用。<br>【主治】脘腹冷痛，大便秘结或久痢。<br>【用法】每次温饮10-20毫升，每日早、晚各1次。
文仲大麻子酒方	文仲大麻子酒方――（脚气）<br>（《外台秘要》）<br>【配方】大麻子碎研）一升。<br>【制法】清酒三升渍三宿。<br>【主治】疗脚气上，脚肿，小腹痹。<br>【用法】温服随性，一方傅用大良。
沃实酒	沃实酒――（脚气）<br>（《普济方》）<br>【配方】牛蒡根三大升，枳实八两（炙），毛磁石一斤（绵裹），薏苡仁一升，玄参六两，乌蛇脯六两（炙），生地黄（切）二大升，乌豆（小粒者）一大升。<br>【制法】上细切，绢袋盛，以好无灰酒一大斗，浸三日。<br>【主治】疗脚气上生风毒疮。<br>【用法】任性多少饮之。
乌豆酒（二）	乌豆酒（二）――（水肿臌胀）<br>（《普济方》）<br>【配方】乌豆一升。<br>【制法】上以水五升，煮取三升汁，去滓，内酒五升，更取三升。<br>【主治】治身肿。<br>【用法】温三服，不瘥，再合服之。
乌豆酒（一）	乌豆酒（一）――（产后瘀血）<br><br>（《普济方》）<br>【配方】乌豆（选择令净）五升，清酒一斗半。<br>【制法】炒豆令烟向绕，投入酒中，看酒赤紫色，乃去豆。如中风口噤，即加鸡屎白二升，和熬投酒中。<br>【主治】破血去风，除气防热，产后两日，尤宜服之。<br>【用法】量性服之可，日三盏。<br>说明：原书方名“紫汤”，此名系笔者所命名。
乌鸡酒（二）	乌鸡酒（二）――（背强口噤）<br>（《圣济总录》）<br>【配方】乌y鸡（去毛嘴脚）1只，江米酒4公斤。<br>【制法】将鸡破肚去肠，以酒煮取1公斤，去渣。分三服。<br>【主治】体虚中风，背强口噤，舌硬不得语，目睛不转，烦热苦渴，或身重瘙痒。》<br>【用法】早、午、晚各1服，汗出即愈。
乌鸡酒（三）	乌鸡酒（三）――（跌打损伤）<br>（《普济方》）<br>【配方】乌鸡一双。<br>【制法】上合毛杵一千二百杵，好苦酒一升，相和得所。<br>【主治】治被笮，坠堕丹红，车碾马踏，牛觞胸腹破陷，四肢擢折，气闷欲死。<br>【用法】以新布摺病上，取药涂布，以干易，觉寒振欲吐，不可辄去药，须臾复上一双，少则再作，并以地黄酒佳。<br>说明：《普济方》注出“肘后方”，原书无方名，据用药及制法命名。
乌鸡酒（四）	乌鸡酒（四）――（背强口噤）<br>（《饮膳正要》）<br>【配方】乌雌鸡一只（Α⑾淳弧⑷コΧ牵。<br>【制法】上件以酒五升煮，取酒二升，去滓。<br>【主治】中风背强，舌直不得语，目睛不转，烦热。<br>【用法】分作三服，相继服之，汁尽无时，熬葱白、生姜粥投之，盖复取汁。
乌鸡酒方	乌鸡酒方――（背强口噤）<br>（《圣济总录》）<br>【配方】乌雌鸡（去毛嘴脚）一只。<br>【制法】上一味，破开去肠肚，以酒五斗，煮取二升。<br>【主治】中急风，背强口噤，舌直不得语，目睛不转，烦热苦渴，或身重，或身痒。<br>【用法】去滓分温服，相继服尽，汗出即愈。不汗者，用热生姜葱白稀粥投之，盖复取汗。又鸡肠肚勿去中屎，紧结两头，勿伤动，煮汁服之。
乌鸡酿酒方	乌鸡酿酒方――（风疾诸病）<br>（《普济方》）<br>【配方】乌鸡一双（其鸡先以笼养，用大麻子五升与鸡吃，吃尽即便将鸡去毛及肠胃净洗试干，将其肉碎v，毛即烧灰亦同酿酒），羌活二（三两），桂心二（三）两，牛膝四两去苗，芎二两，防风二两（去芦头），附子三两（炮裂去皮脐，萆　三两），熟干地黄四两，乌蛇六两，海桐皮五两，丹参四两，白胶香三两，地骨皮十两，五加皮十两，百灵藤十两，松节十两。<br>【制法】上件药都细v和匀，以水一石煎取五斗，与曲末如常法同酿酒。<br>【主治】风疾。<br>【用法】候熟即日饮三四盏，忌生冷、毒滑动风物。<br>说明：《普济方》注出“圣惠方”。
乌金浸酒方	乌金浸酒方――（风疾诸病）<br>（《太平圣惠方》）<br>【配方】黑豆（紧小者炒熟捣碎）二升，防风（去芦头）、桂心、附子（炮裂去皮脐）、羌活各二两，熟干地黄三两，乌鸡粪（雌者以大麻子喂笼七日后取粪）一两。<br>【制法】上件药，细v和匀，入于生绢袋中，用好酒二斗，于瓷瓮子中，重汤缓火，煮候药瓮子内有香气即止。<br>【主治】治风疾。<br>【用法】每日三度，温饮一小盏。
乌麻浸酒	乌麻浸酒――（痹证）<br>（《普济方》）<br>【配方】乌麻（即黑脂麻）五升。<br>【制法】取上味，熬碎之，酒一升浸一宿。<br>【主治】手脚酸痛兼微肿。<br>【用法】随多少饮之。
乌麻酒方（二）	乌麻酒方（二）――（悦色驻颜）<br>美好的容颜，悦泽的肤色，是身体强壮的重要标志。只有气血旺盛，精力充沛，心情舒畅，注重摄养，方能使人有面色光华，色等桃花，容如少女，青春常驻。以下介绍几种悦色驻颜类药酒。从入酒的药物来看，不外补虚驻颜，益气养血、祛风泽面之品。如果因病导致的面色不华，肤色不悦，还应积极找出原因，治疗本病为主。<br>（《太平圣惠方》）<br>【配方】乌麻子一斗。<br>【制法】上投水中，掠去浮者，九蒸九曝，炒令香，以木杵臼捣细，用生绢袋盛之，令极宽转，即结袋头，又以一细绳子接系袋处悬于瓮中，下无灰酒五斗，以新盆覆瓮，其盆底上钻一小窃，引出系袋绳头，又系于小横木子上，以泥固缝，莫使泄气。每日六七度引挽其绳，令药汁入于酒中，满七日药成，乃开瓮，举袋沥汁令尽，冬温夏冷。<br>【主治】除风气，令人充悦强壮。<br>【用法】随性饮之，不令至醉，若以此酒浸石斛丹参牛膝杜仲石英磁石等，补腰脚尤甚，末尽一剂，充悦倍常，亦无所忌。患风者宜用大麻子蒸热炒香，捣入袋中，一准乌麻法作，大良矣。
乌麻酒方（一）	乌麻酒方（一）――（脚气）<br>（《备急千金要方》）<br>【配方】乌麻（微熬捣碎）五升。<br>【制法】以酒一斗渍一宿。<br>【主治】治脚气。<br>【用法】随所能饮之，尽更作，甚良。<br>说明：《普济方》同上。原书无主治，“治脚气”是根据《普济方》所加。
乌木梢煎酒方	乌木梢煎酒方――（霍乱）<br>（《普济方》）<br>【配方】鸟木梢。<br>【制法】上为末，煎酒。<br>【主治】治霍乱病重。<br>【用法】饮服。<br>说明：方名为笔者所加。
乌梢蛇酒	乌梢蛇酒――（痹证）<br>（《本草纲目》）<br>【配方】乌梢蛇1条，好酒500克。<br>【制法】将乌梢蛇用酒浸泡3-4日后即成。或用乌蛇肉，袋盛，同曲置于缸底，糯饭盖之，3-7日酒熟，去渣贮酒即可。<br>【主治】风湿痹痛，肌肤麻木，骨、关节结核，小儿麻痹症，麻风，皮疹瘙痒，疥癣，破伤风。<br>【用法】每次服1-2杯，每日3次。
乌蛇浸酒方（二）	乌蛇浸酒方（二）――（白癜风）<br>（《普济方》）<br>【配方】乌蛇六两（酒浸去皮骨炙微黄），防风（去芦头）、桂心各二两，熟干地黄四两，白蒺藜二两（炒去刺），天麻三两，五加皮二两，羌活三两，牛膝（去苗），枳壳（麸炒微黄去瓤）各三两。<br>【制法】上细v，以生绢袋盛，以无灰酒二斗，于瓷瓮中浸，密封头，七日后开。<br>【主治】风及白癜紫癜。<br>【用法】每日三度温饮一小盏，忌毒滑物、猪、鸡肉。
乌蛇浸酒方（三）	乌蛇浸酒方（三）――（白癜风）<br>（《奇效良方》）<br>【配方】乌蛇180克，防风、桂心、白蒺藜、五加皮各60克，熟地黄120克，天麻、牛膝、枳壳、羌活各90克，无灰酒20升。<br>【制法】将上药研为粗末，以生绢袋盛之，悬于酒坛中，用酒浸之，坛口封固，7天后便可饮用。<br>【主治】白癜风，其表现为皮肤色素脱失而发生局部性白色斑片，其中的毛发亦变白，皮损的表面平滑，无鳞屑。可单发，亦可多发，有的可呈对称性，并有增大的趋势。损害边缘的颜色反可加深，变白的皮肤对日光敏感，一经日晒即会发红。<br>【用法】每次1小盅，日3，忌食毒性、粘滑食物及猪肉、鸡肉。<br>说明：乌蛇是游蛇科动物乌蛇除去内脏的干燥全体。同时，乌蛇需先去头，去鳞片，用黄酒闷透后，趁湿去骨刺，切段，再用文火炒至微黄色。
乌蛇浸酒方（一）	乌蛇浸酒方（一）――（白癜风）<br>白癜风又名“白驳风”。为局限性的皮肤色素脱失，皮肤出现白色斑片。多因风湿搏于皮肤，气血失和，血不荣肤所致。本病发无定处，可发于任何部位；多见于青壮年，亦见于儿童及老人。症见皮肤出现边缘清楚、大小不等的白色斑片。可以单发，亦可泛发。周围皮肤色较深，斑内毛发亦变白，部分白斑中央有褐色斑疹或淡红色丘疹，表现光滑，不痛不痒，经过缓慢，常常经久不退，但偶而亦有自行消退者。本病治疗以祛风胜湿，活血理气为治。治疗一般可服用白驳片，外用补骨脂酊搽擦。以下再介绍6种治疗本病的药酒，供选用。<br>（《太平圣惠方》）<br>【配方】乌蛇（酒浸去皮骨炙微黄）六两，防风（去芦头）二两，桂心二两，白蒺藜（炒去刺）二两，天麻三两，五加皮一两，羌活三两，牛膝（去苗）二两，枳壳（麸炒微黄去瓤）三两，熟干地黄四两。<br>【制法】上件药细v，以生绢袋盛，以无灰酒二斗，于瓷瓮中浸，密封七日后开。<br>【主治】治风及白癜紫癜。<br>【用法】每日三度，温饮一小盏，忌毒滑物猪鸡肉。
乌头浸酒	乌头浸酒――（痈疽、疮疡、发背）<br>（《普济方》）<br>【配方】乌头五枚，苦酒三升。<br>【制法】用乌头以苦酒浸三日。<br>【主治】治痈攻肿，若息肉突出者。<br>【用法】洗之，日三。<br>说明：苦酒实为米醋。
乌须酒	乌须酒<br>【来源】《寿世保元》<br>【原料】何首乌500g白首乌500g胡桃肉90g枸杞子60g莲子肉90g全当归60g生姜汁20g蜂蜜90g细曲300g生地120g麦冬30g糯米5kg<br>【制作】<br>1先将两种首乌洗净，用水煮过，捣烂；<br>2除生姜汁、蜂蜜外，其余药材捣为粗末与首乌一起装入白布袋，封口备用；<br>3将细曲捣成细末，备用；<br>4生地用酒洗净，放入煮首乌的水中去煮，等水渐干时，再用文火煨；<br>5待水汁尽后，取出捣烂备用；<br>6将糯米放入锅中，加水3000ml，放在文火上熬成粥状，然后倒入干净的坛子里；<br>7冷后加入细曲末，用柳枝拌匀，加盖密封，放在保温处酿制，待有酒浆时开封；<br>8将生地黄倒入酒糟中，用柳枝拌匀，加盖密封，3～5日后开封；<br>9压榨去糟渣，贮入干净的坛子里，再将药袋悬入酒中，加盖；<br>10将坛放入锅中，隔水加热约80分钟后取出，埋入土中；<br>11过5日将酒坛取出，开封，去掉药袋，将蜂蜜炼过，倒入药酒中，再细滤一遍，装瓶备用。<br>【功效】补肾养肝，益精血。<br>【用法】每次10～20ml，每日3次，将酒温热空腹服用。<br>【药材功效解析】何首乌、白首乌、枸杞子、胡桃肉、莲子肉、当归：补肾养肝，益精血。红枣：调和诸药，并有健脾作用。麦冬：滋阴润燥。<br>蜂蜜：调味，并能缓和酒性。此酒功效为补肾养肝，因肝肾精血不足而导致的腰膝酸软，体乏无力，精神萎靡，，食欲不振，面色憔悴，须发早白，大便秘结等症。<br>【宜忌】
乌药酒	乌药酒――（脚气）<br>（《普济方》）<br>【配方】土乌药（即矮樟树根）。<br>【制法】用土乌药，取如萝卜者，不用铁器，不须过水，干滤布揩净，用瓷片刮屑，收于瓷器内，如饮得酒一升，或半升，取出酒浸一宿，次日空心在热汤上坐。有麝香入少许尤妙。<br>【主治】治脚气发动，乡村无处问药。<br>【用法】温服，一服即安。无麝香则多服数服后，得溏泄病去。
吴茱萸根浸酒	吴茱萸根浸酒――（产后缺乳）<br><br>（《圣济总录》）<br>【配方】吴茱萸根（粗者）1尺，麻子50克，陈皮70克，酒1公斤。<br>【制法】将吴茱萸根切碎、捣陈皮、麻子为泥，然后拌入吴茱萸根，用酒浸1宿后，慢火上微煎，去渣，贮瓶。<br>【主治】产后虚弱，大便秘结，呕吐涎沫，头额冷痛，蛲虫搔痒。<br>【用法】分作5份，空心温服。
吴茱萸浸酒	吴茱萸浸酒――（产后虚损）<br><br>（《普济方》）<br>【配方】吴茱萸三两，清酒三升。<br>【制法】以清酒渍吴茱萸一宿，煮如蚁鼻沸，减得二升许，中分之。<br>【主治】治产后虚赢、盗汗，啬啬恶寒。亦治产后腹中疼痛。<br>【用法】顿服一升，日再，间日再作服。<br>说明：方名系笔者所加。《普济方》注本方书“千金方”。
五加酒方（二）	五加酒方（二）――（痿证）<br>（《备急千金要方》）<br>【配方】五加皮、枸杞皮各二升，干地黄、丹参各八两，杜仲、石膏（一方作石床）各一斤，干姜四两，附子三两。<br>【制法】上八味口父咀，以清酒二斗渍三宿。<br>【主治】肉虚坐不安席、好动，主脾病，寒气所伤。<br>【用法】一服七合，日再。
五加酒方（一）	五加酒方（一）――（产后虚损）<br><br>（《备急千金要方》）<br>【配方】五加皮、枸杞子各二升，干地黄、丹参各二两，杜仲一斤，干姜三两，天门冬四两，蛇床子一升，乳床半斤。<br>【制法】上九味口父咀，以绢袋子盛，酒三斗渍三宿。<br>【主治】治产后癖瘦，玉门冷。<br>【用法】一服五合，日再，稍加至十合佳。<br>说明：《普济方》名“五加皮酒”，方中前两味药各一斤，乳床作乱发半斤，余同上。
五加皮浸酒方（二）	五加皮浸酒方（二）――（腰脚疼痛诸病）<br>（《奇效良方》）<br>【配方】五加皮、熟地黄各三两，枳壳（麸炒）、防风、干姜（炮）各一两，独活、地骨皮、牛膝（去苗）、乌啄（炮裂，去皮脐）、石楠叶各二两，丹参一两，虎胫骨（酥炙）五两，清酒二斗。<br>【制法】将上药细v，以生绢袋盛，入浸于瓷瓶中浸之，密封七日即成。<br>【主治】风毒气攻腰脚，连骨髓，日夜疼痛。<br>【用法】每日三五度，温饮一小盏，常令醺醺，以瘥为度。
五加皮浸酒方（四）	五加皮浸酒方（四）――（腰脚疼痛诸病）<br>（《太平圣惠方》）<br>【配方】五加皮、熟干地黄各三两，枳壳（麸炒微黄去瓤）、防风（去芦头）、干姜（炮裂v）各一两，独活一分（二两），地骨皮、牛膝（去苗）、乌啄（炮裂去皮脐）、石南叶各二两，丹参一两半，虎胫骨（涂酥炙微黄）五两。<br>【制法】上药细v，以生绢袋盛，用清酒二斗于瓷瓶中浸，密封七日后开。<br>【主治】风毒气攻腰脚，连骨髓，日夜疼痛。<br>【用法】每日三五度，温饮一小盏，常令醺醺，以差为度。
五加皮浸酒方（一）	五加皮浸酒方（一）――（产后虚损）<br><br>（《妇人大全良方》）<br>【配方】五加皮、干姜、丹参、蛇床子、熟地黄、杜仲（制）各三两，钟乳粉四两，天门冬一两，地骨皮二两。<br>【制法】上细v，以生绢袋盛，用酒十五升，渍二宿。<br>【主治】疗妇人癖瘦阴冷。<br>【用法】每服温一中盏，空心、晚食前各一服。
五加皮酒（二）	五加皮酒（二）――（关节疼痛）<br>（《陕甘宁青中草药选》）<br>【配方】穿山龙、白鲜皮、五加皮各5钱。<br>【制法】浸泡24小时后服用。<br>【主治】风湿性关节炎，关节拘挛疼痛。<br>【用法】每天服10毫升，日服1次。
五加皮酒（六）	五加皮酒（六）――（痹证）<br>（《扶寿精方》）<br>【配方】五加皮一斤。<br>【制法】以好酒一金华坛煮滚，入五加皮。<br>【主治】胜湿益人。<br>【用法】不拘时饮。
五加皮酒（七）	五加皮酒（七）――（脚气）<br>（《普济方》）<br>【配方】五加皮三两，薏苡仁五两，羚羊角三两，生干地黄半斤，防风三（一）两（去芦）独活三两，牛蒡根半斤（去皮），桂心一两，牛膝五两（去苗），黑豆半斤（炒熟），海桐皮一两，大麻仁半两。<br>【制法】上v，用生绢袋盛，以酒三斗，浸六七日。<br>【主治】脚气发动，烦热疼痛，筋脉拘急，行履不得。<br>【用法】每于食前，随性暖服。<br>说明：《普济方》注出《太平圣惠方》。
五加皮酒（三）	五加皮酒（三）――（痿证）<br>（《本草纲目》）<br>【配方】五加皮150克，当归100克，地榆30克，川牛膝60克，曲200克，糯米5.5公斤。<br>【制法】将五加皮煎汁，和曲、米如常法酿成酒，再把当归、川牛膝、地榆浸酒中煮数百沸，去渣，贮存。<br>【主治】湿邪偏胜，下肢痿弱，脚气浮肿，腰膝酸痛，骨节拘挛、阳痿精寒，皮水肿满，小便不利。<br>【用法】每次饮15-20毫升，每日3次。<br>说明：阴虚火旺者不宜用。
五加皮酒（四）	五加皮酒（四）――（筋骨诸病）<br>（《清太医院配方》）<br>【配方】当归、玫瑰、栀子、白蔻各6克，五加皮、红花各7.5克，佛手、黄柏、甘草、白芷、菊花、知母、木瓜、官桂、陈皮、丁香各3克，玉竹150克，木香2.4克，酒酿2000克，密300克，白糖500克。<br>【制法】用烧酒一坛，加酒酿，密，白糖及上述各药，密封浸泡10天即得。<br>【主治】慢性风湿，筋骨无力，肝胃不和，食少脘痞，两胁胀痛及小便不利等症。<br>【用法】适量饮用。
五加皮酒（一）	五加皮酒（一）――（痿证）<br>（《本草纲目》）<br>【配方】五加皮32克，曲50克，大米100克，当归、牛膝、地榆各20克，白酒1000毫升。<br>【制法】先将五加皮、当归、牛膝、地榆入锅加水煎汁，用纱布过滤备用；将大米煮半熟沥干，和药汁混匀蒸熟，再拌以酒曲，入瓷瓶内，周围保温，待发酵后，酒甜可口即可服用。亦可将群药切碎浸泡于酒内10天后服用。<br>【主治】一切风湿痿痹。有壮筋骨，填精髓之功。<br>【用法】每服20-30毫升，日服2次。
五加皮酒方（二）	五加皮酒方（二）――（痹证）<br>（《太平圣惠方》）<br>【配方】五加皮（细v）一升。<br>【制法】上以清酒一斗，渍十日。<br>【主治】风痹不仁，四肢挛急疼痛。<br>【用法】温服一中盏，日三服，亦可与术地黄各二十斤，细v，以水一矾五斗，煮取一硕，以渍细曲十斤，黍米一硕，净淘炊熟，都拌扣入瓮，盖覆如法，候熟，任性饮之，不令至醉。
五加皮酒方（三）	五加皮酒方（三）――（脚气）<br>（《太平圣惠方》）<br>【配方】五加皮、羚羊角屑、防风（去芦头）、独活各三两，薏苡仁、牛膝（去苗）各五两，生干地黄、牛蒡根（去皮）、黑豆（炒熟）各半斤，桂心一两，海桐皮二两，大麻仁半两。<br>【制法】上药v，用生绢袋盛，以无灰酒三斗，浸六七日。<br>【主治】治脚气发动，烦热疼痛，筋脉拘急，行李不得。<br>【用法】每于食前，随性暖服。
五加皮酒方（一）	五加皮酒方（一）――（筋骨诸病）<br>（《圣济总录》）<br>【配方】五加皮五两，枳刺二两，猪椒根皮（去土）、丹参各三两，桂（去粗皮）、当归（切焙）、甘草（炙）各一两，天雄（炮裂去皮脐）三分，秦椒（去目及闭口者炒出汗）、白鲜皮、木通各一两一分、川芎、干姜（炮）各三分，薏苡仁半两，大麻仁三两。<br>【制法】上一十五味细v，以生绢袋贮之，以酒一斗浸，春夏四宿，秋冬六宿。<br>【主治】筋虚极善悲，颜色苍白，手足拘挛，举动缩急，腹中转痛。<br>【用法】空腹温服半盏，渐加至一盏，以差为度。
五加皮醪	五加皮醪――（关节疼痛）<br>（验方）<br>【配方】南五加皮50克，糯米500克。<br>【制法】南五加皮洗净，加水适量泡透煎煮，每30分钟取煎液一次，共取两次。再净煎液与糯米共同烧煮，做成糯米干饭，待冷，加酒曲适量，拌匀，发酵成为酒酿。<br>【主治】祛风湿，强筋骨，可治风湿性关节炎。<br>【用法】每日适量佐餐食用。
五粒松酒方	五粒松酒方――（风疾诸病）<br>（《外台秘要》）<br>【配方】黄芪、独活、秦艽、芎、防风各二两，五粒松叶（大叶）七斤，麻黄（去节）七两，牛膝四两，生地黄一斤。<br>【制法】上九味切，以无灰清酒四大斗渍，春七日，冬二十日，夏五日。日二、三度。<br>【主治】疗一切风。<br>【用法】日二三度服。<br>说明：《普济方》载本方五粒松叶为七片。谓冬十月以此酒服，大治诸风。用法：取酒六合服之，忌如药法。
五粒松叶浸酒方	五粒松叶浸酒方――（风疾诸病）<br>（《太平圣惠方》）<br>【配方】五粒松叶（十月初采）三斤，麻黄（去根节）、防风（去芦头）、独活、肉桂（去皱皮）各三两，天雄（炮裂去皮脐）一两，春艽（去苗）二两，牛膝（去苗）四两，生地黄二（一）斤。<br>【制法】上药细v和匀，以生绢袋盛，用好酒四斗浸之，春秋七日，冬二七日，夏五日。<br>【主治】治风。<br>【用法】日满每服温一小盏，日三服，忌毒滑动风物。
五味子酒（二）	五味子酒（二）――（失眠）<br>（《陕甘宁青中草药选》）<br>【配方】五味子200克，白酒400毫升。<br>【制法】浸泡7日后服用。<br>【主治】治失眠。<br>【用法】每服10毫升，日服2次。
五味子酒（一）	五味子酒（一）――（失眠）<br>（《药膳食谱集锦》）<br>【配方】五味子50克，白酒500毫升。<br>【制法】将五味子洗净，装入玻璃瓶中，加入酒浸泡，瓶口密封，浸泡期间，每日振摇1次，浸足半个月后即可饮用。<br>【主治】神经衰弱，失眠，头晕，心悸，健忘，烦躁等症。<br>【用法】每次饮3毫升，每日3次。
五香酒料	五香酒料――（腹胀腹痛）<br>（《清太医院配方》）<br>【配方】甘草、菊花、甘松、官桂、白芷、藿香、三柰、青皮、薄荷、檀香、砂仁、丁香、大茴香各120克，细辛、红曲、木香各18克，干姜12克，小茴香15克，烧酒9公斤。<br>【制法】将上药用绢袋盛好，浸入多年陈存的烧酒中，密封10天后可用。<br>【主治】脾胃气滞，虚寒脘满，食欲不振等症，并可用于寒凝气滞的小肠疝气及暑月感受风寒等症。<br>【用法】每日早、晚各饮1-2盅。<br>说明：忌食生冷、油腻食物。
五枝酒方	五枝酒方――（手足不遂）<br>（《太平圣惠方》）<br>【配方】夜合枝，花桑枝、槐枝、柏枝、石榴枝（以上并取东南嫩者v）各半斤，防风（去芦头）、羌活各十两，糯米五斗，小麦曲（末）五斤，黑豆（择紧小者）二斗。<br>【制法】上五枝用水一硕，煎取三斗，去滓，澄滤浸米及豆，二宿，滤出蒸熟，后更于药汁内入曲，并防风羌活等末，同搅和入瓮，如法盖覆。<br>【主治】治中风，手足不遂，筋骨挛急。<br>【用法】候酒熟时，饮一盏，常令醺醺，甚有大效。
五子酒	五子酒<br>【来源】经验方<br>【原料】覆盆子60克，楮实子60克，菟丝子60克，金樱子60克，枸杞子60克，桑螵蛸60克，白酒2.5升。<br>【制作】将上述各药加工细碎，用绢袋盛，扎紧口，悬于小坛内。将白酒倒入小坛，加盖密封置阴凉处。每日摇动数下，经49日后开封，除去药袋，用细纱布过滤一遍，收贮净瓶中。<br>【功效】补肝肾，益精髓，固精耕细作气，缩遗尿，明晴目。适应症因肝肾虚损而腰膝冷痛，软弱无力，阳痿，遗精，滑精及小便频数，视物模糊，耳鸣，妇女白带经久不止等症。<br>【用法】每日早、晚各一次，每次服用10-15毫升。药渣爆干为末，每次用药酒冲服5克。<br>【注意事项】此酒不适宜长期饮服，病愈则止。
戊戌酒（二）	戊戌酒（二）――（阳萎）<br>（《本草纲目》）<br>【配方】小黄狗1只，曲30克，糯米7.5公斤。<br>【制法】将狗去内脏，洗净，煮烂，连汁和曲、米如常法酿酒。<br>【主治】肾阳虚损，少腹冷痛，不孕，阳萎，腰膝酸痛。<br>【用法】每次空腹饮2-3小杯，每日3次。<br>说明：其性大热，阴虚内热之病人不宜饮用。
细辛独活酒	细辛独活酒――（牙痛）<br>（《圣济总录》）<br>【配方】独活、莽草、防风、细辛各15克，制附子6克，酒250克。<br>【制法】将上药碎细，以酒煮数十10沸，去渣。<br>【主治】牙齿肿痛。<br>【用法】热漱，以愈为止。
虾米酒	虾米酒――（产后缺乳）<br><br>（《本草纲目》）<br>【配方】虾米、黄酒各500克。<br>【制法】将净肉捣烂为膏，每用2勺，调黄酒1杯。<br>【主治】妇女乳腺不通。<br>【用法】每温1杯，每日3次。
夏英公酒浸饮子	夏英公酒浸饮子――（风疾诸病）<br>（《普济方》）<br>【配方】防风（细v）、萆　、羌活、秦艽、牛膝、败龟、虎骨、桔梗、晚蚕沙（炒黄）各二两，苍耳五升（去刺槌碎酥炙），干茄根八两（洗v蒸），枸杞子（炒）五两。<br>【制法】上十二味，用好酒三斗浸，瓶盛封蔽，二七日开，不得向面，恐气冲头目。<br>【主治】风疾。<br>【用法】每日空心，午时及早晨，各服一盏，常令有酒气，一月、除一切风毒湿痹瘫痪等疾。
仙酒方（二）	仙酒方（二）――（癞病）<br>（《普济方》）<br>【配方】川牛膝（洗净）一斤，秦艽<br>（洗净切）一两，枸杞子（洗净）二两，蚕沙（洗净）二两，牛蒡子（炒）一升，桔梗（洗）二两，苍术（去皮蒸烂用）二斤，地黄一两（洗）八钱，当归（洗净用）一两八钱，天麻（洗净）五两。<br>【制法】上用无灰糯酒二斗，以前药于净磁缸内浸，用七重净白纸，密封七日，勿用妇人，封取药成，若用时，人面勿得于缸内觑。<br>【主治】大风，手足拳挛，半身不遂。<br>【用法】每酒一盏，日进三服，年深重风，不过二斗，忌湿面等物，常每日一服。
仙酒方（三）	仙酒方（三）――（癞病）<br>（《三因极一病证方论》）<br>【配方】牛蒡根、牛膝各一斤，秦艽、鼠黏子各二两，枸杞子（炒）一斗，苍术（蒸烂）二斤，防风、蚕沙各二两，大麻子（炒，别研去壳）一升，桔梗、羌活各二两。<br>【制法】上为v散，无灰酒二斗，净瓮器内浸，密封，七日开，开时不得对瓶口。<br>【主治】治大风及偏风一切风疾，延年益寿。<br>【用法】日进三服，每服大盏，温服，常令面有酒色，甚者不过一斗，忌面食并鱼肉动风物。
仙酒方（四）	仙酒方（四）――（半身不遂）<br>（《扶寿精方》）<br>【配方】天麻半斤，当归三两，枳壳（正方见下）二两，枸杞二升，牛蒡子半斤，牛蒡根一斤，天麻子一升，牛膝、秦艽、苍术（去皮，米泔浸，瓦器蒸熟）、羌活、防风、桔梗、晚蚕沙各二两。<br>【制法】上为粗末，无灰酒二三斗，瓦坛浸七日，勿令面近酒，恐气触目有伤。<br>【主治】手足拘挛，半身不遂。<br>【用法】每日空心午夜，各温进一杯，忌鱼面三个月。
仙灵脾浸酒方（二）	仙灵脾浸酒方（二）――（半身不遂）<br>（《太平圣惠方》）<br>【配方】仙灵脾（好者）一斤。<br>【制法】上细v，以生绢袋盛，于不津器中，用无灰酒二豆+斗浸之，以厚纸重重密封，不得通气，春夏三日，秋冬五日，后旋开取。<br>【主治】偏风，手足不遂，皮肤不仁。<br>【用法】每日随性饮之，常令醺醺，不得大醉，若酒尽，再合服之，无不效验，合时切忌鸡犬见。<br>说明：《普济方》同上。
仙灵脾浸酒方（三）	仙灵脾浸酒方（三）――（半身不遂）<br>（《太平圣惠方》）<br>【配方】仙灵脾一两，天麻一两，独活一两，天雄（炮裂去皮脐）一两，牛膝（去苗）一两，桂心一两半，当归一两，五加皮一两，芎一两，石斛（去根）一两半，茵芋一两，萆　一两，狗脊一两，海桐皮一两，虎胫骨（涂酥炙令黄）二两，鼠黏子一两，苍耳子一两，川椒（去闭口及目微炒去汗）一两。<br>【制法】上诸药，细v，以生绢袋盛，用好酒二豆+斗浸之，密封，经七日后用之。<br>【主治】中风半身不遂，肢节疼痛无力。<br>【用法】每日不计时候，温服一小盏，常令酒气相续，其酒出一盏入一盏，以药味薄即止。<br>说明：《普济方》同上。
仙灵脾浸酒方（一）	仙灵脾浸酒方（一）――（痹证）<br>（《太平圣惠方》）<br>【配方】仙灵脾二两，牛膝（去苗）二两，附子（炮裂去皮脐）二两，石南叶一（二）两，杜仲（去粗皮微炙）二两。<br>【制法】上诸药细v，以生绢袋盛，用好酒一斗五升，浸经七日。<br>【主治】妇人风痹，手足不随。<br>【用法】每服温饮一小盏。<br>说明：《普济方》同上
仙灵脾酒（二）	仙灵脾酒（二）――（阳萎）<br>（《本草纲目》）<br>【配方】淫羊藿一斤。<br>【制法】以酒一斗浸三日。<br>【主治】益丈夫兴阳，理腰膝冷。<br>【用法】逐时饮之。<br>说明：本方见《本草纲目》卷十二淫羊藿条引食医心镜。卷二十五附诸药酒条引圣惠方仙灵脾酒：治偏风不遂，强筋坚骨，仙灵脾一斤，袋盛，浸无灰酒二斗密封三日，饮之。
仙灵脾酒（三）	仙灵脾酒（三）――（阳萎）<br>（验方）<br>【配方】仙灵脾60克，白酒500克。<br>【制法】将仙灵脾装入纱布袋中，浸泡在酒内封固三日后，即可饮用。<br>【主治】祛风，益肝肾，强筋骨。适用于阴阳两损，命门火衰而引起的男子阳萎，女子不孕，四肢不仁。<br>【用法】每晚睡前饮一小杯。
仙灵脾酒（一）	仙灵脾酒（一）――（半身不遂）<br>（《本草纲目》）<br>【配方】仙灵脾500克，无灰酒2500毫升。<br>【制法】将仙灵脾切寸段，浸泡于酒内，3日后可服用。<br>【主治】半身不遂，筋瘘骨弱。<br>【用法】每服20-30毫升，日服2-3次。
仙茅加皮酒	仙茅加皮酒――（阳萎）<br>阳萎系指男子阴茎不举，或举而不坚、不久，不能完成房事。病名见于《景岳全书・杂证谟》，在《内经》邪气藏府病形等篇中名曰阴痿。阳萎可由肝气郁结、肝胆湿热、大卒惊恐和命门火衰等所致，适合于药酒疗法的，主要是命门火衰、下元虚疲的患者。对于遗精、早泄及女子宫冷不孕、性欲冷淡的患者，只要是属于肾阳虚引起的，亦可饮用本药酒。本类药酒常用的药物有：仙茅、淫羊藿、熟地黄、钟乳、薯蓣、附子、菟丝子、人参、肉从蓉、天门冬、牛膝、巴戟天、枸杞子、山萸肉、覆盆子、石菖蒲、远志肉、龙眼肉、大虾、白术、破故纸、小茴香、母丁香、海狗肾、海马、茯苓、蛤蚧、鹿茸、蜈蚣等。<br>（《万病回春》）<br>【配方】仙茅（用米泔水浸，去赤水尽，晒干）90克，淫羊藿（洗净）120克，五加皮（酒洗净）90克，醇酒1小坛。<br>【制法】将上药碎细，包贮，悬于酒坛中，封口，浸7日即可饮用。<br>【主治】腰膝筋脉拘急，肌肤麻木，关节不利，阳萎，子宫寒冷不孕。<br>【用法】每日早、晚各饮1-2杯，甚效。
仙茅酒	仙茅酒――（阳萎）<br>（《本草纲目》）<br>【配方】仙茅。<br>【制法】上药九蒸九晒，浸酒。<br>【主治】精气虚寒，阳萎膝弱，腰痛痹缓，诸虚之病。<br>【用法】饮之。<br>说明：本方见《本草纲目》卷二十五附诸药酒条下。
仙茅酒（二）	仙茅酒（二）――（阳萎）<br>（《本草纲目》）<br>【配方】仙茅120克，酒0.5公斤。<br>【制法】将上药九蒸九晒后，置于净器中，入酒浸泡，封口，7日后即可开取饮用。<br>【主治】阳萎滑精，腰膝冷痛，男子精寒，女子宫冷不孕，老年遗尿，小便余沥。<br>【用法】每日早、晚各空心饮15-20毫升。<br>说明：相火旺盛者不宜用。
仙茅酒（一）	仙茅酒（一）――（阳萎）<br>（《妙一斋医学正印种子编》）<br>【配方】仙茅（米泔水浸）、淫羊藿、五加皮各120克，龙眼肉一百枚，白酒9公斤。<br>【制法】将上药切片，装入绢袋，浸于酒中，21天后启用。<br>【主治】阳萎而兼腰膝酸软，精液清冷，小便清长，手足不温，或见食少，睡眠不实等症。舌苔多白润，脉沉迟。<br>【用法】每次饮10毫升，早、晚各服1次。<br>说明：如见五心烦热，小便黄赤，舌红少苔，脉细数是阴虚有热的表现，禁用此酒。
仙人掌草方	仙人掌草方――（肠风）<br>肠风为便血的一种，指因外感得之，血清而色鲜，多在粪前，自大肠气分而来的便血。临床所见多为实证，常用凉血泻热，息风宁血法治疗，药酒亦不离此原则。因酒性偏热，故较少用于本病，这里选录的三种配方，可根据情选用。<br>（《普济方》）<br>【配方】仙人掌草二斤。<br>【制法】与甘草浸酒。<br>【主治】治肠风下血。<br>【用法】饮之。
仙人杖浸酒方	仙人杖浸酒方――（痿证）<br>（《圣济总录》）<br>【配方】仙人杖根（刮洗去土皮v枸杞根白皮是也）一斤四两。<br>【制法】上一味，用生绢囊贮，以酒二斗浸七日。<br>【主治】柔风脚膝痿弱，久积风毒，上冲有膊胸背疼痛。妇人产后中风。兼治一切热毒风。<br>【用法】每日温饮一盏，至一两，不拘时，酒欲尽，再入五升，依前浸服。
香豉酒方	香豉酒方――（脚气）<br>（《外台秘要》）<br>【配方】香豉一斗。<br>【制法】上升以酒三斗，浸三日。<br>【主治】疗脚气。<br>【用法】取饮任性多少，利即减之，不利任性，其中用橘皮生姜调适香味，任意服尽复作，以瘥为度。<br>说明：①《圣济总录》主治脚气冲心，余同。②《普济方》主治脚气冲心，兼治瘴毒脚气，及和腰脚除湿痹，去心神烦闷，岭南常服，极效。
香附根酒	香附根酒――（胁痛）<br>（《中国医学大辞典》）<br>【配方】香附根60克。<br>【制法】将香附根洗净切碎，用水、白酒各250克，浸泡3-5日，去渣。<br>【主治】胸肋胀痛，脘痛疼痛，食欲不振，月经不调，乳房胀痛，心中郁闷。<br>【用法】频频饮之，不拘时候。
香犀酒	香犀酒――（脚气）<br>（《普济方》）<br>【配方】香豉三升，犀角八两（v末）。<br>【制法】上香豉如前，不能九蒸九曝，三蒸三曝亦得，用一生绢袋贮，用好美酒渍之，五日，其犀角末散着袋外。<br>【主治】脚气。<br>【用法】每服常搅，令犀角末入酒中，服三合，量性增减，日三服，其酒夏月初作，多恐坏，不耐久，可用此方，豉三合，橘皮、生姜、葱细切，任意调和，先熬油令香熟，次下诸物煎熟，以绵裹，纳铛中著酒，任性饮之。
小黄芪酒	小黄芪酒――（痰证）<br>痰证是因痰湿停滞体内而表现出来的病证，因其所停部位不同，表现亦不一样，痰滞在肺可见喘咳咯痰；痰滞在心，可见胸闷心悸；痰迷心窍，可见痴呆、神昏；痰停于胃，可见呕吐恶心，痰在经络筋骨，可见瘰疠痰核，肢体麻木，半身不遂等。临床又分寒痰、热痰、湿痰，燥痰、风痰等不同类型。<br>历代治疗本病所用药酒，有以祛风散寒、扶正固本为主者，常用黄芪、附子、防风、牛膝等药，如小黄耆酒；有以消痰下气为主者，常用苏子，如苏子酒；有以燥湿健脾为主者，如苍术酒；有以清热滋阴为主者，如玉露酒。<br>（《备急千金要方》）<br>【配方】黄芪、附子、蜀椒、防风、牛膝、细辛、桂心、独活、白术、芎、甘草各三两，秦艽、乌头（集验用署预三两）、大黄葛根、干姜、山茱萸各二两，当归二两半。<br>【制法】上十八味咀，少壮人无所熬练，虚劳人微熬之，以绢袋中盛，清酒二斗渍之，春夏五日，秋冬七日。大虚加蓰蓉二两，下痢加女萎三两，多忘加石斛、菖蒲、紫石各二两，心下多水者，加茯苓、人参各二两，署预三两。酒尽，可更以酒二斗重渍滓。<br>【主治】大治风虚痰癖，四肢偏枯两脚弱，手不能上头，或小腹缩痛，胁下挛急，心下有伏水，胁下有积饮，夜喜梦，悲愁不乐，恍惚善忘，此由风虚五脏受邪所致，或久座腰痛，耳聋卒起，眼眩头重，或举体流肿痛痹，饮食恶冷，　　恶寒，胸中痰满心下寒疝，药皆主之，及妇人产后余疾，风虚积冷不除。此药攻痹甚佳，服一剂得力，令人耐寒冷补虚，治诸风神良。<br>【用法】先食服一合，不知，可至四五合，日三服，服后小热宜冷饮食。服之不尔，可暴滓捣，下酒服方寸匕，不知，稍增之。<br>说明：《普济方》无乌头，余同上。
小茴香酒	小茴香酒――（白浊）<br>白浊有溺浊和精浊之分，前者指小便色白混浊（见《诸病源候论・虚劳小便白浊候》，后者指尿道口常滴出白色浊物，小便涩痛明显，但尿不混浊（见《证治要诀》。小茴香酒治疗的是精浊属精道感受风寒者。<br>（《医林改错》）<br>【配方】小茴香（炒黄，为粗末）一两。<br>【制法】上件用黄酒半斤烧滚冲，停一刻，去渣。<br>【主治】治白浊，俗名骗白，又名下淋，精道受风寒，汤药全不效。<br>【用法】服酒。
小芥子酒方	小芥子酒方――（哮喘）<br>（《外台秘要》）<br>【配方】小芥子（捣碎）一升。<br>【制法】以绢袋盛，好酒二升浸之七日。<br>【主治】疗气喘。<br>【用法】空腹温服三合，日二服，渐渐加之，以知为度，酒尽旋旋添之，无所忌。
小品桃皮酒	小品桃皮酒――（水肿臌胀）<br>（《外台秘要》）<br>【配方】桃皮（削去黑，取黄皮）三斤，女曲、秫米各一升。<br>【制法】上三味，以水斗，煮桃皮令得一升，以五升汁渍女曲，五升汁饭，酿如酒法，熟漉去滓。<br>【主治】疗水肿，以体中有热为候，小便多者即是，病去便愈。<br>【用法】服一合，日三，耐酒者增之，忌生冷酒面一切毒物。
小品正朝屠苏酒	小品正朝屠苏酒――（疫毒）<br>（《肘后备急方》）<br>【配方】大黄、川椒各五分，水桂三分，桔梗四分，乌头一分，菝葜二分。<br>【制法】上七物细切，以绢囊贮之，十二月晦日正中时悬置井中至泥，正晓拜庆前出之，正旦取药置酒中。<br>【主治】令人不病温疫。<br>【用法】屠苏饮之。
小叶杜鹃酒	小叶杜鹃酒――（哮喘）<br>哮以突然发作，呼吸喘促，喉间哮鸣有声为特征；喘以气息迫促为主要表现。哮必兼喘，故哮病又称为哮喘。喘可见于多种急、慢性病程中，当其成为这些疾病某一阶段的主证时，即称作喘证。哮喘有发作期和缓解期，一般在发作期较少用药酒治疗，以缓解期用之为多。在我国古代，较少用药酒治疗哮喘，在防治慢性气管炎、哮喘、肺心病的过程中，人们发现，药酒亦不失为治疗哮喘的一个有效手段，值得努力发掘。但应注意，对某些酒哮者或对酒过敏者，不宜用药酒治疗。<br>（《陕甘宁青中草药选》）<br>【配方】小叶杜鹃（干品）2两，白酒1斤。<br>【制法】浸泡7日后，去渣服用。<br>【主治】慢性气管炎，哮喘。<br>【用法】每服10毫升，日服2次。
缬草酒	缬草酒――（失眠）<br>（《陕甘宁青中草药选》）<br>【配方】缬草1两，白酒5两。<br>【制法】浸泡48时后服用。<br>【主治】神经衰弱，心悸。<br>【用法】分7日服。
杏仁酒摩方	杏仁酒摩方――（破伤风）<br>（《圣济总录》）<br>【配方】杏仁（碎研生用不去皮类）三斤。<br>【制法】上一味，蒸令一馈久，更研令极细，入酒三升，绞取汁。<br>【主治】治金疮中风，角弓反张。<br>【用法】每服五合，日二夜一。汗出慎外风即愈，兼将杏仁酒汁摩疮上。<br>说明：《普济方》同上。
杏枝酒	杏枝酒――（跌打损伤）<br>（《普济方》）<br>【配方】杏枝一握。<br>【制法】以水一大升，煮半升，酒三合。一方取东引杏枝三两，细v，微熬好酒二升，煎汁数沸去滓温，分二服，如人行二三里再服。<br>【主治】治坠伤及坠马损，损疼、血在内烦闷。<br>【用法】分再服。<br>说明：《普济方》云：“出圣惠方”。《太平圣惠方》载“杏枝酒”以“东引杏枝不限多少，细v，以酒一大盏，煎至五分，去滓。每服半两，每于食前温服。治马坠”。
芎酒方（二）	芎　酒方（二）――（口眼?斜）<br>（《圣济总录》）<br>【配方】芎、羌活（去芦头）、莽草、细辛（去苗叶）、甘草（炙v）各一两，黑豆（炒）二合。<br>【制法】上六味，粗捣筛，分作八帖，每帖以酒一升，煎取五合。<br>【主治】治热毒风攻口面?斜，及偏风。<br>【用法】热含漱，咽亦无妨。<br>说明：《普济方》同上。
雄黑豆酒方	雄黑豆酒方――（背强口噤）<br>（《太平圣惠方》）<br>【配方】雄黑豆（小紧者是）三合，鸡龚白二合。<br>【制法】上诸药，先炒豆声欲绝，入鸡龚白同炒令黄，投酒五升，后去滓。<br>【主治】妇人中风口噤迷闷。<br>【用法】每服一小盏，拗开口灌之。<br>说明：《普济方》一方同上。
雄鸡酒	雄鸡酒――（补益增白）<br>皮肤白皙嫩鲜，取决于人体气血的强弱。产后、病后往往可使人气血亏损，皮肤颜色萎黄无华。采取益气养血的方法则可使之肌肤丰满，恢复正常，达到补益增白的作用。以下介绍两种药酒。其中入酒的药品有黑雄鸡、肥地黄、糯米等，均是补养气血的精品。以此制成的补酒，想必会达到补益增白美容的效果。<br>（《普济方》）<br>【配方】黑雄鸡（理如食法，和五味炒熟香）。<br>【制法】上即投二升酒中，封口，经宿取饮。<br>【主治】治新产妇，令大肥白。<br>【用法】饮之。<br>说明：方名系作者所命名。
续筋接骨酒	续筋接骨酒――（跌打损伤）<br>（验方）<br>【配方】透骨草、大黄、当归、芍药各10克，丹皮6克，生地15克，土狗（捶碎）10个，土虱30个，红花10克，自然铜（末）3克，好酒350毫升。<br>【制法】将上药，除自然铜外，其余粗碎，用酒煎取1半，去渣，候温，分作3份。<br>【主治】跌伤、打伤。<br>【用法】每日用1份药酒，送服自然铜末1克。
玄参酒（二）	玄参酒（二）――（瘰疠）<br>（《普济方》）<br>【配方】玄参（又名馥草）。<br>【制法】酒渍。<br>【主治】疗诸毒鼠瘘。<br>【用法】饮之。<br>说明：原书无方名，据药味命名。《普济方》注出“本草”。
玄参酒（一）	玄参酒（一）――（瘰疠）<br>（《圣济总录》）<br>【配方】玄参（细v）三斤，磁石（烧令赤醋淬七遍细研水飞）三斤。<br>【制法】上二味，以生绢袋盛，酒三斗，浸六七日。<br>【主治】治瘰疠寒热，先从颈腋诸处起者。<br>【用法】每服一盏，空心临卧温服。
玄胡酒	玄胡酒――（产后腹痛）<br><br>（《百病饮食自疗》）<br>【配方】玄胡10克，白酒300克。<br>【制法】将玄胡入酒中浸泡3天，即可饮用。<br>【主治】产后少腹疼痛，拒按，恶露量少滞涩，有紫黑瘀血块，面色青紫，舌有紫点，或瘀斑，脉弦涩。<br>【用法】每次饮用15-30克。视酒量大小。<br>说明：有肝病史者忌服。
痃癖不能食酒方	痃癖不能食酒方――（痃癖）<br>痃癖系古病名，见《外台秘要》，是脐腹部或胁肋部患有癖块的泛称。病因饮食不节，脾胃受伤，寒痰结聚，气血凝滞所致，除癖块胀痛外，常伴见消瘦，食少，疲乏等全身症状，治应消积、散寒、涤痰、理气、和血、消瘀，药如紫苏、丹参、牛膝、香豉、橘皮、生姜、猪胰等。制成药酒常饮缓图，其效亦彰。<br>（《普济方》）<br>【配方】紫苏、牛膝、丹参、紫苑、橘皮各三两，生姜六两，生地黄（切）四两，香豉（熬）三升，防风四两，大麻仁（熬）一升五合。<br>【制法】上细切绢袋盛，以清酒二斗五升，浸三宿。<br>【主治】痃癖不能食。<br>【用法】后温一盏，用下桃仁丸，酒尽更添，忌芜荑。
雪莲酒	雪莲酒――（关节疼痛）<br>（《陕甘宁青中草药选》）<br>【配方】雪莲5钱，白酒或黄酒100毫升。<br>【制法】浸泡7日后服用。<br>【主治】风湿性关节炎，妇女小腹冷痛，胎衣不下。<br>【用法】每服10毫升，日服2次。
寻骨风酒	寻骨风酒――（痹证）<br>（验方）<br>【配方】寻骨风200克，酒750克。<br>【制法】将上药粗碎，用酒浸7日后开口，去渣备用。<br>【主治】风湿痹痛，肢体麻木，筋脉拘挛。<br>【用法】每次空腹温饮10-15毫升，每日3次。
延年生石斛酒	延年生石斛酒――（痹证）<br>（《外台秘要》）<br>【配方】生石斛（碎）三斤，牛膝一斤，杜仲、丹参各八两，生地黄（切，暴令干）三升。<br>【制法】上五味切，以绢袋盛，以上清酒二斗，入器中渍七日。<br>【主治】风痹脚弱，腰胯疼冷，利关节，坚筋骨，令强健悦泽。<br>【用法】每食前温服三合，日三夜一，加至六七合，至一升，忌芜荑。
延年薯蓣酒	延年薯蓣酒――（眩晕）<br>（《外台秘要》）<br>【配方】薯蓣、白术、五味子（碎）、丹参各八两，防风十两，山茱萸（碎）二升，人参二两，生姜（屑）六两。<br>【制法】上八味切，以绢袋盛，酒二斗五升浸五日。<br>【主治】主头风眩不能食，补益气力。<br>【用法】温服七合，日二，稍加，忌桃李雀肉等。<br>说明：《普济方》同上。
延寿获嗣酒	延寿获嗣酒――（阳萎）<br>（《惠直常常经验方》）<br>【配方】生地（用益智仁60克同蒸半小时，去益智仁）360克，覆盆子、山药、芡实、茯神、柏子仁、沙苑子、山萸肉、肉苁蓉、麦冬、牛膝各120克，鹿茸一对，龙眼肉、核桃肉各250克，酒40公斤。<br>【制法】将上药同酒一起入缸内，封固，隔水加热3.5小时后，埋入土中7天后取出。<br>【主治】肾阳虚弱，肾精不固，遗精阳萎，婚后无嗣或妇女受孕易流产，以及须发早白，耳目失聪等症。<br>【用法】每晚服4-5杯，勿饮至醉。<br>说明：阴虚火旺者及孕妇禁用。
延寿酒	延寿酒<br>【来源】《中藏经》<br>【原料】黄精30克、天冬30克、松叶15克、枸杞20克、苍术12克、白酒1000克。<br>【制作】将黄精、天冬、苍术切成小块，松叶切成碎末，同枸杞一起装入瓶中。再将白酒注入瓶内，摇匀，静置浸泡10-12天即可饮用。<br>【功效】补虚强身，延年益寿。<br>【用法】早晚各服1次，每次10-15克。
延寿酒（四）	延寿酒（四）――（阳萎）<br>（《中国医学大辞典》）<br>【配方】白术（土炒）、青皮、生地、厚朴（姜汁炒）、杜仲（姜汁炒）、破故纸（微炒）、广陈皮（去净白）、川椒各30克，青盐15克，黑豆（微炒）60克，巴戟肉、白茯苓、小茴香、肉苁蓉各30克，高梁酒1.5公斤。<br>【制法】上药共碎为粗末，夏白布或绢袋盛，置于净器中，注酒封口浸之，春夏7日，秋冬10日即可取用。<br>【主治】脾肾两衰，男子阳萎，女子经水不调，赤白带下。<br>【用法】每早、晚各空心温服1-2杯。勿食牛、马肉。妇女受胎不可再服用。
延寿瓮头春（一）	延寿瓮头春（一）――（阳萎）<br>（《寿世保元》）<br>【配方】天门冬、破故纸、肉苁蓉、粉甘草、牛膝、杜仲各30克，制附子15克，川椒30克（以上八味，制为末，待用），淫羊藿（以羯羊脂500克拌炒）、头红花各500克，白芍30克，生地黄60克，苍术120克，熟地黄60克，白茯苓120克，甘菊花30克，五加皮、地骨皮、当归各120克（以上十二味，切片，用绢袋装好备用），宿砂仁、白豆寇、木香、丁香各15克（以上四味，制为末，待用），糯米二斗，红曲末2000克，好酒20公斤。<br>【制法】将糯米洗净，浸24小时，再用水淘一次后，上锅蒸为糜，取出晾冷，用红曲及以天门冬等八味药末加入糯米糜中，调匀。再将装有淫羊藿等十二味的绢袋，置于缸底，把已调好的曲、药的糯米糜置于缸中，压住绢袋，拍实。投入好酒，封固7天，榨出洽清酒液，注入酒坛中，加入砂仁等四味药物，再封固酒坛，隔水加热1.5小时，取出，埋入土中3天后，即可饮用。<br>【主治】肾阳虚损，气血不足所致的腰膝冷痛，痿软无力，阳萎遗精，精液清冷，婚后无嗣，小便频数，妇女经血不调，带下清稀，周身疲乏，精神不振，食少腹胀，胃脘冷痛等；无明显不适症状，但素体虚寒，气祛血弱者可做为一种保健酒饮用。<br>【用法】每天视个人情况，酌饮1-2杯。<br>说明：①饮用该酒可有浑身觉热，脐部发痒的感觉。②应用制过的熟附子，并掌握用量。
芫花菟丝子酒	芫花菟丝子酒――（水肿臌胀）<br>（《普济方》）<br>【配方】芫花、菟丝子各一升。酒五升。<br>【制法】上以酒浸二药二三宿。<br>【主治】治卒肿满身面皆肿。<br>【用法】每服一升，日二服。<br>说明：《普济方》注“出肘后方”。方名为笔者所加。
芫青酒	芫青酒――（癫痫狂）<br>癫证是以精神抑郁，表情淡漠，沉默痴呆，语无伦次，静而少动为特征的疾患；痫证是以突然昏仆不知人，口吐涎沫，两目上视，肢体抽搐，或口中如作猪羊叫声等神志失常为特征的疾患；狂证是以精神亢奋，狂躁不宁，打骂毁物，动而多怒为特征的疾患。本类疾患多与痰结、火郁、血瘀、气滞或暴受惊恐，先天禀赋不足等有关。治疗本类病证的药酒，有的以活血为主，如丹参酒；有的以豁痰开窍为主，如菖蒲酒；有的以安神镇惊为主，如丹砂酒；有的以散寒除积为主，如芫青酒。但总的说来，治疗这类疾患的药酒较少。<br>（《千金翼方》）<br>【配方】芫青、巴豆（去皮心熬）、斑蝥（去翅足熬）各三十枚，附子（去皮）、踯躅、细辛乌头（去皮）、干姜、桂心、蜀椒（去目闭口者汗）、天雄（去皮）、黄芩各一两。<br>【制法】上一十二味切，以酒一斗渍十日。<br>【主治】百病风邪狂走，少腹肿，症瘕霍乱，中恶飞尸遁注，暴症伤寒，中风湿冷，头痛身重诸病，寒热风虚及头风。<br>【用法】每服半合，日二。应苦烦闷，饮一升水解之。以知为度。
雁脂酒	雁脂酒――（半身不遂）<br>（《老老余编》）<br>【配方】雁脂五两。<br>【制法】上药熬化。<br>【主治】老人风痰，偏枯不利。<br>【用法】每日空心温酒化半合服。
羊胫骨酒	羊胫骨酒――（筋骨诸病）<br>（《肘后备急方》）<br>【配方】羊胫骨适量，酒适量。<br>【制法】将羊胫骨用酒浸之。<br>【主治】筋骨挛痛。<br>【用法】随量饮之。
阳春酒	阳春酒――（痈疽、疮疡、发背）<br>（《外科正宗》）<br>【配方】人参（切片）、白术、熟地各五钱，当归身（切片）、天门冬、枸杞各三钱，柏子仁、远志各二钱五分。<br>【制法】上药，用绢袋宽贮，以无灰好酒五斤，磁罐内浸至一伏时。<br>【主治】治脑疽、诸发已溃流脓腐尽时，脾胃虚弱，肌肉生迟；或气血原不足以致肉色淡白，不能长发收敛，宜服此酒生长肌肉，强健脾胃，美悦颜色，滋润皮肤。凡大疮后饮此，不惟却病，亦且延寿。<br>【用法】每早、中、晚各饮一杯热服。如夏日天炎易坏，不堪久服，将药分作五分，每次用酒一斤随便浸服亦效。如酒将完，药尚有味，再添酒浸饮之，一次己后，药淡无味，不必再浸用之。
杨梅酒	杨梅酒――（中暑）<br>中暑为酷暑炎热之季，感受暑热邪气，以致津伤气耗，表现为发热、烦渴、汗出、胸闷心烦、头痛头昏、身重、呕恶、神昏等症状的一种疾患。临床又分中暑阳证、中暑阴证、暑犯心营，肝风内动等证，常用清热、益气、养阴、除湿、开窍等法治疗。<br>治疗本病的药酒，以预防中暑和解除轻度暑热为主，不适于暑犯心营、肝风内动等证。<br>【配方】鲜杨梅500克，白糖80克。<br>【制法】将杨梅洗净，加白糖共装入瓷罐中捣烂，加盖（不密封，稍留空隙），约7-10天，自然发酵成酒。再用纱布绞汁，即成约12度的杨梅露酒，然后倒入锅内煮沸，待冷装瓶，密封保存，时间越久越佳。<br>【主治】预防中暑。<br>【用法】夏季饮用最宜。
杨梅醴	杨梅醴――（中暑）<br>（验方）<br>【配方】鲜杨梅500克，白糖50克。<br>【制法】鲜杨梅洗净，加白糖，置瓷罐中捣烂、加盖（但需留空隙），一周后自然发酵成酒，用洁净的纱布绞汁，即为约12度的杨梅醴，如甜度不能还可酌加白糖，再置锅中煮沸，停火，待冷，装瓶，密闭保存，陈久为良。<br>【主治】夏季常饮可预防中暑，并有止泻之功。<br>【用法】夏季作饮料饮之。
养生酒	养生酒<br>【来源】(经验方)<br>【原料】当归身、菊花各30克，桂圆肉240克，枸杞子120克，白酒浆3500克，滴烧酒1500克。<br>【制作】将上药盛入绢袋内，悬于坛中，加入酒封固，窖藏1个月以上，便可饮用。<br>【功效】补益强身，养生防病。适用于血虚精亏，面色不华，头晕目眩，视物昏花，睡眠不安，心悸，健忘等症。常饮能改善老年人免疫功能，增强抗病能力，延缓衰老。<br>【用法】每日1-2次，每次饮服1-2小盅。
一醉不老丹（一）	一醉不老丹（一）――（乌须黑发）<br>（《古今医　》）<br>【配方】莲花蕊、生地黄、槐角子、五加皮各二两，没食子六个，好清酒十斤。<br>【制法】上诸药，以木石臼碎，用生绢袋盛药，同酒入净坛内，春冬浸一月，秋二十日，夏十日，紧封坛口，浸满日数即成。<br>【主治】专养血乌须黑发。<br>【用法】任意饮之，所醉为度，须连日服，若不黑，再制，服之自黑。
一醉膏	一醉膏――（痈疽、疮疡、发背）<br>（《普济方》）<br>【配方】大甘草（为粗末）半两，没药（研）一份，栝蒌（大者去皮）一个。<br>【制法】上用无灰酒三升，熬至一升。<br>【主治】治发背痈疽，一切恶疮。<br>【用法】放温顿服之，如一服不尽，分三两服，连服尽。当先用托里药，使毒气皆出，凡初觉发背痈疽者，即多服，用大黄、甘草等药，极疏转以行结毒，次用此药。
一醉散	一醉散――（乌须黑发）<br>（《普济方》）<br>【配方】槐子四钱，旱莲草四分，生地黄半两。<br>【制法】上为细末，无灰酒一瓶，将药投酒内，密封之，浸二十日。<br>【主治】黑发。<br>【用法】取酒饮一醉后，觉来须发尽黑。恐人不信，将白鸡犬喂试之，白毛鸡犬皆变为黑鸡犬也。
益母草浸酒	益母草浸酒――（脱肛）<br>脱肛又名“截肠”。是指直肠粘膜或直肠脱出肛外的一种病症。多因气虚下陷或湿热下注所致。以老年人和小儿多患。初开始仅于大便时肛门脱垂，能自行回缩；病久则脱出较长，需用手托纳回。每于行走、劳累、咳嗽、用力等而脱出，肛门坠胀不适，久不回纳，则局部紫赤，肿痛加剧，甚则溃烂。以下介绍用益母草浸酒治疗脱肛。<br>（《普济方》）<br>【配方】益母草（炙令香）。<br>【制法】以上味浸酒。<br>【主治】治脱肛下血。<br>【用法】服之。<br>说明：《普济方》注出“本草方”，原无方名，此方名据所用药物及制法命名。<br>
益肾明目酒	益肾明目酒――（耳聋）<br>（验方）<br>【配方】覆盆子（去梗）50克，巴戟天（穿心紫者，去心）、肉苁蓉（酒浸，去皱皮）、远志（去心）、川牛膝、五味子、续断各35克，山萸肉（去核）30克，醇酒1公斤。<br>【制法】将上药共捣为粗末，用夏白布袋盛，置于净器中，注酒浸之，密封口，春夏5日，秋冬7日，然后添冷开水1公斤，合均备用。<br>【主治】肝肾虚损，耳聋目昏，腰酸腿困，神疲力衰。<br>【用法】每次空心温饮10-15毫升，每日早、晚各1次。
薏苡仁酒（二）	薏苡仁酒（二）――（痹证）<br>（《活人书》）<br>【配方】薏苡仁、牛膝各二两，海桐皮、五加皮、独活、防风、枳壳（炒）、杜仲（姜汁炙）各一两，干生地黄二两半，白术半两。<br>【制法】上为粗末，入生绢袋内，用好酒五升浸，春秋冬二七日，夏月盛热，分作数贴，逐贴浸酒。<br>【主治】脚痹。<br>【用法】每日空心温服一盏或半盏，日三四服，常令酒气醺醺不绝。<br>说明：久服，觉皮肤下如数百条虫行，即风湿气散。
薏苡仁酒（三）	薏苡仁酒（三）――（脚气）<br>（《普济方》）<br>【配方】薏苡仁五两，羚羊角屑三两，川升麻二两，秦艽（去苗）三两，黄苓二两，地骨皮一两，羌活二两，枳壳一两（麸炒微黄土瓤）、牛膝（去苗）五两，五加皮三两，独活二两，牛蒂子（微炒）二两，桂心二两，大麻仁五合，生干地黄五两，防风三两（去芦头）。<br>【制法】上件药v碎，以生绢袋盛之，以酒三斗，浸六七日。<br>【主治】风治脚气风毒，发歇疼痛，四肢拘急，背项强直，言语蹇涩。<br>【用法】每于食前，随性暖服之。
薏苡仁酒（一）	薏苡仁酒（一）――（筋骨诸病）<br>（《医部全录》）<br>【配方】薏苡仁（绝好者，研粉）适量。<br>【制法】将上粉同曲、米如常法酿酒。<br>【主治】去风湿，强筋骨，益肺肾，健脾胃。<br>【用法】随量饮之，或将粉以袋盛之，煮酒饮。
茵陈酒	茵陈酒――（风疾诸病）<br>风为六淫之首，百病之长，风之为病善行而数变，治无常方。风邪致病，表现筋肉关节、气血经脉者，用药酒治疗尤宜，因酒有和血活血之功，“治风先治血，血行风自灭”，酒可引诸药直走血分。常用药有：茵陈蒿、麻黄、防风、独活、肉桂、秦艽、牛膝、天雄、当归、五加皮、侧子、海桐皮、附子、乌梢蛇、百灵藤、川芎、虎骨、牛蒡子、大麻子、天蓼木、石南、乌头、茵芋、细辛、桑枝、槐枝、松针等。<br>（《本草纲目》）<br>【配方】茵陈蒿（炙黄）一斤，秫米一石，曲三斤。<br>【制法】如常酿酒。<br>【主治】治风疾，筋骨挛急。<br>【用法】饮之。<br>说明：本方见《本草纲目》卷二十五附诸药酒条下。
茵芋浸酒方（一）	茵芋浸酒方（一）――（痹证）<br>（《圣济总录》）<br>【配方】茵芋（去粗茎）、萆、蜀椒（去目并闭口炒出汗）、狗脊（去毛）、桂（去粗皮）、附子（炮裂去皮脐）各一两，牛膝（去苗酒浸切焙）、石斛（去根）、生姜各一两半。<br>【制法】上九味，口父咀，以生绢袋贮，以酒一斗，浸经三两宿。<br>【主治】风寒湿痹，皮肉不仁，骨髓疼痛，不可忍。<br>【用法】每服一盏或二盏温服，服尽酒一半，更添新酒浸之。觉药味淡，即再合。<br>说明：《御药院方》同上。
茵芋酒（三）	茵芋酒（三）――（筋骨诸病）<br>（《太平圣惠方》）<br>【配方】茵芋20克，白及、薏苡仁、赤芍、桂心、牛膝、酸枣仁（炒）各30克，炮姜15克，制附子30克，炙甘草15克，酒1公斤。<br>【制法】将上药共捣碎细，和匀，以酒浸于净瓶中，封口，7宿后开取，去渣备用。<br>【主治】筋脉拘挛，不可屈伸。<br>【用法】随量温饮，不拘时候。
茵芋酒方（二）	茵芋酒方（二）――（癞病）<br>（《太平圣惠方》）<br>【配方】茵芋一两，乌头（炮裂去皮脐）一两，天雄（炮裂去皮脐）一两，附子（炮裂去皮脐）一两，川椒（去目及闭口者微炒去汗）一两，踯躅花（醋拌炒令干）一两，干姜（炮裂）一两，桂心一两，防风（去芦头）一两，石南叶一两，甘草（炙微赤v）一两，莽草（炙微黄）一两。<br>【制法】上诸药，细v，以生绢袋盛，以清酒一　五升浸三七日满后服。<br>【主治】治大风疾。<br>【用法】每日空心及临卧时，暖一小盏服之。<br>说明：《普济方》同上。
淫羊藿酒（二）	淫羊藿酒（二）――（阳萎）<br>（《陕甘宁青中草药选》）<br>【配方】淫羊藿（全干草）1斤，白酒3斤。<br>【制法】将淫羊藿浸泡在酒内，密封7天7夜（前4天4夜温度在50℃以上，后3天3夜温度在5-8℃内），过滤贮瓶备用。<br>【主治】阳萎，早泄，四肢麻木。<br>【用法】每服10-20毫升，日服3次。
淫羊藿酒（一）	淫羊藿酒（一）――（阳萎）<br>（《普济方》）<br>【配方】淫羊藿一斤。<br>【制法】上以酒一斗，浸经三日。<br>【主治】益丈夫兴阳，理腰膝冷。<br>【用法】饮之。<br>说明：方名系笔者所加。
银酒	银酒――（流产）<br><br>（《妇人大全良方》）<br>【配方】根（v）二两，银五两，清酒一盏。<br>【制法】上以水一大盏，煎至一大盏，去滓。<br>【主治】治妊娠胎动欲堕，腹痛不可忍。<br>【用法】分温二服。<br>说明：《普济方》同上。
饮酒令人不醉方（二）	饮酒令人不醉方（二）――（解酒毒）<br>（《太平圣惠方》）<br>【配方】葛根汁（或枇杷叶汁）一盏。<br>【制法】取上药汁。<br>【主治】欲饮时先服上药，即倍能饮酒。<br>【用法】饮酒前服用。
饮酒令人不醉方（三）	饮酒令人不醉方（三）――（解酒毒）<br>（《太平圣惠方》）<br>【配方】葛花半两、小豆花半两。<br>【制法】上件药，捣细罗为散。<br>【主治】饮酒令人不醉。<br>【用法】每服一钱，以温酒调服之。
饮酒令人不醉方（一）	饮酒令人不醉方（一）――（解酒毒）<br>（《太平圣惠方》）<br>【配方】柏子仁、大麻子仁各一两。<br>【制法】上件药，捣筛为散，以水一大盏，煎至六分，去滓，放温。<br>【主治】治饮酒令人不醉。都为一服，比常时乃进酒三倍。<br>【用法】温服。
饮蛇龟酒	饮蛇龟酒――（跌打损伤）<br>（《普济方》）<br>【配方】饮蛇龟一枚，糯米（蒸作酿饭）五升，好酒二斗。<br>【制法】上为v龟酿饭，同入酒瓮中，封七日。<br>【主治】治一切筋骨肌肉折，疼痛。<br>【用法】每服暖一盏服之，日三五服。<br>说明：《普济方》注出《太平圣惠方》
樱桃酒	樱桃酒――（关节疼痛）<br>（《药用果品》）<br>【配方】鲜樱桃500克，米酒1000克。<br>【制法】将樱桃洗净，浸入酒中，密封10天即成。<br>【主治】风湿关节疼痛，风湿性瘫痪等。<br>【用法】每次30-60克，早、晚各1次。
涌泉酒	涌泉酒――（产后缺乳）<br><br>（《验方新编》）<br>【配方】王不留行、天花粉各10克，当归7克，穿山甲（炙黄）5克，甘草10克。<br>【制法】将上药，共为细末，每取7克，同黄酒2杯，煎取1杯，候温备用。<br>【主治】产后乳汁不通。<br>【用法】温饮，每日2次。
鱼灰酒	鱼灰酒――（产后缺乳）<br><br>（验方）<br>【配方】鲤鱼头（瓦上烧灰）5枚，黄酒500毫升。<br>【制法】将上1味细研为散，用酒同煎数沸，去渣备用。<br>【主治】乳汁不下。<br>【用法】早、午、晚各温饮15-20毫升。
玉露酒	玉露酒――（痰证）<br>（《鲁府禁方》）<br>【配方】薄荷叶五斤，绿豆粉一斤半，白沙糖一斤半，天门冬（去心）一两，麦门冬（去心）一两，天花粉四两，白茯苓（去皮）四两，柿霜四两，硼砂五钱，冰片二钱。<br>【制法】用新盆二个，将薄荷等药屑相间隔，著实盛於内，二盆合封固如法，不许透气，蒸五炷香，取出晒干，抖去群药，止用豆粉，复加白糖、柿霜、硼砂、冰片。<br>【主治】诸疾痰饮，宿滞噎塞，气痞奔豚，膨胀上喘下坠，乍寒乍热，头目晕胀，咽喉肿痛，不拘老少，并皆治之。<br>【用法】随用此药，不用引子，诸物不忌。
郁李酒	郁李酒――（牙宣）<br>牙宣是类似于慢性牙周炎、牙龈萎缩一类的病症。多因胃经积热与风寒之邪相搏，热不得宣，邪欲行而又止，致龈肉日渐腐颓，久而宣露其根。症见牙龈先肿，龈肉日渐萎缩，牙根宣露，或齿缝中常出血或流脓。老年人齿龈萎缩，齿牙动摇欲落者，多是由于肾气渐衰所致。以下介绍郁李酒治疗本病的方法。<br>（《普济方》）<br>【配方】郁李根、细辛、椒各半两，槐白皮、柳白皮各一两。<br>【制法】上细v，每用药一两，酒半斤，煎三五沸，去滓。<br>【主治】治齿风肿痛，呼吸风冷，其痛愈甚，　　肿赤。<br>【用法】热漱冷吐。
欲蛇龟酒方	欲蛇龟酒方――（跌打损伤）<br>（《太平圣惠方》）<br>【配方】欲蛇龟一枚，糯米（蒸作酿饭）五斤（升），好酒二。<br>【制法】上药细v龟，酿饭，同入酒瓮中，牢封一七日后服用。<br>【主治】治伤折疼痛不可忍。<br>【用法】即每暖一中盏服之，日可三五服。
愈风酒	愈风酒――（关节疼痛）<br>（《随息居饮食谱》）<br>【配方】陈海蛇360克，黑大豆、嫩桑枝、松针各120克，陈酒3500克。<br>【制法】将上药制成粗末，以绢袋盛，浸于酒中，封固，隔水加热，煮1.5小时，取出晾凉，再浸数日即可饮用。<br>【主治】关节、筋骨疼痛等症。<br>【用法】酌量饮用。<br>说明：陈海蛇即海蛰，又名水母。
愈风酒方	愈风酒方――（风疾诸病）<br>（《随息居饮食谱》）<br>【配方】陈海蛇（漂净拭干，晾极燥）十二两，井黑大豆、嫩桑枝、松针（杵烂）各四两，陈酒七斤。<br>【制法】封浸，煮三柱香。<br>【主治】诸风腰背疼痛，节肿。<br>【用法】温饮。
愈疟酒	愈疟酒――（疟疾）<br>疟疾是感受疟邪，瘴毒及风寒暑湿邪气，伏于少阳，以寒热往来，反复发作，发作有一定时间，每次发作症状相同等为表现特征的疾病。历代有按阴阳对本病分类者，有按脏腑对本病分类者，有以经络分类者，有以病邪分类者，方法不一，各有所长。<br>使用药酒治疗本病，早在《肘后备急方》中即有记载，历代亦有不少发明。其中所有药物，以青蒿、常山等为多，如常山酒、青蒿酒、治寒热诸疟方、黄连酒方等。治寒疟常配附子，如鳖甲酒方；疗久疟、老疟、劳疟常配鳖甲等，如鳖甲酒、秦艽酒、老疟久不断方、近效疗久难瘥疟常山酒等。<br>（《本草纲目》）<br>【配方】水100升，曲2500克。<br>【制法】取曲500克，压细末，放入水内发酵，再煎煮之，等水剩70升，待冷，再入曲2000克，放一宿，上起白沫，再加热煮数沸，待冷，自然发酵，3日酒成，即可服用。<br>【主治】各种疟疾。<br>【用法】频频温饮之。
愈癣药酒	愈癣药酒――（疥癣病）<br>疥疮和癣病均是较常见的皮肤病。疥疮多以手指缝最多见，亦常见于肘窝、腋下、小腹、腹股沟、臀部和腿部等所，甚则遍及全身。呈现针头大小的丘疹和水疱，痒甚，故体表常见抓痕和结痂。抓后有滋水者，称为湿疮；无滋水者，称为干疥；因搔破皮肤而感染化脓者，称为“脓窝疥”。本病多因风湿热邪郁于皮肤，接触传染，疥虫潜隐皮肤所致。癣病中医也有诸多之分。根据病损的部位、好发季节、好发年龄、临床病损特点不同，有诸多不同的名称。如松皮癣（又名白疮、类似银屑病）、吹花癣（桃花癣，多发于春月）、圆癣（金钱癣、笔管癣）、蛇皮癣（鱼鳞癣）、牛皮癣、鹅掌风（掌心风、鹅爪疯）、奶癣、股癣等等。其特点均以皮疹白屑，浸润肥厚、局部搔痒，甚则刮破皮出血等。其病因多因血虚风燥，营卫失调，外受风邪，肌肤失养所致。以下介绍治疗疥癣的药酒12种，临床可酌情选用。<br>（《中国医学大辞典》）<br>【配方】苦参子、土荆皮、花椒、樟皮、白芨、姜、百部、槟榔、木通各30克，高梁酒750克。<br>【制法】将上药共捣碎，布包，用酒浸于净瓶中，3-5日后开取，去渣备用。<br>【主治】癣疮，皮肤顽存，浸淫作痒。<br>【用法】用毛笔蘸涂患处，1日2次，至愈为度。
远志酒	远志酒――（痈疽、疮疡、发背）<br>（《类编朱氏集验医方》）<br>【配方】远志（米泔浸洗，去土，去心）不以多少。<br>【制法】上为细末。<br>【主治】治一切痈疽、发背、疖毒、恶候浸大有死血。阴毒在中则不痛，敷之即痛。有忧怒等气积而内攻则痛不可忍，敷之即不痛。或蕴热在内，热迫人手不可近，敷之清凉。或气虚血冷，溃而不敛，敷之即效。或七情内郁，不问虚、实、寒、热，治之必愈。<br>【用法】以酒一盏，调药末三钱，迟顷澄清，饮之。以滓敷病处。<br>说明：《三因极一病证方论》、《普济方》同上。
月季花酒	月季花酒――（月经过少）<br><br>（中医研究院《常见病验方研究参考资料》）<br>【配方】月季花12朵，黄酒适量。<br>【制法】将月季花烧灰存性。<br>【主治】经来量少，紫黑有块，少腹胀痛、拒按，血块排出后疼痛减轻，舌边可见紫黯瘀点，脉沉涩。<br>【用法】黄酒送服。
枣子酒	枣子酒――（奔豚气）<br>奔豚气即奔豚，名出《灵枢・邪气藏府病形》，又名贲豚，多由肾脏阴寒之气上逆或肝经气火冲逆所致，症见有气从少腹上冲胸脘、咽喉，发时痛苦剧烈，或有腹痛，或往来寒热，病延日久，可见咳逆、骨痿、少气等。《类编朱氏集验医方》等以枣子酒，斑蝥为主药治疗，与常规方法以奔豚汤、桂枝和桂汤及茯苓桂枝甘草大枣汤等治疗不同，值得探讨。<br>（《类编朱氏集验医方》）<br>【配方】斑蝥（去头足翅）一个。<br>【制法】上件用好肥枣一个，劈开去核，安在内，用湿纸包，文武灰中煨热、去斑蝥不细<br>【主治】治奔豚气。<br>【用法】将枣子细嚼，热酒送下，空心。<br>说明：《普济方》注“出仁存方”，同上。
皂荚酒方（二）	皂荚酒方（二）――（水肿臌胀）<br>（《普济方》）<br>【配方】皂荚（剥去筋皮炙令黄，　）三升。<br>【制法】酒一斗渍入石器煮令沸。<br>【主治】治水肿入腹苦满急，妨害饮食。<br>【用法】服一升，日三服。<br>说明：《普济方》注“出肘后方”。
皂荚乳香酒方	皂荚乳香酒方――（痈疽、疮疡、发背）<br>（《圣济总录》）<br>【配方】皂荚刺（大者）一枚，乳香一块，如鸡头实大。<br>【制法】皂荚v制作十余片，用乳香银石器内炒令烟起，入皂荚刺同炒，候香缠在刺上，便入醇酒一盏，同煎令沸，滤去滓。<br>【主治】治肿毒。<br>【用法】作一服，肿未成者便消，已成者则脓毒自破。<br>说明：《普济方》同上。
泽兰酒	泽兰酒――（产后腹痛）<br><br>（《百病饮食自疗》）<br>【配方】泽兰30克，米酒300克。<br>【制法】将上药共煎，饮时再加少量米酒。<br>【主治】产后少腹疼痛，拒按，恶露量少滞涩，有紫黑瘀血块，面色青紫，舌有紫点或瘀斑，脉弦涩。<br>【用法】视酒量大小，以不醉为度。
增损茵芋酒	增损茵芋酒――（半身不遂）<br>（《妇人大全良方》）<br>【配方】茵芋叶、川乌（炮，去皮尖）、石楠叶、防风、川椒（炒去汗）、女萎、附子（炮）、北细辛、独活、卷柏、肉桂、天雄（炮，去皮）、秦艽、防己各一两，踯躅花（炒）、当归、生干地黄各二两，芍药一两。<br>【制法】上口父咀，酒二斗渍之，冬七日，夏三日，春、秋各五日。<br>【主治】半身不遂，肌肉干燥，渐渐细瘦，或时　痛，病名偏枯。<br>【用法】初服一合，渐增之，以知为度，令酒气相续。<br>说明：《普济方》所载本方同上，注出《妇人大全良方》。
榨木皮酒	榨木皮酒――（瘰疠）<br>（《普济方》）<br>【配方】榨木皮五升。<br>【制法】上以酒一斗煮熟，去皮煎汁，令得二升。<br>【主治】疗鼠瘘。<br>【用法】服之尽，有宿肉出愈。<br>说明：《普济方》注出“肘后方”，方名“疗鼠瘘要方”。
柘根酒（二）	柘根酒（二）――（耳聋）<br>（《本草纲目》）<br>【配方】柘根二十斤，菖蒲五斗。<br>【制法】上药各以水一石，煮取汁五斗。故铁二十斤熔赤，以水五斗浸取清。合水一石五斗，用米二石，曲二斗，如常酿酒成。用真磁石三斤为末，浸酒中三宿。<br>【主治】治耳聋，柘能通肾气，故圣惠方治耳鸣耳聋一二十年者，有柘根酒。<br>【用法】日夜饮之，取小醉而眠。闻人声乃止。
柘根酒（一）	柘根酒（一）――（耳聋）<br>（《普济方》）<br>【配方】柘根三十斤，菖蒲（切）五斗各用水一石煮取五斗去滓澄清，故铁三（二）十斤烧赤水五斗浸三宿去铁澄清。<br>【制法】上合一石五斗，同米二石并，曲二斗，酿如常法，酒熟一月，封头开清，用磁石嗡铁者三斤，捣为末，纳酒中，浸三宿。<br>【主治】治耳聋鸣汁出，皆由肾寒，或三十年不瘥。<br>【用法】日夜饮，常饮取小醉而眠，取闻人语乃止。
鹧鸪酒	鹧鸪酒――（疫毒）<br>（《普济方》）<br>【配方】鹧鸪、羊肉。<br>【制法】以鹧鸪合羊肉酒煮。或单鹧鸪以酒服之。<br>【主治】治瘴及蛊气放死者。<br>【用法】服之。
栀子酒	栀子酒――（黄疸）<br>（《普济方》）<br>【配方】栀子，茵陈各一束。<br>【制法】上以无灰酒二大碗，煎至八分。<br>【主治】黄疸。<br>【用法】三更时分服之，忌油腻油面豆腐生冷等物。
蜘蛛浸酒方	蜘蛛浸酒方――（瘰疠）<br>本病是发生于颈部淋巴结的慢性感染疾患。因其结核累累若贯珠之状，故名瘰疬。欲称“疬子颈”或“老鼠疮”。起病多缓，初起结核如豆，皮色不变，不痛。以后逐渐增大串连，成脓时皮肤转为暗红，溃后脓水清稀，每夹有败絮样物质，往往此愈彼溃，形成窦道。本病的治疗，初期宜疏肝养血，健脾化痰，中期则辅以托毒透脓；后期应滋肺。此病相当于现代医学的颈淋巴结结核。<br>（《普济方》）<br>【配方】大肚蜘蛛不拘多少。<br>【制法】上用好酒浸了研烂，同酒去滓。<br>【主治】治颌下结核不消经效。<br>【用法】临卧温服。<br>说明：《普济方》原名“治颌下结核不消经效方”，蜘蛛浸酒方系编者新加。
枳壳浸酒方（二）	枳壳浸酒方（二）――（风瘾疹）<br>风瘾疹又称“隐疹”、“风瘙瘾疹”、“风　　”。即现代医学的荨麻疹。多因内蕴湿热，复感风寒，郁于皮腠而发，或因对某些物质过敏所致。症见皮肤大小不等的风团，小如麻粒，大如豆瓣，甚则成块成片，剧痒，时隐时现。本病有风寒、风热、血热和血虚的不同。以下介绍8种药酒，可根据病情酌用。<br>（《圣济总录》）<br>【配方】枳壳（去瓤麸炒）三两，秦艽（去苗土）、独活（去芦头）、肉苁蓉各四两，丹参、蒴各五两，松叶（细切）二斗。<br>【制法】上七味，v如麻豆，用生绢袋贮，以清酒二斗，浸六宿。<br>【主治】治风瘙瘾疹，皮肤生　　，或如虫行。<br>【用法】每服半盏，日三夜一，渐加至一盏。<br>说明：《普济方》同上。
枳壳浸酒方（一）	枳壳浸酒方（一）――（口眼?斜）<br>（《太平圣惠方》<br>【配方】枳壳（刮去上面青末）三斤。<br>【制法】上以微火炒去湿气，以酒二斗浸之，其药瓶常令近火，微，令药味得出，七日后用之。<br>【主治】治风，口偏眼急。<br>【用法】随性饮之。
枳壳酒方	枳壳酒方――（赤游风）<br>赤游风又名“游风”、“赤游丹”。多因脾肺燥热，或表气不固，风邪袭于腠理，风热壅滞，营卫失调所致。滞于血分则发赤色，名赤游风或赤游丹；滞于气分则成白色，名白游风。症见突然发作，游走不定，皮肤红晕、光亮、浮肿，形如云片，触之坚实，搔痒，灼热，麻木。多发于口唇、眼睑、耳垂及胸腹、背部等处。亦可伴有腹痛、腹泻呕吐等症。与现代医学的“血管神经性水肿”相似。以下介绍两种治疗本病的药酒，供选用。<br>（《圣济总录》）<br>【配方】枳壳（去瓤麸炒）、柏白皮各半斤、五叶草一斤。<br>【制法】上三味，细v，生绢袋盛，以酒一斗浸七日。<br>【主治】治刺风游风。<br>【用法】每温饮一盏，并服不妨，常令有酒力佳。<br>说明：《普济方》同上。
枳茹酒	枳茹酒――（口眼?斜）<br>（《备急千金要方》）<br>【配方】枳茹五升。<br>【制法】枳实上青刮取末，欲至心止，得茹五升，微火炒去湿气，以酒一斗渍，微火令得药味。<br>【主治】主口僻眼急大验，治缓风急风并佳。<br>【用法】随性饮之。
治鼻塞眼昏疼痛脑闷方	治鼻塞眼昏疼痛脑闷方――（鼻窒）<br>鼻窒又名“鼻塞”、“鼻痈”、“鼻窍不利”。多由风寒或风热导致肺气不宣所致。风寒者，鼻塞不通，兼有发热恶寒，头痛身痛，苔白，脉浮紧；因于风热者，鼻塞而兼有发热微恶风寒，鼻流浊涕，眼昏头痛，苔薄黄，脉浮数或弦数。其次，鼻痔（鼻肉）等也可引起鼻塞。以下介绍葫芦酒治疗鼻窒的方法，三首配方均大同小异，来自于不同的书籍，均录于此，可供相互参考。<br>（《太平圣惠方》）<br>【配方】苦葫芦子。<br>【制法】用苦葫芦子，碎以醇酒半升浸之，夏一日，冬七日。一方用童子小便浸之。<br>【主治】鼻塞、眼昏疼痛、脑闷。<br>【用法】少少纳鼻中。
治赤白下痢酒方	治赤白下痢酒方――（下痢泄泻）<br>下痢是以大便次数增多，腹部疼痛，里急后重，下赤白脓血便为特征的疾病；泄泻是以大便次数增多，类质溏薄或完谷不化，甚至泻出如水样为特征的疾病。二者在病因方面都与感受外邪，饮食损伤，七情失调，脾胃虚弱等有关。<br>根据临床表现的特点，下痢又分为寒湿痢、湿热痢、疫毒痢、噤口痢、休息痢、阴虚痢、虚寒痢、劳痢等类型；泄泻又分为寒湿泄泻、湿热泄泻、伤食泄泻、肾虚泻等类型。药酒用于这两种疾病，以偏寒者用之为多，如地榆附子浸酒、猪胰酒、曲末酒等。<br>（《本草纲目》）<br>【配方】鸡冠花。<br>【制法】煎酒。<br>【主治】赤白下痢。<br>【用法】服，赤用红，白用白。<br>说明：《本草纲目》卷十五鸡冠条注：“引集简方”，本方名系笔者所加。
治跌打酒	治跌打酒――（跌打损伤）<br>（《普济方》）<br>【配方】铁一斤。<br>【制法】上以酒三升，煮取一升，或烧赤投酒中。<br>【主治】治被打扑，瘀血在骨节及胁下不去。<br>【用法】服之。
治耳聋铁酒方	治耳聋铁酒方――（耳聋）<br>（《圣济总录》）<br>【配方】铁五两，酒一升。<br>【制法】上二味烧铁令赤，投酒中，去铁饮之。<br>【主治】治耳聋。<br>【用法】去铁饮之，仍以磁石塞耳中。
治风毒骨痛酒方	治风毒骨痛酒方――（筋骨诸病）<br>（《本草纲目》）<br>【配方】芍药二分，虎骨一两。<br>【制法】炙为末，夹绢袋盛，酒三升，渍五日。<br>【主治】风毒骨痛在髓中。<br>【用法】每服三合，日三服。<br>说明：《本草纲目》卷十四芍药条注“引经验后方”，本方名系笔者所加。
治风毒脚弱痹满上气又方	治风毒脚弱痹满上气又方――（脚气）<br>（《肘后备急方》）<br>【配方】白矾石二斤（亦可用钟乳末）、附子三两，豉三升。<br>【制法】酒三斗渍四五日。<br>【主治】治风毒脚弱痹满上气。<br>【用法】稍饮之，若此有气，加苏子二升。
治风毒膝挛酒方	治风毒膝挛酒方――（关节疼痛）<br>关节疼痛是由外感风寒湿邪或肝肾虚损而致，其中多属于中医的“历节风”、“痹证”等内容，常常呈现反复发作，逐渐加重的特点。其病机主要为气血痹阻不通，筋脉关节失去濡养。在临床表现方面，除具有疼痛外，还常伴有麻木，酸楚以及活动障碍等症状。<br>关节疼痛的治疗药酒较多，从其作用特点看，有以祛风散湿为主者，如青囊药酒、松节酿酒、松节酒等；有以补肝肾，强筋骨为主者，如虎骨酒、虎骨地黄酒、补肾地黄酒、地黄酒等；有以活血通络为主者，如复方当归酒、茜草酒、当归松叶酒等；有以活血祛风为主者，如参蛇浸酒；有以祛湿为主者，如白术酒等；有的药酒具有多种功能，如列节酒、长宁风湿酒、加皮丹参酒、冯了性药酒等，不但能祛风散寒除湿，且能活血通络补肾，以够治疗多种原因引起的关节疼痛。<br>（《本草纲目》）<br>【配方】豉心五升。<br>【制法】九蒸九暴，以酒一斗浸经宿。<br>【主治】风毒膝挛，骨节痛。<br>【用法】空心随性温饮。<br>说明：《本草纲目》卷二十五大豆豉条注“引食医心镜”，本方名系笔所加。
治风经效鼠黏根浸酒方	治风经效鼠黏根浸酒方――（风疾诸病）<br>（《太平圣惠方》）<br>【配方】鼠黏根（掘时勿令见风，密房内净洗薄切，密瓷内阴干）五斤，防风（去芦头）五两，附子（炮裂去皮脐）二两，独活五两，汉防已二两，桂心二两，天麻二两，麻黄（去根节）二两，坐地黄八两。<br>【制法】上件药细v，用生绢袋盛，以无灰酒三斗浸之，密封，春夏七日，秋冬二七日开。<br>【主治】治风疾。<br>【用法】每日空腹，日午夜临卧，每温饮一小盏。
治风冷脚气酒方	治风冷脚气酒方――（脚气）<br>（《本草纲目》）<br>【配方】白矾石（煅）二斤。<br>【制法】酒三斗渍三日。<br>【主治】风冷脚气。<br>【用法】稍稍饮之。<br>说明：《本草纲目》卷十矾石条注“引肘后方”，本方名系笔者所加。
治风无问新久及偏枯顽痹不仁	治风无问新久及偏枯顽痹不仁――（半身不遂）<br>肢节缓急宜服此浸酒方<br>（《太平圣惠方》）<br>【配方】茵芋、狗脊、川乌头（炮裂去皮脐）、天麻、附子（炮裂去皮脐）各二两，独活二两，踯躅（炒黄）一两，天雄（炮裂去皮脐）二两，牛膝（去苗）三两，防风（去芦头）三两，桂心一两半。<br>【制法】上件药，细v和匀，以生绢袋盛，用好酒二斗，浸十日。<br>【主治】风无问新久，及偏枯顽痹不仁，肢节缓急。<br>【用法】每服温饮一小盏，日三服，以效为度。忌生冷毒鱼鸡猪鹅鸭肉。
治腹中紧张酒方	治腹中紧张酒方――（腹胀腹痛）<br>（《本草纲目》）<br>【配方】砂糖。<br>【制法】以酒三升煮。<br>【主治】腹中紧张。<br>【用法】服之，不过再服。<br>说明：《本草纲目》卷三十三沙糖条注“引子母秘录”，本方名系笔者所加。
治鬼疰劳气酒方	治鬼疰劳气酒方――（鬼疰）<br>鬼疰为疰病之一，多认为是后世所说的痨，以病程迁延，具有传染性为特点。临床表现有发热、咳嗽、盗汗、遗泄，或腹中有块，或脑后两边有小结核等。本病以阴虚内热，痰火郁结为主，较少用药酒治疗。这里选录一方，可供临证参考。<br>（《本草纲目》）<br>【配方】芥子（研末）三升。<br>【制法】绢袋盛，八三斗酒中七日。<br>【主治】治鬼疰劳气。<br>【用法】温服，一日三次。<br>说明：《本草纲目》卷二十六芥子条注曰“引广济方”，本方名系笔者所加。
治寒热诸疟方（二）	治寒热诸疟方（二）――（疟疾）<br>（《肘后备急方》）<br>【配方】常山（　）三两。<br>【制法】以酒三升渍之二三日。<br>【主治】治寒热诸疟。<br>【用法】平旦作三合服，欲吐之，临发又服二合便断，旧酒亦佳，急亦可煮。
治鹤膝风病酒方	治鹤膝风病酒方――（鹤膝风）<br>（《本草纲目》）<br>【配方】酒醅糟四两，肥皂一个（去子）芒消一两，五味子一两，砂糖一两，姜汁半瓯。<br>【制法】研匀。<br>【主治】鹤膝风。<br>【用法】日日涂之，加入烧酒尤妙也。<br>说明：《本草纲目》卷二十五糟条。
治鹤膝风挛酒方	治鹤膝风挛酒方――（鹤膝风）<br>鹤膝风是以膝关节肿大疼痛，而股胫的肌肉消瘦为特征，常因肾阴亏损，寒湿侵于下焦，流注关节所致。由于其形如鹤膝，故称之为鹤膝风。本病大多由“历节风”发展而来，为临床难治疾患之一。这里选录的二种药酒配方，一为内服，一为外用，可根据情况选用。<br>（《本草纲目》）<br>【配方】紫荆皮三钱。<br>【制法】老酒煎。<br>【主治】鹤膝风挛。<br>【用法】煎服，日二次。<br>说明：《本草纲目》卷三十六紫荆条注“引直指方”，本方名系笔者所加。
治霍乱转筋酒方	治霍乱转筋酒方――（霍乱）<br>（《本草纲目》）<br>【配方】生姜三两。<br>【制法】捣，酒一升煮三两沸。<br>【主治】霍乱转筋，入腹欲死。<br>【用法】服，仍以姜捣贴痛处。<br>说明：《本草纲目》卷二十六生姜条注“引外台秘要”，本方名系笔者所加。
治金疮浸酒方	治金疮浸酒方――（破伤风）<br>破伤风一病见于《仙授理伤续断秘方》，又名伤痉、金疮痉、金疮中风等，多因外伤金疮而中风邪所致。临床表现为在伤愈或未愈时，见发寒发热，面肌痉挛，呈苦笑面容，牙关紧闭，舌强口噤，继则角弓反张；后期说话、吞咽、呼吸均感困难，甚则窒息以致死亡。古代文献中记载，有以雀屎、鸡屎白、蒜、大豆、杏仁等制成药酒治疗本病的方法，介绍如下。<br>（《普济方》）<br>【配方】雀屎（炒研）半合。<br>【制法】以酒七合，煮五合，滤去渣。<br>【主治】金疮或击破等疮中风，口闭牙噤，身强欲死。<br>【用法】温顿服之，腹中转动当即愈。若不能开口，翰开灌之。
治酒醉不醒方	治酒醉不醒方――（解酒毒）<br>（《太平圣惠方》）<br>【配方】豉一合，葱白（切）一合。<br>【制法】上件药，以水二大盏，煮取一盏，去滓。<br>【主治】治酒醉不醒。<br>【用法】涓涓饮之。
治酒醉不醒又方	治酒醉不醒又方――（解酒毒）<br>（《太平圣惠方》）<br>【配方】菘菜子二合。<br>【制法】上药细研，以井华水一大盏调之。<br>【主治】治酒醉不醒。<br>【用法】分为三（二服）。
治冷虫心痛酒方	治冷虫心痛酒方――（虫证）<br>（《本草纲目》）<br>【配方】川椒四两。<br>【制法】炒出汗，酒一碗淋之。<br>【主治】冷虫心痛。<br>【用法】服酒。<br>说明：《本草纲目》卷三十二蜀椒条注“引寿域神方”，本方名系笔者所加。