坑前有个盆	坑前有个盆，盆里有个瓢，<br>瓢里盛着钱，拿钱去商店买糖，<br>尝尝糖，甜不甜，不甜不给钱！
从前有个猪八戒	从前有个猪八戒，<br>走到百花桥娘头，<br>跑到百花店里头，<br>坐勒八仙台娘头，<br>吃腊铜钱八元八角八分八厘八、八、八、八、八…… 
老师撕试纸	老师撕试纸,试纸变紫纸。
妈妈卖麦	妈妈卖麦，麦卖妈妈买袜。
滚花龙缸盛滚龙虾汤	滚花龙缸盛滚龙虾汤，虾汤鲜，花缸掀。 
我都家列有只白鼻头猫	我都家列有只白鼻头猫,<br>白鼻头婆婆家列也有只白鼻头猫,<br>白鼻头婆婆家列个白鼻头猫没落列,<br>硬刚我都家列个白鼻头猫是白鼻头婆婆家列个白鼻头猫。
舅舅吃酒	舅舅吃酒，酒醉舅舅求救。 
清水煮青鱼	清水煮青鱼，清水注进青鱼嘴。
八个人夹八根夹棍	八个人夹八根夹棍。（念五遍）
老狼走进老狼	庙老狼走进老狼庙，探落老凉帽。
广东话绕口令	郭蔼明见过郭可盈，话郭可盈个袋型，郭可盈叫郭蔼明过海改个袋型，改成郭可盈个袋 
上海话绕口令	庙里一只猫，庙外一只猫。<br>庙里猫咬庙外猫，庙外猫咬庙里猫。<br>勿晓得到底是庙里猫咬庙外猫，还是庙外猫咬庙里猫。
土堆土豆腿肚子	土堆土豆腿肚子。（念五遍）
风风和东东	风风和东东一起去打工，<br>找到一个桶，<br>挖了一个洞,<br>风风拿着桶,<br>东东钻进洞。
大猫抱小猫	大猫抱小猫，<br>小猫找大猫。<br>大猫抱小猫藏猫猫，<br>小猫在大猫的怀里叫喵喵。 
喝水	菲菲有只灰黑杯，<br>辉辉有只黑灰杯，<br>菲菲喝水不用黑灰杯用灰黑杯，<br>辉辉喝水不用灰黑杯用黑灰杯。<br>菲菲辉辉爱卫生，<br>不乱用灰黑杯和黑灰杯。
大娘和小祥 	江大娘买大梁，<br>项小祥买香肠。<br>买大梁的江大娘和买香肠的项小祥，<br>一起到市场。<br>江大娘买了一根梁，<br>项小祥买了二斤肠。<br>江大娘买的大梁江大娘扛不动，<br>买香肠的项小祥帮买大梁的江大娘扛大梁，<br>买梁的江大娘帮买香肠的项小祥提香肠。 
长江黄河 	长江长，黄河弯，<br>黄河没有长江长，<br>长江没有黄河弯。
鹅追鹅	鹅呀鹅，鹅追鹅，<br>鹅呀鹅，鹅过河，<br>鹅追鹅，鹅过河，<br>鹅过河，鹅追鹅，<br>小鹅过河追大鹅，<br>我也过河去赶鹅，<br>赶着大鹅小鹅过小河。
香肠	香肠长，长香肠，<br>炒香肠，尝香肠，<br>常炒香肠，常尝香肠。
白天黑夜	冬天黑夜长，<br>夏天白天长，<br>夏天比冬天白天长，<br>冬天比夏天黑夜长。
猫捉鼠	粮仓里边有稻谷，<br>小猫咪咪来看护，<br>睁大眼睛不马虎。<br>忽然发现一只鼠，<br>偷偷摸摸来吃谷，<br>咪咪一把抓过去，<br>老鼠乖乖成俘虏。<br>左抓抓，右拱拱，<br>吓得老鼠心打鼓，<br>眼看小命要入土。
送梨	有个小孩叫齐齐，<br>路上捡了几只梨，<br>一看前面推车的，<br>是赶集卖梨的米阿姨。<br>米阿姨推着梨脚步急，<br>小齐齐不迟疑，<br>马上跑步追米姨。<br>追上米姨递上梨，<br>米姨坚决不收梨，<br>说声谢谢小齐齐，<br>阿姨再奖你几个大甜梨。
拦兔追鹿	老虎拦住鹿和兔的路，<br>张着嘴巴要吃兔。<br>兔子捂着肚子呜呜哭，<br>说是吃草中了毒。<br>老虎放开兔子去追鹿，<br>左找右找找不着鹿，<br>回头再来抓小兔，<br>没了兔，没了鹿，<br>气得老虎直发怒。
一个瓜	金瓜瓜，银瓜瓜，<br>瓜棚里结瓜瓜。<br>瓜瓜熟，落下来，<br>打着坐着的小娃娃。<br>小娃娃瞪瓜瓜，<br>要打瓜瓜打不着，<br>哭着叫妈妈，<br>妈妈抱娃娃，<br>手指大瓜瓜，<br>瓜瓜笑娃娃。 
爷爷打狗	爷爷今年六十六，<br>推着车子去卖肉。<br>半路碰见一条狗，<br>狗追车子想吃肉。<br>爷爷拿棍去打狗，<br>吓得饿狗扭头走。 
踢毽子	小燕子踢毽子，<br>小建子数毽子。<br>毽子上，毽子下，<br>毽子上上又下下，<br>累坏数数的小建子，<br>乐坏踢毽的小燕子。
吃核桃	我敲桃壳你剥肉，<br>吃掉桃肉甩掉壳。<br>桃壳甩得门角落，<br>门角落头有桃壳。
泡泡	宝宝吹泡泡，泡泡跑了，<br>宝宝追泡泡，泡泡爆了爆宝宝。
手拿两瓶醋	手拿两瓶醋，肩背两尺布，急忙去赶路。<br>走到半路途，看见一只兔。<br>放下醋，丢掉布，慌忙去追兔。<br>逃掉兔，倒掉醋，醋染布，白辛苦。 
白塔	白石造白塔，<br>白塔白石塔。<br>层层白石搭白搭，<br>白塔层层高又大。<br>高高白塔入白云，<br>白云上面有白塔。 
满碗饭	红碗饭，黄饭碗，<br>红饭碗盛满碗饭，<br>黄饭碗盛半碗饭，<br>黄饭碗添半碗饭，<br>和红饭碗一样盛了满碗饭。
两只小猫	黑猫白猫去偷桃，<br>看见小狗守着桃。<br>黑猫与狗打招呼，<br>掩护白猫去偷桃。<br>小狗眼尖“汪汪”叫，<br>捉住黑猫和白猫。<br>咬痛肉，咬去毛，<br>黑猫白猫哭“喵喵”。 
甜和咸	玲玲买来盐，用舌舔一舔。<br>是咸不是甜，是甜不是盐。<br>是咸才是盐。
贝贝和菲菲 	贝贝飞纸飞机，菲菲要贝贝的纸飞机，<br>贝贝不给菲菲自己的纸飞机，<br>贝贝教菲菲自己做能飞的纸飞机。
白菜和海带 	买白菜，搭海带，不买海带就别买大白菜。<br>买卖改，不搭卖，不买海带也能买到大白菜。
大嫂子和大小子 	一个大嫂子，一个大小子。<br>大嫂子跟大小子比包饺子，<br>看是大嫂子包的饺子好，<br>还是大小子包的饺子好，<br>再看大嫂子包的饺子少，<br>还是大小子包的饺子少。<br>大嫂子包的饺子又小又好又不少，<br>大小子包的饺子又小又少又不好。
阿尔及利亚的阿尔及尔 	要说“尔”专说“尔”/马尔代夫，喀布尔/阿尔巴尼亚，扎伊尔/卡塔尔，尼伯尔/贝尔格莱德，安道尔/萨尔瓦多，伯尔尼/利伯维尔，班珠尔/厄瓜多尔，塞舌尔/哈密尔顿，尼日尔/圣彼埃尔，巴斯特尔/塞内加尔的达喀尔，阿尔及利亚的阿尔及尔。
女小吕和女老李 	这天天下雨，体育局穿绿雨衣的女小吕，去找穿绿运动衣的女老李。<br>穿绿雨衣的女小吕，没找到穿绿运动衣的女老李，穿绿运动衣的女老李，也没见着穿绿雨衣的女小吕。
鼓上画只虎 	鼓上画只虎，破了拿布补。<br>不知布补鼓，还是布补虎。 
伊犁马 	门前有八匹大伊犁马，你爱拉哪匹马拉哪匹马。（重复五遍） 
司机买雌鸡 	司机买雌鸡，<br>仔细看雌鸡，<br>四只小雌鸡，<br>叽叽好欢喜，<br>司机笑嘻嘻。
三山撑四水 	三山撑四水，四水绕三山，<br>三山四水春常在，四水三山四时春。
一堆粪 	一堆粪，一堆灰，灰混粪，粪混灰。（重复五遍）
六十六岁刘老六 	六十六岁刘老六，<br>修了六十六座走马楼，<br>楼上摆了六十六瓶苏合油，<br>门前栽了六十六棵垂杨柳，<br>柳上拴了六十六个大马猴。<br>忽然一阵狂风起，<br>吹倒了六十六座走马楼，<br>打翻了六十六瓶苏合油，<br>压倒了六十六棵垂杨柳，<br>吓跑了六十六个大马猴，<br>气死了六十六岁刘老六。 
炖冻豆腐 	会炖我的炖冻豆腐，<br>来炖我的炖冻豆腐，<br>不会炖我的炖冻豆腐，<br>就别炖我的炖冻豆腐。<br>要是混充会炖我的炖冻豆腐，<br>炖坏了我的炖冻豆腐，<br>哪就吃不成我的炖冻豆腐。 
补破皮褥子不如不补破皮褥子 	补破皮褥子不如不补破皮褥子（重复五遍）
娃娃和妈妈 	娃娃画画，妈妈绣花。<br>娃娃画绣花的妈妈，<br>妈妈绣画画的娃娃。 
刘小牛与柳小妞 	刘村有个刘小牛，<br>柳村有个柳小妞。<br>刘小牛去放牛，<br>柳小妞种石榴。<br>刘小牛让柳小妞骑牛牛，<br>柳小妞让刘小牛吃石榴。
蒸馍馍 	锅锅蒸馍馍，<br>馍馍蒸了一锅锅，<br>馍馍搁上桌桌，<br>桌桌上面有馍馍。 
风儿和铃儿 	风儿停停，风儿行行，<br>风儿吹着铃铃，<br>铃铃响响停停，<br>宝宝看看听听。 
缝裤缝 	一条裤子七道缝，<br>斜缝竖缝和横缝，<br>缝了斜缝缝竖缝，<br>缝了竖缝缝横缝。
狗咬狗 	狗咬狗，狗被狗咬狗就吼，<br>狗吼把咬狗的狗轰走，<br>狗再也不敢狗咬狗。
小鸭下水洼 	小鸭下水洼，<br>水洼有水花，<br>小花陪小鸭抓小虾，<br>小虾躲着小鸭抓。 
小扁担 	小扁担，三尺三，<br>扁担不离肩，<br>扁担挑担担，<br>一边一座山。 
坐车 	田田和建建，争了大半天，<br>田田说坐汽车前面抖，<br>建建说坐汽车后边颤。<br>到底前面抖还是后颤。<br>请你告诉田田和建建。
小石拾柿 	小石拾柿拾到四十四，<br>拿到秤上试，需要称两次。<br>头次秤三十，斤数整四十；<br>二次称十四，四斤四两四。<br>两次称柿子。<br>共是四十四斤四两四。
编细席 	一席地里编细席，<br>编得细席细又密。<br>编好细席戏细席，<br>细席脏了洗细席。
猴拍球 	一群猴，打篮球<br>猴拍球蹦球碰头，<br>球蹦猴拍头碰球，<br>球碰猴头球蹦跳，<br>猴拍蹦球头碰球。 
1和7 	1是1，7是7，17是17。<br>17倒过来，便是71。<br>71去掉1，变成一个7。<br>17去掉7，剩下一个1。<br>7后加个7，便成77。<br>77倒过来，仍是77。 
肉和豆 	肉炒豆，豆炒肉，肉是肉，豆是豆。<br>肉炒豆肉里有豆，豆炒肉豆里有肉。
小王和小黄 	小王和小黄，一块画凤凰。<br>小王画黄凤凰，小黄画红凤凰。<br>红凤凰黄凤凰，只只画成活凤凰，<br>望着小王和小黄。 
摘柿子 	四个孩子摘柿子，<br>老大摘了四个十，<br>老二摘了十个四，<br>老三摘了四十个，<br>老四摘了十四又四十。
鞋子和茄子 	爷爷买双鞋子，奶奶买斤茄子。<br>爷爷爱吃奶奶烧的茄子，<br>奶奶爱穿爷爷挑的鞋子，<br>爷爷奶奶吃完茄子试鞋子。
提灯笼 	小凤提着圆灯笼，<br>小龙提着方灯笼。<br>小凤的圆灯笼上画着龙，<br>小龙的方灯笼上画着凤，<br>小凤要拿圆龙灯笼换小龙的方凤灯笼。
造纸 	造纸张，用纸浆，<br>纸浆造纸出纸张。<br>草纸浆，木纸浆，<br>造出纸张有短长。<br>长纸张，用纸浆，<br>短纸张，用纸浆，<br>张张纸张用纸浆。 
左眼右眼 	左眼上有左上眼皮儿，<br>右眼上有右上眼皮儿，<br>左上眼皮儿打不着右下眼皮儿，<br>右上眼皮儿打不着左下眼皮儿。
青松岭  	青松岭，青松顶，<br>青松顶停蜻蜓静，<br>蜻蜓静，蜻蜓停，<br>蜻蜓静停青松顶。 
下棋  	两个老棋迷，一起来下棋。<br>棋迷老李要吃棋迷老齐的车，<br>棋迷老齐不让棋迷老李吃车。<br>不知棋迷李胜过棋迷齐，<br>还是棋迷齐胜过棋迷李。 
墙壁和壁纸  	墙壁贴壁纸，下雨墙壁湿。<br>壁湿壁纸湿。纸湿壁更湿。<br>撕纸换湿纸，湿纸撕下换壁纸，壁纸不湿纸不撕。
妹子盖被子  	妹子盖被子，被子盖妹子。<br>妹子要盖被子，被子盖住妹子。<br>妹子盖被子是被子盖妹子，被子盖妹子是妹子盖被子。 
树  	坡上一棵粗树，<br>坡下一棵秃树。<br>坡上粗树看秃树树秃，<br>坡下秃树看粗树树粗。<br>粗树树粗树不秃，<br>秃树树秃树不粗。<br>粗树比秃树粗，<br>秃树比粗树秃。
吃仁儿不吃皮儿  	吃仁儿不吃皮儿，<br>吐皮儿不吐仁儿。<br>磕下皮儿，吃了仁儿，<br>吃了仁儿，吐了皮儿，<br>吐皮儿吃仁儿皮儿里没仁儿。
两张床   	小刚买了两张床，<br>一张短来一张长，<br>长床短床十三尺，<br>短床长一尺，短床变长床，<br>长床短一尺，长床变短床。 
陈庄和郑庄   	陈庄城，郑庄城，<br>两庄城墙都有门。<br>陈庄人走陈庄门，<br>郑庄人走郑庄门。<br>忽然刮来一股风，<br>吹乱陈郑两庄人，<br>陈庄人过郑庄门，<br>郑庄人走陈庄门。
半半摆碗，盼盼摆盘   	半半摆碗，盼盼摆盘。<br>半半不能摆盼盼的盘，<br>盼盼不能摆半半的碗，<br>只能摆完盘子再摆碗，<br>或者摆完碗再摆盘。<br>半半摆完碗帮盼盼摆盘，<br>盼盼摆完盘帮半半摆碗。
巧巧与乔乔   	有个小孩叫巧巧，<br>巧巧哥哥叫乔乔，<br>乔乔划船带巧巧，<br>巧巧乔乔看姥姥。
扔草帽   	隔着墙头扔草帽，<br>也不知草帽套老头儿，<br>也不知老头儿套草帽。
虱子与狮子   	四只箱子，藏着四粒虱子，<br>四粒虱子，吓退四只狮子。
冠希与相机   	打南边来了个冠希<br>手里拿着一台相机<br>打北边来了个名姬<br>胸口露着两个咪咪<br>拿相机的冠希要拿手里的相机拍露咪咪的名姬<br>露咪咪的名姬不让拿相机的冠希把信息存进微机<br>拿相机的冠希非要把相机里的信息存进微机<br>存着信息的微机不知道拿相机的冠希不懂微机<br>也不知道露咪咪的名姬有的已成了人妻<br>于是存着露咪咪名姬信息的微机被拿相机的冠希整死了机<br>拿相机的冠希没想到修理微机会泄露少儿不宜的信息<br>修微机的也没想到冠希微机里的名姬会露着咪咪<br>最后，露咪咪的名姬哭哭啼啼闹分居<br>拿相机的冠希灰头土脸离开特区 
刷牙   	牙刷能刷牙，<br>刷牙用牙刷。<br>牙刷能把牙刷白，<br>牙白就得牙刷刷。
婆婆和嬷嬷   	婆婆和嬷嬷，来到山坡坡，<br>婆婆默默采蘑菇，嬷嬷默默拔萝卜。<br>婆婆拿了一个破簸箕，嬷嬷带了一个薄笸箩，<br>婆婆采了半簸箕小蘑菇，嬷嬷拔了一笸箩大萝卜。<br>婆婆采了蘑菇换饽饽，嬷嬷卖了萝卜买馍馍。 
师父四十四   	山里有个寺，山外有个市，弟子三十三，师父四十四。<br>三十三的弟子在寺里练写字，四十四的师父到市里去办事。<br>三十三的弟子用了四十四小时，四十四的师父走了三十三里地。<br>走了三十三里地就办了四十四件事，用了四十四小时才写了三十三个字。 
卖卵   	有个懒汉本姓阮，提个篮子卖鸡卵，<br>“卖卵”“卖卵”使劲喊，谁都不来买鸡卵，<br>不是鸡卵品种乱，而是鸡卵皮太软。<br>卖不出鸡卵难买饭，回家吃饭路又远，<br>胡乱烧把烂草取取暖，再吃掉篮子里几个软鸡卵。
石、斯、施、史四老师   	石、斯、施、史四老师，天天和我在一起。<br>石老师教我大公无私，斯老师给我精神食粮，<br>施老师叫我遇事三思，史老师送我知识钥匙。<br>我感谢石、斯、施史四老师。 
迟小池吃鱼翅   	紫瓷盘，盛鱼翅，一盘熟鱼翅，一盘生鱼翅。<br>迟小池拿了一把瓷汤匙，要吃清蒸美鱼翅。<br>一口鱼翅刚到嘴，鱼刺刺进齿缝里，疼得小池拍腿挠牙齿。 
长虫围着砖堆转   	长虫围着砖堆转，<br>转完砖堆钻砖堆。 
黄贺和王克   	一班有个黄贺，二班有个王克，<br>黄贺、王克二人搞创作，<br>黄贺搞木刻，王克写诗歌。<br>黄贺帮助王克写诗歌，<br>王克帮助黄贺搞木刻。<br>由于二人搞协作，<br>黄贺完成了木刻，<br>王克写好了诗歌。 
老罗的梨和老李的栗   	老罗拉了一车梨，老李拉了一车栗。<br>老罗人称大力罗，老李人称李大力。<br>老罗拉梨做梨酒，老李拉栗去换梨。 
炖炖冻豆腐   	你会炖炖冻豆腐，你来炖我的炖冻豆腐；<br>你不会炖炖冻豆腐，别胡炖乱炖炖坏了我的炖冻豆腐。 
老方扛着黄幌子   	老方扛着黄幌子，老黄扛着方幌子。<br>老方要拿老黄的方幌子，老黄要拿老方的黄幌子，<br>末了儿方幌子碰破了黄幌子，黄幌子碰破了方幌子。
崔粗腿和崔腿粗    	山前有个崔粗腿，山后有个崔腿粗<br>二人山前来比腿，<br>不知是崔粗腿比崔腿粗的腿粗，<br>还是崔腿粗比崔粗腿的腿粗？ 
六叔和六舅    	出南门，走六步，见着六叔和六舅，<br>叫声六叔和六舅，借我六斗六升好绿豆；<br>过了秋，打了豆，还我六叔六舅六十六斗六升好绿豆。 
虎斗猴    	山前有只虎，山下有只猴。<br>虎撵猴，猴斗虎；<br>虎撵不上猴，猴斗不了虎。 
三娘找山羊    	三娘在山止放三只山羊，<br>三只山羊翻过山梁三娘翻过山梁去找三只山羊。<br>三只山羊躲在杉树旁，<br>三娘找到三只山羊。 
断短扁豆    	门角里放着一大垛断短扁豆。（重复五遍） 
大麦和小麦    	大妹和小妹，一起去收麦。<br>大妹割小麦，小妹割大麦。<br>大妹帮小妹挑大麦，小妹帮大妹捆小麦。<br>大妹小妹收完麦，高高兴兴去打麦。<br>大妹打小麦啪啪噼，小妹打大麦噼噼啪。 
瘸子和矬子    	南面来了个瘸子，腰里别着个橛子，<br>北边来了个矬子，肩上挑着担茄子。<br>别橛子的瘸子要用橛子换挑茄子的矬子的茄子，<br>挑茄子的矬子不给别橛子的瘸子茄子。<br>别橛子的瘸子抽出腰里的橛子打了挑茄子的矬子一橛子，<br>挑茄子的矬子拿起茄子打了别橛子的瘸子一茄子。 
锅摞锅    	锅摞锅，摞锅摞。<br>一共摞了六摞锅，<br>六摞锅上摞六十六张罗面罗，<br>罗面罗里摆六十六个调羹勺。
菠萝与陀螺    	坡上长菠萝，坡下玩陀螺。<br>坡上掉菠萝，菠萝砸陀螺。<br>砸破陀螺补陀螺，顶破菠萝剥菠萝。
霍湖、郭海和汪活    	霍湖、郭海和汪活，三人一起烧茶喝。<br>霍湖点火，郭海烧锅，汪活劈柴火，郭海问汪活为何未劈柴火？<br>霍湖怪郭海，郭海怪汪活，汪活怪劈柴火为何劈不破？
瓜棚挂瓜    	瓜棚挂瓜，瓜挂瓜棚。<br>风刮瓜，瓜碰棚。<br>风刮棚，棚碰瓜。
瓜瓜笑娃娃    	金瓜瓜，银瓜瓜，<br>瓜棚上面结满瓜，<br>瓜瓜落下来，打着小娃娃，<br>娃娃叫妈妈，娃娃怪瓜瓜，瓜瓜笑娃娃。 
孩子和鞋了    	孩子是孩子，鞋子是鞋子，<br>孩子不是鞋子，鞋子不是孩子。<br>是孩子穿鞋子，不是鞋子穿孩子。<br>谁分不清鞋子和孩子，谁就念不准鞋子和孩子。
分不清是鸭还是霞    	天空飘着一片霞，水上游来一群鸭。<br>霞是五彩霞，鸭是麻花鸭，麻花鸭游进五彩霞，五彩霞网住麻花鸭。<br>乐坏了鸭，拍碎了霞，分不清是鸭还是霞。
贾家养虾     	贾家有女初出嫁，嫁到夏家学养虾，<br>喂养的对虾个头儿大，卖到市场直加价。<br>贾家爹爹会养鸭，鸭子虽肥伤庄稼。<br>邻里吵架不融洽，贾家也学养对虾。<br>小虾卡住了鸭子牙，大鸭咬住了虾的夹。<br>夏家公公劝，贾家爹爹压，大鸭不怕吓，<br>小虾装得嗲，夏家贾家没办法。 
风吹藤动铜铃响     	东洞庭，西洞庭，<br>洞庭山上一条藤，<br>藤条顶上挂铜铃，<br>风吹藤动铜铃响，<br>风停藤定铜铃静。
谭老汉买蛋和炭     	谭家谭老汉，挑担到蛋摊，买了半担蛋，<br>挑担到炭摊，买了半担炭，满担是蛋炭。<br>老汉忙回赶，回家炒蛋饭。<br>进门跨门槛，脚下绊一绊，<br>跌了谭老汉，破了半担蛋，<br>翻了半担炭，脏了木门槛。<br>老汉看一看，急得满头汗，<br>连说怎幺办，蛋炭完了蛋，<br>老汉怎吃蛋炒饭。
谁胜谁     	梅小卫叫飞毛腿，卫小辉叫风难追。<br>两人参加运动会，百米赛跑快如飞。<br>飞毛腿追风难追，风难追追飞毛腿。<br>梅小卫和卫小辉，最后不知谁胜谁。
小柳和小妞     	路东住着刘小柳，路南住着牛小妞。<br>刘小柳拿着大皮球，牛小妞抱着大石榴。<br>刘小柳把大皮球送给牛小妞，牛小妞把大石榴送给刘小柳。<br>牛小妞脸儿乐得像红皮球，刘小柳笑得像开花的大石榴。 
蜂和凤     	峰上有蜂，峰上蜂飞蜂蜇凤；<br>风中有凤，风中蜂飞凤斗峰。<br>不知到底是峰上蜂蜇凤，<br>还是风中凤斗蜂。
父母      	父母的父母扶父母，<br>父母扶父母的父母。<br>父母是父母的父母，<br>父母的父母是父母。
男演员、女演员      	男演员、女演员，同台演戏说方言。<br>男演员说吴方言，女演员说闽南言。<br>男演员远东劲族飞行员，女演员演鲁迅著作研究员。<br>研究员、飞行员；吴方言、闽南言。<br>你说男演员演得全不全？
山岩出山泉      	山岩出山泉，山泉源山岩，<br>山泉抱山岩，山岩依山泉，山泉冲山岩。
谁眼圆      	山前有个阎圆眼，<br>山后有个阎眼圆，<br>二人山前来比眼，<br>不知是阎圆眼的跟圆，<br>还是阎眼圆的眼圆。
小黑虎数猪      	爷爷领着孙子黑虎，到猪圈里数黑猪。<br>黑猪圈在猪圈里，各个猪圈都有猪。<br>小黑虎不马虎，挨着个儿地把猪数。<br>黑猪围着小黑虎，转来转去乱乎乎。<br>黑虎数了半天小黑猪，不知哪些黑猪挨过黑虎数，也不知黑虎数过哪些小黑猪。<br>逗得爷爷抿嘴笑，急得黑虎直要哭，爷爷说：“小黑虎，你别哭，这是十五只小黑猪。” 
颗颗豆子进石磨      	颗颗豆子进石磨，<br>磨成豆腐送哥哥，<br>哥哥说我的生产虽然小，<br>可是小小的生产贡献多。
墨与馍      	老伯伯卖墨，老婆婆卖馍，<br>老婆婆卖馍买墨，老伯伯卖墨买馍。<br>墨换馍老伯伯有馍，馍换墨老婆婆有墨。
王七上街去买席      	清早起来雨稀稀，王七上街去买席。<br>骑着毛驴跑得急，捎带卖蛋又贩梨。<br>一跑跑到小桥西，毛驴一下跌了蹄。<br>打了蛋，撒了梨，跑了驴，<br>急得王七眼泪滴，又哭鸡蛋又骂驴。 
砸缸      	小光和小刚，抬着水桶上岗。<br>乒乒乒，乓乓乓，打来打去砸了缸。<br>小光怪小刚，小刚怪小光，小光小刚都怪竹竿和水缸。 
妈妈骑马      	妈妈骑马，马慢；<br>妈妈骂马。<br>妞妞骑牛，牛慢；<br>
会的费，费的不会妞妞拧牛。      	手艺学不会，才料儿用的费<br>正是会的费，费的不会。  
石狮寺前      	石狮寺前有四十四棵涩柿子树，<br>这四十四棵涩柿子树上，住着四十四只小喜鹊。
大花碗      	碗架子上扣着大花碗，<br>大花碗底下扣着个大花活虾蟆。
玲珑塔      	玲珑塔，玲珑塔，玲珑宝塔十叁层，<br>塔前有座庙， 庙内有老僧，老僧当方丈，徒弟有六人；<br>一个叫青头楞，一个叫楞头青；一个叫僧僧头，一个叫点点头；<br>一个是奔胡卢把，一个是把胡卢奔；<br>青头楞会打磬，楞头青会捧笙；<br>僧僧点会吹管，点点僧会撞钟；<br>奔胡卢把会说话，把胡卢奔会念经。
壁上挂只鼓      	壁上挂只鼓，鼓里挂只虎，<br>虎爬破了鼓，拿块布来补，<br>是布补虎，还是布补鼓。
大婆子和小婆子      	大婆子是一个驼子，<br>小婆子是一个跛子，<br>大婆子嘲笑小婆子是一个跛子，<br>小婆子嘲笑大婆子是驼子。
橘子和橘壳      	吃橘子，剥橘壳，<br>橘壳丢啦北边壁角落；<br>弗吃橘子，弗剥橘壳；<br>弗必丢啦北边壁角落。
潮州城里飞英塔      	潮州城里有座飞英塔，<br>飞过一只喜鹊擦一擦，<br>弗晓的是喜鹊来擦塔？<br>还是塔来擦喜鹊？
驼子和胡子      	驼子挑了一担螺蛳，胡子骑了一匹骡子，<br>驼子的螺蛳撞啦胡子的骡子，<br>胡子的骡子踏啦驼子的螺蛳，<br>驼子要胡子赔驼子的螺蛳，<br>胡子要驼子贴胡子的骡子。
驼子骑骡子      	一个驼子骑匹骡子，碰到婆子，挑担茄子，<br>驼子个骡子践到婆子的茄子，<br>婆子拖驼子下骡子，要驼子贴婆子个茄子。
买铃铛      	玲玲和莹莹，上街买铃铛。<br>玲玲买的铃铛响叮当，<br>莹莹买的铃铛叮当响。<br>玲玲莹莹摇铃铛，<br>比比谁的铃铛响。<br>你说是玲玲的铃铛比莹莹的响，<br>还是莹莹的铃铛比玲玲的响？ 
数星星      	晶晶和欣欣，<br>一起看星星。<br>天上星星亮晶晶，<br>晶晶欣欣数星星。 
山前有四十四个小狮子      	山前有四十四个小狮子，山后边有四十四棵紫色柿子树，<br>山前四十四个小狮子吃了山后边四十四棵紫色柿子树的涩柿子，<br>山前四十四个小狮子让山后边四十四棵紫色柿子树的涩柿子给涩死了。
字纸里裹着细银丝      	字纸里裹着细银丝，细银丝上趴着四千四百四十四个似死似不死的小死虱子皮。 
小柱有本小书      	小柱有本小书，书上画棵小树，树下有头小猪。<br>小路撕破小柱的小书，撕坏了书上的小树，没撕坏树下的小猪。<br>小柱要小路赔小书，小路对小柱说：“我赔你的小书，赔你书上的小树，不赔你树下的小猪。” 
小徐钓鱼钓不起大鱼      	小徐钓鱼钓不起大鱼，鱼杆怨鱼钩太直不够曲，<br>鱼钩怨鱼杆太曲不够直，也不知是杆曲钩直，还是杆直钩曲？
苇编五绝      	芦苇高，芦苇长，芦花似雪雪茫茫。芦苇最知风儿暴，芦苇最知雨儿狂。<br>芦苇高，芦苇长，芦苇荡里捉迷藏。多少高堂名利客，都是当年放牛郎。<br>芦苇高，芦苇长，隔山隔水遥相望。芦苇这边是故乡，芦苇那边是汪洋。<br>芦苇高，芦苇长，芦苇荡边编织忙。编成卷入我行囊，伴我从此去远航。<br>芦苇高，芦苇长，芦苇笛声多悠扬。牧童相和在远方，令人牵挂爹和娘。 
南边的哑巴和北边的喇嘛      	打南边来了个哑巴，腰里别了个喇叭；<br>打北边来了个喇嘛，手里提了个獭犸。<br>提着獭犸的喇嘛要拿獭犸换别着喇叭的哑巴的喇叭；<br>别着喇叭的哑巴不愿拿喇叭换提着獭犸的喇嘛的獭犸。<br>不知是别着喇叭的哑巴打了提着獭犸的喇嘛一喇叭；<br>还是提着獭犸的喇嘛打了别着喇叭的哑巴一獭犸。<br>喇嘛回家炖獭犸；<br>哑巴嘀嘀哒哒吹喇叭 
四是四，十是十      	四是四，十是十；<br>十四是十四，四十是四十；<br>别把四十说喜席，别把十四说席喜。<br>要想说好四和十，全靠舌头和牙齿。<br>要想说对四，舌头碰牙齿；<br>要想说对十，舌头别伸直。<br>认真学，常练习，十四、四十、四十四。
我的穿着      	我穿的阿尔泰山、天山、昆仑山、罔底斯山、唐古拉山、喜马拉雅山，<br>还穿了祁连山、巴颜喀拉山、横断山、阴山、贺兰山、六盘山、邛崃山、大雪山、大凉山、太行山、大巴山、大娄山、大别山、武夷山、十万大山、华山、泰山、嵩山、衡山、玉山、阿里山，外穿一件长白山。(一口气越说越快) 
旅游      	我先乘落杉矶，又骑巴拿马、罗马，<br>然后换上由北冰洋、太平洋、大西洋、印度洋这四头羊拉的雪橇，<br>一上新加坡、吉隆坡就到家了。<br>这就是多米尼加、马达加斯加、牙买加。 
四个表妹      	大表妹波兰，二表妹芬兰，三表妹新西兰，四表妹纽芬兰。 
一个一个拾到（十道）黑      	一道黑，两道黑，三四五六七道黑，八九道黑十道黑。<br>买个烟袋乌木杆儿，抓住两头一道黑。<br>二姐描眉去打鬓，照着个镜子两道黑。<br>粉皮墙写川字儿，横瞧竖瞧三道黑。<br>象牙的桌子乌木的腿儿，放在炕上四道黑。<br>买个小鸡不下蛋，圈在笼里捂到（五道）黑。<br>挺好的骡子不吃草，拉到街上遛到（六道）黑。<br>买了个小驴不拉磨，鞴上鞍?骑（七）到（道）黑。<br>姐俩南洼去割麦，丢了镰刀拔到（八道）黑。<br>月窠儿孩子得了疯病，尽点儿艾子灸到（九道）黑。<br>卖瓜籽的没注意，刷拉撒了一大堆，条帚簸箕不凑手，一个一个拾到（十道）黑。 
蓝凤凰,粉凤凰,蓝粉凤凰,黄凤凰      	蓝凤凰,粉凤凰,蓝粉凤凰,黄凤凰.（连念五遍）
槟子、橙子、桔子、柿子、李子、栗子、梨      	闲来没事出城西，树木榔林数不齐，一二三四五六七，七六五四三二一，六城四，三二一，五四三二一，四三二一三二一，二一一，一个一，数了半天一棵树，一棵树长了七个枝，七个枝结了七样果，结的是槟子、橙子、桔子、柿子、李子、栗子、梨！
瘸子和茄子      	打南边来个瘸子，担了一挑子茄子，手里拿着个碟子，地下钉着木头橛子。<br>没留神那橛子绊倒了瘸子，弄撒了瘸子茄子，砸了瘸子碟子，瘸子毛腰拾茄子。<br>北边来个醉老爷子，腰里掖着烟袋别子，过来要买瘸子茄子，瘸子不卖给醉老爷子茄子，<br>老爷子一生气抢了瘸子茄子，瘸子毛腰捡茄子拾碟子，拔橛子，追老爷子，<br>老爷子一生气，不给瘸子茄子，拿起烟袋别子，<br>也不知老爷子的烟袋别子打了瘸子茄子，也不知瘸子橛子打了老爷子烟袋别子。<br>什么上山吱扭扭？什么下山乱点头？什么有头无有尾？什么有尾无有头？
我家有个肥净白净八斤鸡      	我家有个肥净白净八斤鸡，飞到张家后院里。<br>张家院有个肥净白净八斤狗，咬了我的肥净白净八斤鸡。<br>我拿他的肥净白净八斤狗赔了我的肥净白净八斤鸡。
狗啃油篓篓油漏      	说我诌，我倒诌，闲来没事我溜溜舌头。<br>我们那儿有六十六条胡同口，住着一位六十六岁的刘老六，他家里有六十六座好高楼，楼上有六十六篓桂花油，篓上蒙着六十六匹绿绉绸。<br>绸上绣六十六个大绒球，楼下钉着六十六根儿檀木轴，轴上拴六十六条大青牛。<br>牛旁蹲着六十六个大马猴。<br>六十六岁的刘老六，坐在门口啃骨头。<br>南边来了一条狗，这条狗，好眼熟，它好像大大妈家大大妈妈脑袋、大大妈妈眼睛、大大妈妈耳朵、大大妈妈尾巴、大大妈妈家鳌头狮子狗。<br>北边又来一条狗，这条狗，嘿！又眼熟，它好像二大妈妈家、二大妈妈脑袋、二大妈妈眼睛、二大妈妈耳朵、二大妈妈尾巴、二大妈妈家鳌头狮子狗。<br>两条狗打架抢骨头，打成仇。<br>吓跑了六十六个大马猴，吓惊了六十六条大青牛，拉折了六十六根儿檀木轴，倒了六十六座好高楼，洒了六十六篓桂花油，油了六十六匹绿绉绸，脏了六十六个大绒球。<br>南边来个气不休，手里拿着土坯头去砍着狗的头，也不知气不休的土坯头打了狗的头，也不知狗的头碰坏气不休的土坯头。<br>北边来了个秃妞妞，手里拿着个油篓口去套狗的头。<br>也不知秃妞妞的油篓口套了狗的头，也不知狗的头钻了秃妞妞的油篓口。<br>狗啃油篓篓油漏，狗不啃油篓篓不漏油。 
灰、龟、鬼      	远望一堆灰，灰上蹲个龟，龟上蹲个鬼。<br>鬼儿无事挑担水，湿了龟的尾，龟要鬼赔龟的尾，鬼要龟赔鬼的水。
螺蛳和骡子      	胡子担了一担螺蛳，驼予骑了一匹骡子。<br>胡子的螺蛳撞了驼子的骡子，驼子的骡子踩了胡子的骡蛳。<br>胡子要驼子赔胡子的螺蛳，驼子要胡子赔驼子的骡子。<br>胡子骂驼子，驼子打胡子，螺蛳也爬到骡子头上去啃鼻子。
菇乡菇棚架      	菇乡菇棚架，架架挂南瓜。<br>菇棚挂瓜，挂瓜棚架。<br>棚棚菇架挂南瓜，只只南瓜挂棚架。<br>架挂瓜，瓜挂瓜，架架棚上瓜挂瓜，瓜挂瓜棚棚挂瓜。<br>风刮菇棚瓜，瓜碰菇棚架，架碰棚上瓜，不知是瓜碰了架上瓜，还是架碰了瓜边架。 
小牛放学去打球      	小牛放学去打球，踢倒老刘一罂油!<br>小牛转屋拿倒油，向老刘道歉又赔油。<br>老刘唔爱小牛还油，小牛硬爱还油分老刘。<br>老刘说小牛，小牛紧奋头。<br>你团老刘等小牛还油，还系唔使小牛来还油？
《越唱越带劲儿》      	进了门儿，倒杯水儿，喝了两口儿运运气儿，<br>顺手那起小唱本，唱了一曲儿又一曲儿，练完嗓子练嘴皮儿。<br>绕口令儿，练字音儿，还有单弦儿牌子曲儿，<br>小快板儿大鼓词儿，越说越唱越带劲儿。
小兔子开铺子      	小兔子开铺子，开开铺子，<br>一张小桌子，两把小椅子，<br>三根小绳子，四只小匣子，<br>五管小笛子，六条小棍子，<br>七个小盘子，八个小豆子，<br>九本小册子，十双小筷子。
鹤望河与鹅      	河上是坡，坡下是河。<br>宽宽的河，肥肥的鹅。<br>河坡飞来丹顶鹤，鹤望河与鹅。<br>小鹤笑呵呵，不知是鹅过河，还是河渡鹅。
老吕和老徐      	老吕和老徐，上街去买鱼，走到半路天下雨。<br>二人都没带雨具，顾不得上街去买鱼，先去地方去躲雨。
村里有个顾老五      	村里有个顾老五，穿上新裤去卖谷。<br>卖了谷，买了布，外加一瓶老陈醋。<br>肩背布，手提醋，老王急忙来赶路。<br>走了一里路，看见一只兔，<br>老王放下布和醋，糊里糊涂去追兔。<br>挂破了裤，也没追上兔，回来不见布和醋。 
早招租，晚招租      	早招租，晚招租，总找邹周郑曾朱。
康煎有个本      	康煎有个本，本里有个标，<br>标里乘着煎。拿着煎上社去买当，<br>尝尝当，颠不颠，不颠不起煎。
瞎阿华喊黑阿花      	瞎阿华喊黑阿花，黑阿花吓瞎阿华。
黄碗合活鸭      	黄碗合活鸭。（念五遍） 
平遥绕口令      	门圪拉里有个杌子，杌子脑头放的一只钵子，<br>钵子里放的麸子，麸子脑头插的尺子，<br>尺子脑头还落的只鸭子，<br>跌倒杌子，摔了钵子，洒了麸子，折了尺子，<br>飞了鸭子，扶起杌子，捏起钵子，掬起麸子…… 
广东绕口令      	奄金琴军今暗暗，混吉挖金挖甘桔，<br>金骨挖桔挖银骨，银桔甩金不挖得，<br>金骨混笔挖金粒，粒粒金粒挖银桔，<br>银桔挖笔梗不吉，不吉挖金更不吉，<br>笔墨挖骨得不偿失，得失混吉挖金笔，<br>毕生大吉 
虎和兔      	坡上有只在大老虎，<br>坡下有只小灰兔。<br>坡上老虎饿肚肚，<br>想吃坡下小灰兔。<br>虎追兔，兔躲虎，<br>老虎满坡找灰兔，<br>刺儿扎痛虎屁股。<br>气坏了老虎，乐坏了灰兔。
小四约小石      	小四约小石学写字，<br>小石约小四看电视。<br>小四不看电视只要学写字，<br>小石不学写字只看电视。
买柿子      	四个小孩子，<br>翱着小篮子，<br>来到小集市，<br>要买红柿子。<br>每人买四只，<br>回家乐滋滋。
喂鸡      	白阿姨、黄阿姨、花阿姨，<br>养鸡场里来喂鸡。<br>白阿姨喂七百一十七只大黄鸡，<br>黄阿姨喂七百七十一只大花鸡，<br>花阿姨喂七百七十七只大白鸡。<br>三个阿姨一合计，<br>要用机器来喂鸡，<br>造了一套喂食机。 
山岗上      	三只牛儿上山岗，<br>山岗上三个牛铃响。<br>牛铃响，响山岗，<br>山岗上三个铃铛响叮当，<br>铃铛响山岗。
写字      	歪脖子，趴桌子，<br>不是写字好姿势，<br>时间久了变近视。<br>写字身子要坐直，<br>眼睛离纸是一尺。
有豆有扣      	小篓篓，有豆豆还有扣扣，<br>娃娃想拿豆豆却拿起扣扣，<br>又想拿起扣扣却又拿起豆豆，<br>豆豆扣扣，都让娃娃放回篓篓。
运河和通州      	东运河，西运河，<br>东西运河运东西。<br>南通州，北通州，<br>南北通州通南北。
黄果树瀑布      	黄果树瀑布像白布，<br>黄果树瀑布像白幕。<br>白布是白布，像白布的不是白布。<br>白幕是白幕，像白幕的不是白幕。<br>瀑布不是白布也不是白幕。<br>瀑布就是瀑布。 
翻跟头      	小牛牛，围兜兜，<br>兜兜里头装豆豆，<br>吃了豆豆翻跟头，<br>左边翻个六，漏了九颗豆。<br>右边翻个九，漏了六颗豆。<br>问你翻了几个大跟头，漏了几颗小豆豆？ 
公公和冬冬      	楼上住个老公公，<br>楼下住个小冬冬，<br>小冬冬认字问公公，<br>老公公走路扶冬冬，<br>冬冬说楼上有个好公公，<br>公公说楼下有个乖冬冬。
刘小柳和牛小妞      	路东住着刘小柳，<br>路南住着牛小妞。<br>刘小柳拿着九个红皮球，<br>牛小妞抱着六个大石榴。<br>刘小柳把九个红皮球送给牛小妞，<br>牛小妞把六个大石榴送给刘小柳。<br>牛小妞脸儿乐得像红皮球，<br>刘小柳笑得像开花的大石榴。
娃娃画画      	娃娃画画画花花，<br>娃画花花结瓜瓜，<br>花花结瓜给娃娃，<br>娃娃吃瓜画花花。
白帽和白毛      	白猫手里有一顶白帽，<br>白兔手中有一把白毛，<br>白猫想拿手里的白帽，<br>去换白兔手中的白毛，<br>白兔不愿拿手中的白毛，<br>去换白猫手里的白帽。 
俩白脖子      	陈州有个陈白脖子，<br>毫州有个毫白脖子。<br>陈州的陈白脖子和毫州的毫白脖子比白脖子。<br>陈州的陈白脖子比不过毫州的毫白脖子，<br>毫州的毫白脖子的白脖子，<br>比不过陈州的陈白脖子的长脖子。
补皮裤      	出了南门走十步，<br>拾了一条破皮裤。<br>皮裤破，补皮裤，<br>皮裤不破不必补皮裤。
天上一颗星      	天上一颗星，地下一只钉，<br>钉到墙上挂油瓶，<br>油瓶漏，炒黑豆，黑豆香，换生姜，<br>生姜辣，堆宝塔，宝塔高，打把刀，<br>刀很快，好切菜。 
看姥姥      	有个小孩叫巧巧，<br>巧巧哥哥叫摇摇。<br>摇摇划船带巧巧，<br>巧巧要去看姥姥。<br>姥姥站在桥头笑，<br>欢迎巧巧和摇摇。
白帆船      	蓝海湾，漂帆船，<br>帆船挂着白船帆；<br>风吹船帆帆船走，<br>船帆带着船向前。 
装梨      	小丽丽，小黎黎，<br>叫来妹妹和弟弟。<br>小竹篮，手中提，<br>同到梨园去装梨。<br>一二三，三二一，<br>一二三四五六七。<br>篮装梨，摆整齐，<br>丽丽黎黎笑眯眯。 
拔萝卜      	白须白伯伯，<br>白发白婆婆。<br>伯伯扶婆婆，<br>婆婆扶伯伯，<br上了山坡拔萝卜。<br>白萝卜，红萝卜，<br>白、红萝卜营养多。
墙上一面鼓      	墙上一面鼓，<br>鼓上画老虎。<br>老虎扯破了鼓，<br>拿块布来补。<br>到底布补鼓，<br>还是布补虎。
河湾小船      	三只牛儿上山岗，<br>山岗上三个牛铃响。<br>牛铃响，响山岗，<br>山岗上三个铃铛响叮当，<br>铃铛响山岗。
小裤和小兔      	娃娃有条小裤，<br>上面有只小兔。<br>小裤跟着娃娃迈步，<br>迈步，小兔就跟着小裤。
牛儿上山岗      	弯弯小船在河弯弯玩，<br>河弯弯有个弯弯小船，<br>弯弯船儿拽着浪花一串串，<br>串串浪花也找小船船。
营房里出来两个排      	从营房里出来两个排，<br>直奔正北菜园来，<br>一排浇菠菜，二排砍白菜，三排上山担木柴，<br>剩下他们种的一千八百八十八棵大白菜没有掰。<br>一排浇完了菠菜，还得帮助三排把一千八百八十八棵大白菜掰下来。<br>二排砍完了白菜，还得把一排帮助三排掰下来的一千八百八十八棵大白花菜背回营里来。
哥挎瓜筐过宽沟      	哥挎瓜筐过宽沟，<br>赶快过沟看怪狗，<br>光看怪狗瓜筐扣，<br>瓜滚筐空哥怪狗。
大刀对单刀      	大刀对单刀，<br>单刀对大刀，<br>大刀斗单刀，<br>单刀夺大刀。
苏州有个苏胡子       	苏州有个苏胡子，<br>湖州有个胡夫子，<br>苏胡子问湖夫子借梳子梳胡子。
花猫划破毛毛花袍袍       	花猫划破毛毛花袍袍，花猫划破苗苗花帽帽。	
粉红墙上画凤凰       	粉红墙上画凤凰，<br>红凤凰、黄凤凰，<br>粉红凤凰花凤凰。 
梁上两对倒吊鸟       	梁上两对倒吊鸟，<br>泥里两对鸟倒吊，<br>可怜梁上两对倒吊鸟，<br>惦记泥里两对鸟倒吊，<br>可怜泥里两对鸟倒吊，<br>也惦记梁上两对倒吊鸟。
真稀奇       	稀奇稀奇真稀奇，<br>麻雀踩死老母鸡，<br>蚂蚁身长三尺六，<br>八十老头车里坐。
小猴拍皮球       	小猴小猴拍皮球，<br>一拍拍到水里头，<br>小猴急得直挠头，<br>小鸭游来托起球。
小鸡       	小小鸡，叽叽叽，<br>翅膀短，穿黄衣，<br>只会走，不会飞。<br>爱吃小虫和小米。
斗放豆       	黑豆放在黑斗里，<br>黑斗里边放黑豆，<br>黑豆放黑斗，<br>黑斗放黑豆，<br>不知黑豆放黑斗，<br>还是黑斗放黑豆。
十四四十十四四       	十四四十十四四<br>四十十四四四十<br>四十十四四十四<br>不知是十还是四
姨娘恨林娘       	姨娘恨林娘<br>姨娘打了林娘<br>林娘打了姨娘<br>银娘来劝架被两位娘打了一拳
饥鸡集机记       	唧唧鸡，鸡唧唧。<br>几鸡挤挤集机脊。<br>机极疾，鸡饥极，<br>鸡冀己技击及鲫。<br>鸡既济蓟畿，<br>鸡计疾机激几鲫。<br>机极疾，鲫极悸，<br>急急挤集矶级际。<br>继即鲫迹极寂寂。<br>继即几鸡既饥即唧唧。
水上漂着一只表       	水上漂着一只表，<br>表上落着一只鸟。<br>鸟看表，表瞪鸟，<br>鸟不认识表，<br>表也不认识鸟。 
长城长，城墙长       	长城长，城墙长，<br>长长长城长城墙，<br>城墙长长城长长。
大兔子，大肚子       	大兔子，大肚子，<br>大肚子的大兔子，<br>要咬大兔子的大肚子。 
字纸里包着细银丝       	不知字纸里有多少字，<br>字纸里包着细银丝，<br>细银丝上爬着四千四百四十四只似死似不死的死虱子皮。
红鸡和灰鸡       	红鸡公尾巴灰，<br>灰鸡公尾巴红。
大蛋炸弹       	大蛋炸弹（连读五遍）
倒影       	清清楚楚一幅画，<br>有树有草也有花；<br>别处花草梢朝上，<br>此处花草梢朝下。
倒草倒掉稻       	倒草倒掉稻，<br>草倒稻也倒。<br>倒草别倒稻，<br>倒稻别倒草。 
书费本费书本费       	书费本费书本费（连读五遍） 
比尖       	尖塔尖，尖杆尖，<br>杆尖尖似塔尖尖，<br>塔尖尖似杆尖尖。<br>有人说杆尖比塔尖尖，<br>有人说塔尖比杆尖尖。<br>不知到底是杆尖比塔尖尖，<br>还是塔尖比杆尖尖。 
七巷漆匠和西巷锡匠       	七巷一个漆匠，西巷一个锡匠。<br>七巷漆匠用了西巷锡匠的锡，<br>西巷锡匠拿了七巷漆匠的漆，<br>七巷漆匠气西巷锡匠用了漆，<br>西巷锡匠讥七巷漆匠拿了锡。
烧香要烧萧山香       	烧香要烧萧山香，<br>萧山蜡烛萧山香，<br>走到萧山去烧香。
福气好，胡须好       	祖父好福气，<br>长得好胡须；<br>人人都说好，<br>福气好，胡须好；<br>福气好，胡须好。
白狗和白头翁       	白妈有一条白狗，<br>白伯伯有一只白头翁。<br>有一天，白伯伯的白头翁，<br>带了白妈的一条白狗，<br>同到白山去白相。 
八十八个毕卜虫       	墙头上有八十八个毕卜虫格洞，<br>八十八个毕卜虫格洞里有八十八个毕卜虫；<br>剥过格八十八个毕卜虫格皮，<br>糊过格八十八个毕卜虫格洞。
大的铜钱丢入大的铜钱笼       	大的铜钱丢入大的铜钱笼，<br>小的铜钱丢入小的铜钱笼。
麻答新人麻答郎       	麻答新人麻答郎，<br>麻答伯伯来送房。<br>麻答爷娘堂上佳，<br>麻饼麻片麻酥糖。
银子进荷包       	银子进荷包，撩，撩，撩，<br>撩起儿子捡柴烧，<br>一天捡一担，<br>二天捡一挑，<br>又有卖，又有烧，<br>又有银子进荷包。
裤破筷坏       	两条裤子希奇古，<br>两条裤，希奇怪，<br>两只筷，希奇古怪，<br>裤破筷坏。 
河边两只鹅       	河边两只鹅，白鹅与灰鹅，<br>哦哦爱唱歌，唱得渴又饿，<br>昂首吸飞蛾，飞蛾啄不住岸边去找窝。<br>草窝暗又矮，只得去过河，<br>河里真暖和，有吃又有喝，<br>不能再挨饿，遨游真快活，安心唱爱歌。
枣       	出东门，过大桥，大桥前面一树枣，<br>拿着竿子去打枣，青的多，红的少，<br>一个枣，两个枣，三个枣，四个枣，<br>五个枣，六个枣，七个枣，八个枣，<br>九个枣，十个枣；十个枣，九个枣，<br>八个枣，七个枣，六个枣，五个枣，<br>四个枣，三个枣，两个枣，一个枣，<br>这是一个绕口令，一口气说完才算好。 
周邹郑曾朱       	早招租，晚招租，总找周邹郑曾朱。
师部司令部指示       	师部司令部指示：四团十连石连长带四十人在十日四时四十四分按时到达师部司令部，师长召开誓师大会。
日头、石头、舌头和指头       	天上有个日头，地下有块石头，<br>嘴里有个舌头，手上有五个手指头。<br>不管是天上的热日头，地下的硬石头，嘴里的软舌头，手上的手指头，<br>还是热日头，硬石头，软舌头，手指头，反正都是练舌头。 
小郭和小葛       	小郭画了朵红花，小葛画了朵黄花，<br>小郭想拿他的红花换小葛的黄花，<br>小葛把他的黄花换了小郭的红花。 
搬白菜       	掰白菜，搬白菜，<br>掰完白菜搬白菜，<br>搬完白菜掰白菜。
杰杰和姐姐       	杰杰和姐姐，花园里面捉蝴蝶。<br>杰杰去捉花中蝶，姐姐去捉叶上蝶。 
灰粪肥       	老队长召开生产会，号召全队来积肥。<br>要想粮成山，必先肥成堆。<br>小飞挑来村南那堆粪，小会挑来村北那堆灰，<br>村北那堆灰要掺上村南那堆粪，<br>村南那堆粪要拌上村北那堆灰。<br>小飞和小会，谁也不怕累，<br>先把灰混粪，再把粪混灰，混成灰粪肥。
缝凤凰       	粉红女发奋缝飞凤，<br>女粉红反缝方法繁。<br>飞凤仿佛发放芬芳，<br>方法非凡反复防范。<br>反缝方法仿佛飞凤，<br>反复翻缝飞凤奋发。
兔、鼠、树       	一只鼠，一只兔，兔鼠同去伐小树，<br>兔挖土，鼠咬树，惊动吃草小肥猪。<br>猪架兔，兔北鼠，齐心协力撼小树。<br>咯吱一声倒下树，牢牢压住小灰鼠。<br>树压鼠，鼠压兔，兔儿压住小肥猪，<br>猪儿压土唤不住，“兔、鼠、树，树、兔、鼠……”
豆地有豆       	豆地有豆，<br>低头捡豆，<br>豆捡在手，<br>豆装豆篓。
瓜       	爸爸种瓜瓜儿大，<br>妈妈摘瓜摘大瓜，<br>奶奶切瓜分大家，<br>大家吃瓜笑哈哈。
打水漂       	水瓢打水漂，<br>水上漂着瓢。<br>瓢在水上漂，<br>水上有水瓢。
浇花       	浇花浇花快浇花，<br>你不浇花不开花。<br>一盆水，一壶茶，<br>浇好水，开好花。<br>两盆水，两壶茶，<br>花开好，花开大。
补皮鼓       	墙上画只鼓，<br>鼓上画只虎。<br>老鼠咬破鼓，<br>拿块布来补，<br>布补虎还是布补鼓？
虎鹿猪兔鼠       	山上一只虎，<br>林中一只鹿，<br>路边一只猪，<br>草里一只兔，<br>还有一只鼠。<br>数一数，<br>一、二、三、四、五，<br>虎、鹿、猪、兔、鼠。
瓜和花        	 长长藤，开花花，<br>娃娃爱花不去掐，<br>瓜藤开花花结瓜，<br>要吃瓜，不掐花，<br>	娃娃爱花也爱瓜。
城隍庙的包子       	城隍庙的包子, 纯羊毛的标志。 
鼠吃豆和油         	鼠咬豆囤囤漏豆，<br>鼠啃油篓篓漏油篓油，<br>豆囤漏豆鼠啃豆，<br>油篓漏油鼠吸油。
张打铁       	张打铁，李打铁，<br>打把剪刀送姐姐，<br>姐姐留我歇一歇，<br>我要回家学打铁。 
糍粑鸡蛋       	糍粑鸡蛋我要吃，鸡蛋糍粑我也吃
红凤凰，粉凤凰       	红凤凰，粉凤凰，红粉凤凰画在粉红墙上。
买肉和买油       	尤大嫂去买肉，<br>冉大妈去买油，<br>尤大嫂买肉不买油，<br>冉大妈买油不买肉。<br>俩人集上碰了头，<br>尤大嫂请冉大妈到家吃炖肉，<br>冉大妈请尤大嫂去她家喝蜂蜜白糖加香油。
一树枣儿出东门       	一树枣儿出东门，过大桥，<br>一桥底下一树枣儿，<br>拿着竿子去打枣儿。<br>青的多、红的少。<br>一个枣，两个枣，三个枣，四个枣，五个枣，<br>六个枣，七个枣，八个枣，九个枣，十个枣？<br>十个枣，九个枣，八个枣，七个枣，六个枣，<br>五个枣，四个枣，三个枣，两个枣，一个枣。
大花碗里扣个大花活蛤蟆       	大花碗里扣个大花活蛤蟆（连读五遍） 
炖豆腐       	你会炖我的冻豆腐，<br>就来炖我的冻豆腐，<br>你不会炖我的冻豆腐，<br>别胡炖乱炖炖坏了我的冻豆腐。 
西湖与泥壶       	杭州有个西湖，<br>宜兴出产泥壶，<br>西湖店铺卖宜兴泥壶。<br>宜兴泥壶上画着西湖，<br>是游了西湖买宜兴泥壶，<br>还是买了宜兴泥壶再游西湖。 
七种果子摆七样       	七种果子摆七样，<br>苹果、桃儿、石榴、柿子、李子、栗子、梨。
柿子、李子、栗子、梨       	一二三四五六七，<br>七六五四三二一，<br>七个阿姨来摘果，<br>七只篮子手中提。 
蓉子和虫子       	有个小蓉子，<br>提了个小笼子，<br>里头养个小红子，<br>出城去捉小虫子，<br>找着了虫子，<br>放进了笼子，<br>红子吃了虫子。
渠和鱼       	一条小渠，住着一条小鱼，<br>小鱼想游出小渠，小渠笑小鱼，<br>小鱼小鱼你太心急，长大才能游出来。
碰碰船       	公园里面碰碰船，<br>坐着兰兰和南南，<br>南南开船碰兰兰，<br>兰兰开船躲南南。<br>兰兰南南碰一起，<br>乐坏了南南和兰兰。
画瓢       	照葫芦画瓢，照老虎画猫，<br>虎不像虎，猫不像猫，<br>葫芦不像葫芦，瓢不像瓢，<br>还是照虎画虎，照猫画猫，<br>照葫芦画葫芦，照瓢画瓢。
黑和灰       	黑是黑，灰是灰，<br>黑不是灰，灰不是黑，<br>煤是黑，石是灰，<br>烧过变成灰，<br>石涂上墨变了黑。 
采油和漏渍       	大海底下有石油，打井采汩石油流，<br>输油管道流石油，采油运油别漏油，<br>漏了石油污染海，鱼虾海鸟不停留。 
吃桔子       	吃桔子，剥桔子，桔皮丢在垃圾箱里；<br>不吃桔子，不剥桔子，不把桔子皮丢在垃圾箱里。 
换斑竹       	斑竹林里头看干斑竹，<br>包谷林里头有干包谷，<br>潘家三虎直进包谷林，<br>掰了一担干包谷，<br>回家路过斑竹要，<br>换了三根干斑竹。 
鸡蛋碰破石头角       	鸡蛋碰破石头角，<br>老鼠咬着猫子脚。<br>板凳爬上墙，<br>石磙飞过河。<br>先生我，后生哥，<br>妹妹先把十岁过。<br>姐姐带上老花镜，<br>八十岁的婆婆绣花朵，<br>白天伸手不见掌，黑太阳死我。 
唱倒歌       	唱倒歌，倒唱歌，<br>往年少呀今年多。<br>鸡子飞进鸽子笼，<br>鸽子占了燕子窝。 
猜谜       	桌上摆了，一支笔，一面旗，<br>一只小鸡，一个梨，<br>还有一块橡皮泥。<br>阿姨说：桌上有什么？<br>一一记心里，<br>阿姨让你们来猜“谜”。<br>齐齐第一个把手举，<br>他说桌上一支笔，一面旗，<br>一只不鸡，一块橡皮泥，就少了一个梨。 
猜中指       	猜中指，打十五，不打不打二十五，<br>猜到了，一盘肉，猜不到，吃豆腐，<br>猫儿回来憩猪油。 
不要惊吵妈妈       	莎莎告诉佳佳，又去告诉花花，<br>妈妈下班乏了，不要惊吵妈妈。<br>咱们外边玩耍，手帕反眼蒙毒害，<br>玩玩“过桥摸瞎“。<br>莎莎拉着佳佳，佳佳拉着花花。 
卜小五种谷       	卜家卜小五，种了五亩谷。<br>跑来一群鼠，在地里吃谷。<br>小五忙割谷，顾不得捉鼠。<br>小五想捉鼠，就顾不得割谷。<br>忙坏了卜小五，没捉住老鼠，还糟蹋了很多谷。
鹅定鸭       	鹅公鹅母?定?<br>鸭公鸭母鸭定鹅<br>鹅定鸭，鸭定鹅 
一蚊一只鸡       	一蚊一只鸡，<br>七蚊一只龟，<br>到底鸡贵定系龟贵 
入实验室噤紧急制       	入实验室噤紧急制（重复五遍） 
鸡龟骨滚羹       	鸡龟骨滚羹（重复五遍）
墙角落绷根金棍       	墙角落绷根金棍（重复五遍） 
防近视       	史小石，学写字，<br>脸贴书本眼斜视，<br>歪歪扭扭字碰字。<br>司老师，教小石，<br>端正姿势身坐直；<br>离纸一尺防近视，<br>爱护眼睛要坚持。 
四和十       	四是四，十是十，<br>要想说对四，<br>舌头碰牙齿。<br>要想说对十，<br>舌头别伸直。<br>要想说对四和十，<br>多多练习十和四，<br>常常说说四和十。 
铁板钉钉       	钉钉板，<br>板钉钉。<br>铁钉钉铁板，<br>铁板钉铁钉。<br>铁钉钉板钉钉板，<br>铁板钉钉板钉钉。 
调到敌岛打特盗       	调到敌岛打特盗，<br>特盗太叼投短刀。<br>挡推顶打短刀掉，<br>踏盗得刀盗打倒。
老老道小老道       	高高山上有座庙，<br>庙里住着两老道，<br>一个年纪老，一个年纪少。<br>庙前长着许多草，<br>有时候老老道煎药，小老道采药；<br>有时候小老道煎药，老老道采药。
毛毛和涛涛        	毛毛和涛涛，<br>跳高又练跑，<br>毛毛教涛涛练跑，<br>涛涛教毛毛跳高，<br>毛毛学会了跳高，<br>涛涛学会了练跑。 
老爷堂上一面鼓       	老爷堂上一面鼓，<br>鼓上一只皮老虎，<br>皮老虎抓破了鼓，<br>就拿块破布往上补，<br>只见过破布补破裤，<br>哪见过破布补破鼓。
哥哥捉鸽       	哥哥过河捉个鸽，<br>回家割鸽来请客，<br>客人吃鸽称鸽肉，<br>哥哥请客乐呵呵。 
炮兵和步兵       	炮兵攻打八面坡，<br>炮兵排排炮弹齐发射。<br>步兵逼近八面坡，<br>歼敌八千八百八十多。
村里新开一条渠       	村里新开一条渠，<br>弯弯曲曲上山去，<br>河水雨水渠里流，<br>满山庄家一片绿。 
吃橘子       	吃橘子，剥橘子，<br>橘皮丢在垃圾箱里。<br>不吃橘子，不剥橘子，<br>不把橘子丢在垃圾箱里。 
鸡皮补皮裤       	出西门走七步，<br>拾到鸡皮补皮裤。<br>是鸡皮补皮裤，<br>不是鸡皮不必补皮裤。 
肥嫩的嫩巴八斤鸡       	我家有个肥嫩的嫩巴八斤鸡，<br>飞在张家后院里，<br>张家后院有个肥嫩的嫩巴八斤狗，<br>咬了我肥嫩的嫩巴八斤鸡，<br>卖了他肥嫩的嫩巴八斤狗，<br>赔了我肥嫩的嫩巴八斤鸡。
颜圆眼和颜眼圆       	山前住的颜圆眼，山后住的颜眼圆，<br>二人山前来比眼，<br>也不知道颜圆眼比颜眼圆的圆眼，<br>也不知道颜眼圆比颜圆眼的眼圆。
糊我的粉红活佛龛       	你会糊我的粉红活佛龛来糊我的粉红活佛龛，<br>不会糊我的粉红活佛龛，<br>别混充会糊糊坏了我的粉红活佛龛哪。
《施氏食狮史》       	石室诗士施氏，嗜狮，誓食十狮。<br>氏时时适市视狮。十时，适十狮适市。<br>是时，适施氏适市。<br>氏视十狮，恃矢势，使是十狮逝世。<br>氏拾是十狮尸，适石室。<br>石室湿，氏拭室。<br>氏始试食十狮尸。<br>食时，始识十狮尸，实是十石狮尸。<br>试释是事。
面铺面向南       	出南门往正南，<br>有一个面铺面向南，<br>面铺门口挂个蓝市棉门帘，<br>摘了蓝布棉门帘，<br>面铺还是面向南，<br>挂上蓝布棉门帘，<br>瞧了瞧，<br>面铺还是面向南。 
红凤凰粉凤凰       	红凤凰粉凤凰，<br>红粉凤凰粉红凤凰。<br>红凤凰粉凤凰，<br>红粉凤凰粉红凤凰！ 
猪吃我屎，我猪吃屎       	猪吃我屎，我猪吃屎，<br>猪吃我屎，我猪吃屎，<br>猪吃我屎，我猪吃屎，<br>猪吃我屎，我吃猪屎！ 
鹅碰鹅       	天上一只鹅，<br>地上一只鹅，<br>鹅飞，鹅跑，<br>鹅碰鹅。
南门外有个面铺面冲南       	南门外有个面铺面冲南，<br>面铺挂了个蓝布棉门帘，<br>摘了蓝布棉门帘瞧了瞧，<br>面铺还是面冲南，<br>挂上蓝布棉门帘瞧了瞧，<br>面铺还是面冲南。 
截着墙头扔草帽       	截着墙头扔草帽，<br>也不知草帽套老头儿，<br>也不知老头儿套草帽。
敦敦葫芦丫丫葫芦       	敦敦葫芦丫丫葫芦<br>好汉一口气说不了八八六十四个葫芦<br>一个葫芦两个葫芦三个葫芦四个葫芦……<br>一直说到六十四个葫芦 
一面小小鼓       	一面小花鼓<br>鼓上画只虎<br>宝宝敲破鼓<br>妈妈拿布布<br>不知是布布鼓<br>还是布补虎 
鸡碰坯       	炕头一只鸡<br>炕稍一块坯<br>不知是鸡碰了坯<br>还是坯碰了鸡 
班长管班干部       	班长管班干部（重复五遍）
背水杯       	贝贝背水杯，水杯贝贝背。<br>贝贝背水杯背背水杯。<br>水杯贝贝背，贝贝背水杯。
描庙       	东描庙，西描庙，左描庙，右描庙，调转头来描描庙。<br>前描庙，后描庙，这一描，那一描，描得判官满脸毛。
雕和箫       	一把雕刀，雕出好箫。<br>刀是小雕刀，箫是“玉屏箫”。<br>好箫出好调，箫靠好刀雕，刀要艺巧高。 
慢表       	表慢，慢表，慢表慢半秒。<br>慢半秒，拨半秒，拨过半秒多半秒；<br>多半秒，拨半秒，拨过半秒少半秒。<br>拨来拨去是慢表，慢表表慢慢半秒。 
弯弯丘斑斑鸠       	弯前弯后弯弯丘，<br>弯丘弯角里躲着个斑斑鸠。<br>有个弯背的弯老头儿，<br>在弯丘弯角里弯腰捡了个弯砖头。<br>弯老头弯里投砖头，<br>专打弯丘弯角里那个斑斑鸠。 
指示灯       	十字路口指示灯，<br>红黄绿色分得清。<br>绿灯行，红灯停。<br>红灯停，绿灯行。 
望月空满天星       	望月空，满天星，光闪闪，亮晶晶，<br>好象那，小银灯，仔细看，看分明，<br>大大小小，密密麻麻，闪闪烁烁，<br>数也数不清。 
风、松、钟、弓       	走如风，站如松，坐如钟，睡如弓。<br>风、松、钟、弓，弓、钟、松、风，<br>连念七遍口齿清。 
浓雾       	浓浓雾，雾浓浓，<br>浓浓灰雾飞入松。<br>灰雾入松松飞雾，<br>灰雾雾松分不清。
小礼和小丽       	小礼家有梨，<br>小丽家有李。<br>小礼帮小丽摘李，<br>小丽帮小礼摘梨。 
华华和爸爸       	画画的是华华，<br>画的是爸爸，<br>华华爱画爸爸爱花，<br>爸爸爱华华画的画。 
喂蝈蝈       	哥哥喂蝈蝈，<br>蝈蝈要果果，<br>哥哥给果果，<br>蝈蝈叫哥哥。 
妞妞和牛牛       	东头有个李家妞，<br>西头有头刘家牛，<br>刘家牛要吃李家豆，<br>李家妞赶走刘家牛。 
看电视       	对门田老四，<br>喜欢看电视。<br>电视里演戏，<br>戏里有田老师。 
吃菱角       	吃菱角，剥菱壳，<br>菱角丢在北壁角。<br>不吃菱角不剥壳，<br>菱角不丢北壁角。 
布谷鸟       	布谷鸟，<br>叫布谷，<br>布谷布谷，<br>忙忙碌碌，<br>赶快布谷。 
蛙和瓜       	绿青蛙，叫呱呱，<br>蹦到地里看西瓜。<br>西瓜夸蛙唱得好，<br>蛙夸西瓜长得大。 
气球换皮球       	小齐吹气球，小于玩皮球。<br>小齐要拿气球换小于的皮球，<br>小于不拿皮球换小齐的气球。
扣纽扣       	小牛扣扣使劲揪，<br>小妞扣扣对准扣眼扣，<br>小牛和小妞，<br>谁学会了扣纽扣？ 
包枣包       	包枣包，包包枣，<br>宝宝包枣包。<br>枣包包枣枣包包。 
小碗碗和大碗碗       	小碗碗的绿豆汤、芝麻糕、云片糕，<br>还有大碗碗的莲子、红枣、桂圆汤。
一棵树上九十九个节       	一棵树上九十九个节，<br>九十九个节上长九十九片叶，<br>九十九片叶上栖九十九只麻雀；<br>九十九个老人拿九十九根拐棍，<br>打得九十九只麻雀不敢在九十九片叶上歇。 
算算看       	老杜和老顾，<br>齐走富裕路。<br>老杜养了兔，<br>老顾养了鹿。<br>老杜给老顾十只兔，<br>两家平等同只数；<br>老顾给老杜十只鹿，<br>顾家是杜家一半数。<br>请问老杜养了多少兔，<br>再问老顾养了多少鹿。 
灰损肥       	一推肥，<br>一堆灰，<br>肥混灰，<br>灰损肥，<br>不要肥混灰，<br>防止灰损肥。 
糊灯笼       	红红糊红粉灯笼，<br>给军属送光荣灯；<br>芬芬糊粉红灯笼，<br>给军属送灯光荣；<br>红红糊完红粉灯笼，<br>糊粉红灯笼；<br>芬芬糊完粉红灯笼，<br>糊红粉灯笼。 
锡匠和漆匠       	东边来了个锡匠卖锡，<br>西边来了个漆匠卖漆。<br>锡匠拿锡换漆匠的漆，<br>漆匠拿漆换锡匠的锡。<br>锡匠换了六斤六两漆，<br>漆匠换了九斤九两锡。<br>锡匠漆匠笑嘻嘻，<br>锡匠漆匠都有了漆和锡。
磨麦面       	马妈妈磨麦面，<br>磨了麦面蒸麦面馍。<br>马妈妈忙了磨麦面，<br>又去忙蒸麦面馍。 
落果坡       	       	歌乐山上落果坡，<br>落果坡下歌乐河。<br>河边两个小朋友，<br>名叫罗乐和贺河。<br>贺河上午约罗乐，<br>落果坡上去放鹿；<br>罗乐下午约贺河，<br>歌乐河边来牧鹅。<br>鹿上坡，鹅下河，<br>罗乐贺河歌对歌。<br>歌对歌，真快活，<br>歌乐山上歌满坡。 
白鸽和白鹅       	伯伯养了一群大白鹅，<br>哥哥喂了三只小白鸽，<br>伯伯教哥哥训鸽，<br>哥哥帮伯伯放鹅。<br>白鹅白鸽长得好，<br>乐坏了伯伯和哥哥。 
白伯伯和白婆婆       	白须白伯伯，<br>白发白婆婆。<br>鸡叫三更喔喔喔，<br>白伯伯白婆婆一齐上北坡。<br>白伯伯搀着白婆婆，<br>白婆婆扶着白伯伯，<br>白伯伯白婆婆把萝卜种子种在北山坡。
老姥姥       	老姥姥恼姥姥姥姥老恼老姥姥，<br>麻妈妈问妈妈妈妈老问麻妈妈。 
白鹅下河       	东边一条河，<br>西边一群鹅，<br>鹅儿鹅儿唱着歌，<br>一只狐狸来追鹅，<br>鹅飞鹅跑跳下河。 
老鼠嗅着油豆香       	油一缸，豆一筐，<br>老鼠嗅着油豆香。<br>爬上缸，跳进筐，<br>偷油偷豆两头忙。<br>又高兴，又慌张，<br>脚一滑，身一晃，<br>“扑通”一声跌进缸。 
蚕和蝉       	爬来爬去是蚕，<br>飞来飞去是蝉。<br>蚕常在桑叶里藏，<br>蝉藏在树林里唱。 
牛和油       	买来一桶油，<br>跑来一头牛，<br>踢翻桶里油，<br>牛角都是油。 
于瑜与余欲渔遇雨       	于瑜欲渔，<br>遇余于寓。<br>语余：“余欲渔于渝淤，与余渔渝欤？”<br>余语于瑜：“余欲玉，俞禹欲玉，余欲遇俞于俞寓。”<br>余与于瑜遇俞于俞寓，<br>逾俞隅，<br>欲玉与俞，<br>遇雨，<br>雨逾俞宇。<br>余语于俞：“余欲渔于渝淤，遇雨俞宇，欲渔欤？玉欤？”<br>于瑜与余御雨于俞寓，<br>俞玉与余禹，<br>雨愈，<br>余与于瑜踽踽逾逾俞宇，<br>渔于渝淤。 
季姬击鸡记       	季姬寂，<br>集鸡，<br>鸡即棘鸡。<br>棘鸡饥叽，<br>季姬及箕稷济鸡。<br>鸡既济，<br>跻姬笈，<br>季姬忌，<br>急咭鸡，<br>鸡急，<br>继圾几，<br>季姬急，<br>即籍箕击鸡，<br>箕疾击几伎，<br>伎即齑，<br>鸡叽集几基，<br>季姬急极屐击鸡，<br>鸡既殛，<br>季姬激，<br>即记《季姬击鸡记》。
雾       	早晨下大雾，<br>山里看不见路，<br>急坏了小猪、小兔和小鹿。<br>小兔领小猪，<br>小猪拉小鹿，<br>拉着藤，扶着树，<br>一步一步走山路。<br>秋风婆婆来帮助，<br>呼――呼――呼――<br>一下吹散满天雾。 <br>
鱼和大雁       	小鱼入鱼网鱼网捕鱼鱼难逃，<br>大雁过雁塔雁塔留雁雁不留。 
数青蛙       	一只青蛙一张嘴，<br>两只眼睛四条腿，<br>扑通一声跳下水。<br>两只青蛙两张嘴，<br>四只眼睛八条腿，<br>扑通扑通两声跳下水。<br>三只青蛙三张嘴，<br>六只眼睛十二条腿，<br>扑通扑通扑通三声跳下水。<br>四只青蛙四张嘴，<br>八只眼睛十六条腿，<br>扑通扑通扑通扑通四声跳下水。 
白庙、白猫       	山上有座白庙，<br>地上有只白猫，<br>白发老公公掉了一顶白帽，<br>白猫叼着白帽跑进一白庙。 
涩柿子与石狮子       	树上结了四十四个涩柿子，<br>树下蹲着四十四头石狮子；<br>树下四十四头石狮子，<br>要吃树上四十四个涩柿子；<br>涩柿子不让石狮子吃涩柿子；<br>石狮子偏要吃涩柿子。 
梳胡子       	苏州有个苏胡子，<br>湖州有个胡梳子。<br>胡梳子买把斧子做梳子，<br>苏胡子买把梳子梳胡子。
白猫与黑猫       	庙里有只白猫,<br>庙外有只黑猫。<br>庙里白猫骂庙外黑猫是馋猫，<br>庙外黑猫骂庙里白猫是懒猫。
分清巾金睛景       	小金到北京看风景，<br>小京到天津买纱巾，<br>看风景，用眼睛，<br>还带一个望远镜。<br>买纱巾，带现金，<br>到了天津把商店进<br>买纱巾，用现金，<br>看风景，用眼睛，<br>巾、金、睛、景要分清。 
人造神?神造人?       	宁宁和成成，<br>去看观音神。<br>宁宁说是“人造神”，<br>成成说是“神造人”，<br>宁宁说不服成成，<br>成成说不服宁宁。<br>一道去请教高婶婶，<br>到底是神造人，<br>还是人造神？ 
油缸碰豆筐       	豆混油，缸混筐，<br>豆要油赔豆，<br>油要豆赔油；<br>缸要筐赔缸，<br>筐要缸赔筐。<br>墙上油一缸，<br>墙下豆一筐，<br>乒乓一声响，<br>油缸碰豆筐。 
狗、猴过桥       	桥东走来一条狗，<br>桥西走来一只猴。<br>行到桥心碰了头，<br>彼此匆匆跑回头。<br>猴回头来望望狗，<br>狗回头来望望猴，<br>究竟是猴怕狗，<br>还是狗怕猴。 <br>
上果市       	四个孩子上果市，<br>拿着四个小篮子。<br>花了硬币四毛四，<br>买了十个小柿子。<br>四个孩子出果市，<br>拾了四十小石子。<br>到了家里吃柿子，<br>吃完柿子玩石子。 
肥猪、肥兔       	小苏要喂猪，<br>老鲁要养兔。<br>老鲁会喂猪，<br>小苏会养兔。<br>老鲁教小苏喂猪，<br>小苏教老鲁养兔。<br>兔肥如猪，<br>满院肥猪、肥兔关不住。 
北京和天津       	天津和北京，<br>津京两个音。<br>一是前鼻音，<br>一是后鼻音。<br>如果分不清，<br>请你认真听。 
雕与猫       	树上有只雕，<br>地上有只猫，<br>地上的猫想叼走树上的雕，<br>树上的雕啄猫身上的毛，<br>雕吓走了猫，猫赶飞了雕。
丽丽和弟弟       	丽丽家来了小弟弟，<br>弟弟叫丽丽出来做游戏，<br>丽丽和弟弟拿不定主意，<br>是做游戏还是玩玩具。 
灰猫追花鸟       	灰猫跳，花鸟叫，<br>灰猫听花鸟叫，<br>花鸟瞧灰猫跳，<br>灰猫跳起抓花鸟，<br>花鸟怕灰猫，<br>拨腿就逃掉。
是灯还是星       	天上满天星，<br>地上满山灯，<br>满天星亮满天庭，<br>满山灯接满天星，<br>星映灯，灯映星，<br>分不清是灯还是星。 
梨和犁       	耕地要用犁，<br>口渴要吃梨，<br>梨子掉下地，<br>沾了一身泥，<br>不要扔了梨，<br>只需洗掉泥。 
乌鸦说猪黑       	乌鸦站在黑猪脊上说黑猪黑，<br>黑猪说乌鸦比黑猪还要黑，<br>乌鸦说它身比黑猪黑，嘴不黑，<br>黑猪听罢笑得嘿嘿嘿。 
月亮走       	月亮走，我也走，<br>我给月亮提竹篓，<br>竹篓里面装豆豆，<br>送给月亮上的小猴猴，<br>小猴吃了豆豆长肉肉。 
我有一条狗       	我有一条狗，<br>狗尾拖个斗。<br>走起路来狗关直发抖，<br>不知是狗拖斗，<br>还是斗拖狗。 
颠倒歌       	太阳从西往东落，<br>听我唱个颠倒歌。<br>天上打雷没有响，<br>地上石头滚上坡。<br>江里骆驼会下蛋，<br>山上鲤鱼搭成窝。<br>腊月炎热直流汗，<br>六月寒冷打哆嗦。<br>妹照镜子头梳手，<br>门外口袋把驴驮。 
皮鞋、蒲鞋       	一只皮鞋，<br>一只蒲鞋，<br>皮鞋补蒲鞋，<br>蒲鞋补皮鞋，<br>皮鞋、蒲鞋，<br>蒲鞋、皮鞋…… 
比锤       	炉东有个锤快锤，<br>炉西有个锤锤快，<br>两人炉前来比赛，<br>不知是锤快锤比锤锤快锤得快？<br>还是锤锤快比锤快锤锤得快？
护树       	北风吹摇路边树，<br>小陆上前把树护。<br>一个木竿路旁竖，<br>一根绳子拴捆住。<br>树有木竿做支柱，<br>木竿支树树稳固。 
荷花和蛤蟆       	一朵粉红大荷花，<br>趴着一只活蛤蟆；<br>八朵粉红大荷花，<br>趴着八只活蛤蟆。
收葵花       	葵花、蓖麻胖娃小筐手中拿，<br>来到园中收葵花；<br>小华小篮身上挎，<br>一同进园收蓖麻。<br>胖娃种的葵花花盘大，<br>小华种的蓖麻密麻麻。<br>小华去帮胖娃摘葵花，<br>胖娃去帮小华收蓖麻。<br>小华和胖娃，<br>收了葵花、蓖麻献国家。 
种冬瓜       	东门童家门东董家，<br>童、董两家，<br>同种冬瓜，<br>童家知道董家冬瓜大，<br>来到董家学种冬瓜。<br>门东董家懂种冬瓜，<br>来教东门童家种冬瓜。<br>童家、董家都懂得种冬瓜，<br>童、董两家的冬瓜比桶大。 
一捆葱       	东边来个小朋友叫小松，<br>手里拿着一捆葱。<br>西边来个小朋友叫小丛，<br>手里拿着小闹钟。<br>小松手里葱捆得松，<br>掉在地上一些葱。<br>小丛忙放闹钟去拾葱，<br>帮助小松捆紧葱。<br>小松夸小丛像雷锋，<br>小丛说小松爱劳动。 
老顾大顾和小顾       	老顾大顾和小顾，<br>扛锄植树走出屋。<br>漫天大雾罩峡谷，<br>雾像灰布满路铺。<br>大顾关注喊小顾，<br>老顾扛锄又提树。<br>雾里植树尽义务。 
猴子吃桃子       	树上有只小桃子，<br>树下有只小猴子。<br>风吹桃树哗哗响，<br>树上掉下小桃子。<br>桃子打着小猴子，<br>猴子吃掉小桃子。
花和瓜       	瓜藤开花像喇叭，<br>娃娃爱花不去掐。<br>瓜藤开花瓜花结花<br>没花就没瓜。<br>吃瓜要爱花，<br>娃娃爱花也爱瓜。 
白庙、白猫、白帽       	山顶有座白庙，<br>白庙里有只白猫。<br>白庙外有顶白帽，<br>白猫看见了白帽，<br>叨着白帽跑进了白庙。
花青蛙       	花青蛙，叫呱呱，<br>西瓜地里看西瓜，<br>西瓜夸青蛙背背花，<br>青蛙夸西瓜长得大。 
教练和主力       	蓝教练是女教练，<br>吕教练是男教练，<br>蓝教练不是男教练，<br>吕教练不是女教练。<br>蓝南是男篮主力，<br>吕楠是女篮主力，<br>吕教练在男篮训练蓝南，<br>蓝教练在女篮训练吕楠。 
小华和胖娃       	小华和胖娃，两人种花又种瓜，<br>小华会种花不会种瓜，<br>胖娃会种瓜不会种花，<br>小华教胖娃种花，<br>胖娃教小华种瓜。
南南有个篮篮       	南南有个篮篮，篮篮装着盘盘，<br>盘盘放着碗碗，碗碗盛着饭饭。<br>南南翻了篮篮，篮篮扣了盘盘，<br>盘盘打了碗碗，碗碗撒了饭饭。
窝和锅       	树上一个窝，<br>树下一口锅，<br>窝掉下来打着锅，<br>窝和锅都破，<br>锅要窝赔锅，<br>窝要锅赔窝，<br>闹了半天，<br>不知该锅赔窝，<br>还是窝赔锅。 
捉壁虎       	李虎捉壁虎，<br>本是虎捉虎，<br>李虎满屋转，<br>壁虎不敢咬李虎，<br>李虎也捉不住壁虎。 
造房子       	捡颗小石子，<br>在地上画个方格子<br>画好了格子造房子<br>画个大方格子造个大房子，<br>画个小方格子造个小房子，<br>楼上的房子分给鸽子，<br>楼下的房子分给小兔子。 
盆和瓶       	桌上放个盆，<br>盆里有个瓶，<br>砰砰啪啪，<br>啪啪砰砰，<br>不知是瓶碰盆，<br>还是盆碰瓶。
麻字谣       	麻家爷爷挑着一对麻叉口，<br>走到麻家婆婆的家门口。<br>麻家婆婆的一对麻花狗，<br>咬破了麻家爷爷的麻叉口。<br>麻家婆婆拿来麻针、麻线，<br>来补麻家爷爷的麻叉口。 
看豆豆       	小妞妞围个圆兜兜<br>牛头沟边看豆豆，<br>忽听沟前喊抓牛，<br>妞妞怕牛牛踩豆豆<br>紧紧抓住牛牛不松手。 
小道上       	小王的姜撞翻老杨的缸，<br>老杨的缸碰倒小王的姜。<br>小王放下姜去扶老杨的缸，<br>老杨放下缸去帮小王装姜。 
煤和灰       	东边一堆煤，<br>西边一堆灰。<br>先用车推煤，<br>再用车推灰。<br>烧煤变成灰，<br>煤灰来自煤。<br>煤堆变灰堆，<br>灰堆赛煤堆。<br>有煤就有灰，<br>你说对不对？ 
青龙洞       	青龙洞中龙做梦，<br>青龙做梦出龙洞，<br>做了千年万载梦，<br>龙洞困龙在深洞。<br>自从来了新愚公，<br>愚公捅开青龙洞，<br>青龙洞中涌出龙，<br>龙去农田做农工。 
白家伯伯       	北贫坡上白家有个伯伯，<br>家里养着一百八十八只白鹅，<br>门口种着一百八十八棵白果，<br>树上住着一百八十八只八哥。<br>八哥在白果树上吃白果，<br>白鹅气得直叫：我饿！我饿！ 
补裤       	一块土粗布，<br>一条粗布裤，<br>哥哥屋里补布裤，<br>飞针走线自己做。<br>粗布裤上补粗布，<br>土粗布补粗布裤，<br>哥哥穿上粗布裤，<br>艰苦朴素牢记住。 
好孩子       	张家有个小英子，<br>王家有个小柱子。<br>张家的小英子，<br>自己穿衣洗袜子，<br>天天扫地擦桌子，<br>王家的小柱子，<br>捡到一只皮夹子，<br>还给后院大婶子。<br>小英子，小柱子，<br>他们都是好孩子。 
画葫芦       	胡图用笔画葫芦，<br>葫芦画得真糊涂，<br>糊涂不能算葫芦，<br>要画葫芦不糊涂，<br>胡图决心不糊涂，<br>画出一只大葫芦。 
小花鼓       	一面小花鼓，<br>鼓上画老虎。<br>妈妈用布来补。<br>到底是布补鼓，<br>还是布补虎。 
学捏梨       	盘里放着一个梨，<br>桌上放块橡皮泥。<br>小丽用泥学捏梨，<br>眼看着梨手捏泥，<br>比比，真梨、假梨差不离。 
四个头       	天上有日头，<br>地下有石头，<br>嘴里有舌头，<br>瓶口有塞头。<br>天上是日头不是石头，<br>地下是石头不是日头，<br>嘴里是舌头不是塞头，<br>瓶中是塞头不是舌头。 
吃荸荠       	荸荠有皮，皮上有泥。<br>洗掉荸荠皮上的泥，<br>削去荸荠外面的皮，<br>小丽、小艺和小奇，<br>欢欢喜喜吃荸荠。
买菜       	小艾和小戴，一起去买菜。<br>小艾把一斤菜给小戴，<br>小戴有比小艾多一倍的菜；<br>小戴把一斤菜给小艾，<br>小艾、小戴就有一般多的菜。 
妈妈骂马       	妈妈种麻，<br>我去放马，<br>马吃了麻，<br>妈妈骂马。
板凳与扁担       	板凳宽，扁担长。<br>扁担没有板凳宽，<br>板凳没有扁担长。<br>扁担在绑在板凳上，<br>板凳不让扁担绑在板凳上，<br>扁担偏要扁担绑在板凳上。 
有个面铺门朝南       	出南门，望正门，<br>有个面铺门朝南，<br>面铺挂个蓝布棉门帘，<br>掀开了蓝布棉门帘，<br>还是面铺门朝南。
盆平饼       	一平盆面烙一平盆饼，<br>盆平饼，<br>饼平盆。 
白拐棒棍儿       	打南边来个白胡子老头儿，<br>手拄个绷白的白拐棒棍儿。 
瘸子       	北边来了一个瘸子,背着一捆橛子。<br>南边来了一个瘸子，背着一筐茄子。<br>背橛子的瘸子打了<br>背茄子的瘸子一橛子。<br>背茄子的瘸子打了<br>背橛子的瘸子一茄子。 
小秋和小牛       	小妞妞，叫小秋，梳着两个小抓鬏，<br>小胖胖，叫小牛，穿着一个小兜兜。<br>小秋帮着小牛记扣扣，<br>小牛帮小秋剥豆豆，<br>小秋、小牛手拉手，<br>一块儿玩，一块儿走。 
王婆夸瓜又夸花       	王婆卖瓜又卖花，<br>一边卖来一边夸，<br>又夸花，又夸瓜，<br>夸瓜大，大夸花，<br>瓜大，花好，笑哈哈。 
任命、人名       	任命是任命，<br>人名是人名，<br>任命人名不能错，<br>错了人名错任命。 
小小酒盅       	一只极小极小酒盅，<br>小小酒盅装小小酒瓶细花花雕酒，<br>小小酒瓶倒小小细花酒盅，<br>小小花雕倒不满小酒盅，<br>算算几个小小酒盅装几瓶小小酒瓶的细花小酒盅。 
六斗六升好绿豆       	一出南门走六步，<br>遇见六叔和六舅，<br>好六叔，好六舅，<br>借给我六斗六升好绿豆，<br>到了秋，收了豆，<br>再还六叔六舅六斗六升好绿豆。
烧香船       	前头一只大烧香船，<br>后头一只小烧香船，<br>当中一只中烧香船；<br>大烧香船在中烧香船前面，<br>中烧香船在小烧香船前面，<br>小烧香船在中烧香船后面。 
雪和血       	天上下雪，<br>身上流血，<br>雪是白的，<br>血是红的；<br>血是红的不是白的，<br>雪是白的不是红的。 
爹爹送我一块绸       	爹爹送我一块绸，<br>姆姆送我一头牛，<br>哥哥送我一把白纸扇，<br>嫂嫂送我一个小丫头。<br>穿了绸，<br>骑了牛，<br>白纸扇，<br>遮日头，<br>后面跟了一个小丫头。 
瘸子碟子       	界南来了个瘸子，<br>手里托着碟子；<br>碟子里盛着茄子，<br>地下钉着个橛子；<br>绊倒了瘸子，<br>摔了碟子，<br>撒了茄子。 
爷爷是瘸子       	爷爷是瘸子，<br>夜里去摘茄子，<br>路上有个橛子，<br>绊住爷爷的鞋子，<br>跌倒爷爷这个瘸子，v砸坏爷爷的茄子，<br>爷爷去摸茄子，<br>一摸摸到橛子，<br>爷爷这个瘸子，<br>拔了橛子去摸茄子。 
哑子和瞎子的儿子       	一个哑子，<br>拿了一只盒子，<br>盒子里有桃子；<br>一个瞎子的儿子，<br>绊了他一只凳子，<br>瞎子的儿子的凳子，<br>撞翻哑子盒子里的桃子，<br>哑子拉住瞎子的儿子的凳子，<br>要他赔还盒子里的桃子，<br>瞎子的儿子不肯赔还哑子盒子里的桃子，v哑子打瞎子的儿子，<br>瞎子的儿子也打哑子。 
骑个小黑驴       	骑个小黑驴，<br>黑啦，黑啦，来个客，<br>骑个小黑驴，<br>穿着一身黑，<br>在这黑晚上，<br>哪里看出是个客。
四十四只狮子       	内外有四十四只狮子，<br>不知是四十四只死狮子，<br>还是四十四只石狮子。 
和尚端汤上塔       	和尚端汤上塔，<br>塔滑汤洒汤烫塔；<br>和尚端塔上汤，<br>汤滑塔洒塔烫汤。 
瓶和盆       	墙上一个瓶，<br>墙下一个盆，<br>瓶落下来打破了盆的底，<br>盆翻转来打破了瓶折嘴，<br>瓶要盆赔瓶的嘴，<br>盆要瓶赔盆的底。 
驼子的骡子和婆子的茄子       	一个驼子骑匹骡子，<br>碰到婆子挑担茄子，<br>驼子的骡子践到婆子的茄子，<br>婆子拖驼子下骡子，<br>要驼子赔婆子的茄子。 
严圆眼和圆眼严       	山前有个严圆眼，<br>山后有个圆眼严，<br>两人上山来比眼，<br>不知是严圆眼的眼圆？v还是圆眼严的眼圆？
房胡子　黄胡子       	房胡子，黄胡子，<br>新年到了写福字；<br>不知道房胡子的福字写得好？<br>还是黄胡子的福字写得好？ 
龚先生和翁先生       	龚先生东方走来肩了一棵松，<br>翁先生西方走来拿了一只钟。<br>龚先生的松撞破了翁先生的钟，<br>翁先生扭住了龚先生的一棵松。<br>龚先生要翁先生放了他的松，<br>翁先生要龚先生赔了他的钟。<br>龚先生不肯赔还翁先生的钟，<br>翁先生不肯放还龚先生的松。 
破瓦和骡马       	楼上一块破瓦，<br>楼下一匹骡马，<br>破瓦落下来打了骡马，<br>骡马跳起来踩了破瓦。
庙和猫       	家后有座庙<br>天天猫来尿<br>不知是庙尿猫<br>还是猫尿庙 
房子里有箱子       	房子里有箱子，<br>箱子里有匣子，<br>匣子里有盒子，<br>盒子里有镯子；<br>镯子外有盒子，<br>盒子外有匣子，<br>匣子外有箱子，<br>箱子外有房子。 
墙上一个洞       	墙上一个洞，<br>壁上一条缝，<br>割块鸡皮补壁缝，<br>不知是壁缝补鸡皮？<br>还是鸡皮补壁缝？ 
盆和瓢       	盆里有个瓢，<br>风吹瓢摆摇，<br>不知是瓢碰盆，<br>还是盆碰瓢。
台语绕口令       	有一个姓布，<br>手提一块布，<br>三步做二步，<br>走到双叉路，<br>当钱一千五。<br>又到双叉路，<br>为看做头路。<br>担着一担醋，<br>顶街下街来卖醋。<br>卖呀卖，<br>卖到蕃薯路，<br>看着一只兔，<br>赶紧放落醋，<br>去追兔，<br>掠看兔，<br>更找无布，<br>气看竟落裤，<br>用裤来包兔。<br>这只兔真不识礼数，<br>给我咬破裤，<br>咬到烂糊糊，<br>真可恶，<br>出手要掠，<br>慢半步。<br>赶紧放落醋，<br>去追兔，<br>追前追后追归哺，<br>追一下无突好，<br>推倒醋，<br>啊，裤又更咬到烂糊糊，<br>醋泼落地，<br>沉落土，<br>兔仔走到内山路，<br>真真气死彼个姓布。 
六合县六十六岁的陆老头       	六合县有个六十六岁的陆老头，<br>盖了六十六间楼，<br>买了六十六篓油，<br>堆在六十六间楼。<br>栽了六十六株垂杨柳，<br>养了六十六头牛，<br>扣在六十六株垂杨柳。<br>遇了一阵狂风起，<br>吹倒了六十六间楼，<br>翻了六十六篓油，<br>断了六十六株垂杨柳，<br>打死了六十六头牛，<br>急煞了六合县的六十六岁的陆老头。
白鼻头大白猫       	东边大婆婆之家有一只白鼻头大白猫。<br>西边二婆婆家也有一只白鼻头大白猫。<br>一天东边大婆婆家的白鼻头大白猫和西边二婆婆家的白鼻头大白猫相打，<br>也不晓得东边大婆婆家的白鼻头大白猫赢的呢？<br>还是西边二婆婆家的白鼻头大白猫赢的？ 
跛子和驼子       	一个跛子，牵着驴子；<br>一个驼子，拉着车子；<br>一个瞎子，抱着孩子。<br>跛子的驴子，撞着驼子的车子；<br>驼子的车子，碰倒瞎子的孩子；<br>瞎子要打驼子，驼子要打跛子。 
桥东有一家丁家       	桥东有一家丁家，<br>桥西也有一家丁家。<br>有一天，桥东丁家说桥西丁家的冬瓜好，<br>桥西丁家说桥东丁家的西瓜好。<br>不知是桥东丁家的西瓜好？<br>还是桥西丁家的东瓜好？ 
尖尖山上放紫藤       	尖尖山上放紫藤，<br>紫藤四面挂铜铃。<br>风吹藤动铜铃响，<br>风住藤定定铜铃。 
费和会       	手艺学不会，<br>材料用得费。<br>正是会的不费，<br>费的不会。 
吃葡萄不吐葡萄皮       	吃葡萄不吐葡萄皮，<br>不吃葡萄倒吐葡萄皮。
飞机和灰鸡       	抱着灰鸡上飞机，<br>飞机起飞，<br>灰鸡要飞。
字纸和柿子       	隔着窗户撕字纸，<br>撕了字纸吃柿子。
汤烫塔       	端汤上塔，<br>塔滑汤洒，<br>汤烫塔。
酸枣子       	山上住着三老子，山下住着三小子，山腰住着三哥三嫂子。<br>山下三小子，找山腰三哥三嫂子，借三斗三升酸枣子，<br>山腰三哥三嫂子，借给山下三小子三斗三升酸枣子。<br>山下三小子，又找山上三老子，借三斗三升酸枣子，<br>山上三老子，还没有三斗三升酸枣子，<br>只好到山腰找三哥三嫂子，给山下三小子借了三斗三升酸枣子。<br>过年山下三小子打下酸枣子，还了山腰三哥三嫂子，两个三斗三升酸枣子。
娃挖瓦       	娃挖瓦，娃挖蛙，<br>娃挖瓦挖蛙，<br>挖蛙挖出瓦。<br>娃挖蛙，娃挖瓦，<br>娃挖蛙挖瓦，<br>挖瓦挖出蛙。
任命不是人名       	任命是任命，<br>人名是人名，<br>任命不是人命，<br>人名不是任名，<br>人名不能任命，<br>人是人，名是名，<br>任是任，命是命，<br>人、任、名、命要分清。
巧巧瞧高桥       	巧巧瞧高桥，<br>高桥桥头翘。<br>巧巧翘首瞧，<br>翘桥桥姿俏。
晃黄幌子       	方幌子，黄幌子，<br>方幌子是黄幌子，<br>黄幌子是方幌子。<br>晃动方幌子，<br>是晃动黄幌子，<br>晃动黄幌子，<br>是晃动方幌子。 
刘兰柳和柳兰流       	蓝衣布履刘兰柳，<br>布履蓝衣柳兰流，<br>兰柳拉犁来犁地，<br>兰流播种来拉耧。 
洗席       	一领细席，<br>席上有泥。<br>溪边去洗，<br>溪洗细席。
羊和狼       	东边来了一只小山羊，<br>西边来了一只大灰狼，<br>一起走到小桥上，<br>小山羊不让大灰狼，<br>大灰狼不让小山羊，<br>小山羊叫大灰狼让小山羊，<br>大灰狼叫小山羊让大灰狼，<br>羊不让狼，<br>狼不让羊，<br>扑通一起掉到河中央。 
画狮子       	有个好孩子，<br>拿张图画纸，<br>来到石院子，<br>学画石狮子。<br>一天来画一次石狮子，<br>十天来画十次石狮子。<br>次次画石狮子，<br>天天画石狮子，v死狮子画成了“活狮子”。 
乌鸦说黑猪       	乌鸦站在黑猪背上说黑猪黑，<br>黑猪说乌鸦比黑猪还要黑；<br>乌鸦说它身比黑猪黑嘴不黑，<br>黑猪听罢笑得嘿嘿嘿嘿。 
石狮子和涩柿子       	石狮寺前有四十四个石狮子，<br>寺前树上结了四十四个涩柿子，<br>四十四个石狮子不吃四十四个涩柿子，<br>四十四个涩柿子倒吃四十四个石狮子。 
磨房磨墨       	磨房磨墨，墨碎磨房一磨墨；<br>梅香添煤，煤爆梅香两眉灰。
舀油       	凉勺舀热油，热勺舀凉油。<br>凉勺舀了热油舀凉油，热勺舀了凉油舀热油。 
白云与羊群       	蓝天上是片片白云，草原上银色的羊群。<br>近处看，这是羊群，那是白云；<br>远处看，分不清哪是白云，哪是羊群。 
半瓶油       	小刘放学学打球，<br>球碰老牛半瓶油，<br>油掉地上瓶乒乓。<br>小刘取来半瓶油，<br>赔礼道歉又还油。<br>老牛不要油，<br>小刘硬还油，<br>老牛夸小刘，<br>小刘摇摇头。<br>弄不清老牛是让小刘还油，<br>还不老牛不让小刘还油。 
天上星啦斗       	天上星啦斗，<br>地上鸡啦狗；<br>园里葱啦韭；<br>塘里鱼啦藕。 
吃葡萄       	青葡萄，紫葡萄，<br>青葡萄没紫葡萄紫，<br>紫葡萄不吐葡萄皮，<br>不吃葡萄倒吐葡萄皮。
遇雨       	李小鱼和张小宇，<br>放学来到树林里，<br>轻轻松松坐下来，<br>A、B、C、D读英语。<br>天空飘过一片云，<br>“哗哗啦啦”下起雨，<br>小鱼小宇忙站起，<br>大树下面好避雨。 
小良救羊       	小良赶着一群羊，<br>来到山上遇着狼。<br>狼要吃羊羊躲狼，<br>小良救羊打跑狼。 
梳辫辫       	大姐姐，梳辫辫，<br>左手编右边，<br>右手编左边，<br>编好辫辫晃晃头，<br>一左一右两条小辫辫。
同同和多多       	同同和多多，<br>打鼓敲锣。<br>同同打铜鼓，<br>多多敲铜锣，<br>同同打鼓“咚咚”响，<br>多多“咚咚”敲着锣。
门前有八匹大伊梨马       	门前有八匹大伊梨马，你爱拉哪匹马拉哪匹马。
狗和猴       	桥西走来一条狗，<br>桥东跑来一只猴。<br>走到桥心两碰头，<br>狗望望猴，<br>猴瞧瞧狗。<br>狗跺跺脚向桥西跑，<br>猴挠挠耳向桥东走。<br>谁也不过桥，<br>不知是狗怕猴，<br>还是猴怕狗。 
柱子和树子       	东村有个小柱子，<br>割草丢了灰兔子；<br>西村有个小树子，<br>玩水丢了花裤子；<br>柱子去找灰兔子，<br>捡到一条花裤子；<br>树子去找花裤子，<br>拾到一只灰兔子；<br>树子把兔子还给柱子，<br>柱子把裤子还给树子。 
倪姓新郎来接李姓新娘       	倪伴郎伴着倪新郎来接李新娘，李伴娘伴着李新娘等着倪新郎。<br>李伴娘长得像李新娘，倪新郎把李伴娘当作李新娘要接走李伴娘；<br>倪伴郎长得像倪新郎，李新娘把倪伴郎当作倪新郎要跟着倪伴郎。<br>李伴娘躲开倪新郎，把李新娘推给倪新郎，跟倪新郎说这是你的李新娘；<br>倪伴郎躲开李新娘，把倪新郎推给李新娘，跟李新娘说这是你的倪新郎。<br>倪新郎来接李新娘，错把李伴娘当作李新娘，李伴娘差点当上倪新郎的新娘；<br>李新娘等着倪新郎，错把倪伴郎当作倪新郎，倪伴郎差点当上李新娘的新郎。 
加减乘除四则运算       	四加十是十四，十加四是十四。<br>十四减四是十，十四减十是四。<br>十乘四是四十，四乘十是四十。<br>四十除十是四，四十除四是十。<br>十乘四加四是四十四，四乘十加四是四十四。<br>四十四减四除四是十，四十四减四除十是四。<br>只要有了四和十，就能运算出十四、四十和四十四。 
漪姨       	漪姨倚椅，悒悒，疑异疫，宜诣医。<br>医以宜以蚁胰医姨。<br>医以亿弋弋亿蚁。<br>亿蚁缢，蚁胰溢。<br>医以亿蚁溢胰医姨，姨疫以医。<br>姨怡怡，以夷衣贻医。医衣夷衣，亦怡怡。<br>噫！医以蚁胰医姨疫，亦异矣；<br>姨以夷衣贻医，亦益异已矣！ 
植树苗       	小苏小苗上山腰，<br>欢欢喜喜植树苗，<br>小苏左手拎水桶，<br>小苗右手拿铁锹。<br>小苗用锹使劲铲，<br>小苏用桶把水浇。<br>阳光照耀小树苗，<br>小苗渐渐挺直腰，<br>小苏小苗拍手笑。
两只小兔       	两只小白兔，<br>上山采蘑菇，<br>碰见只小鹿，<br>正在种萝卜，<br>红萝卜，<br>白萝卜，<br>馋得小兔拍肚肚，<br>小鹿拔萝卜，<br>送给小白兔，<br>小兔吃萝卜，<br>忘了采蘑菇。
小鸭背小鸡       	小鸭背小鸡过小溪，<br>浪花追着小鸭和小鸡，<br>小鸭小鸡过完小溪欢喜喜，<br>小鸭呷呷，小鸡叽叽。 
蝴蝶飞       	蝴蝶飞，蝴蝶追。<br>蝶追追，蝶飞飞。<br>到底谁追谁，<br>两只蝴蝶互追追。 
狮子       	我说四个石狮子，<br>你说四个纸狮子，<br>石狮子是死狮子，<br>纸狮子也是死狮子。
虎和鼠       	墙上画了一只虎，<br>墙下蹲了一只鼠。<br>虎蹬墙下鼠，<br>鼠咬墙上虎。<br>虎没动，摔了鼠，<br>嘣了鼠的牙，<br>乐坏墙上虎。 
我和鹅       	我是我，鹅是鹅，<br>我不是鹅，鹅不是我。<br>鹅肚饿，我喂鹅，<br>我爱鹅，鹅亲我。
灰和龟       	远望一堆灰，<br>近看一只龟，<br>龟蹬灰，灰就飞，<br>灰飞龟背灰呛龟。<br>龟吹灰，要下水，<br>水洗龟背灰，<br>龟游直摆尾。 
青蛙跳水       	青蛙跳水有水花，<br>水里水花追青蛙。<br>青蛙没法不让水花追，<br>也没法甩掉水花花。 
学游泳       	小涌勇敢学游泳，勇敢游泳是英雄。（重复五遍）
画圆圈       	圆圈圆，圈圆圈，圆圆娟娟画圆圈。<br>娟娟画的圈连圈，圆圆画的圈套圈。<br>娟娟圆圆比圆圈，看看谁的圆圈圆。 
真绝       	真绝，真绝，真叫绝，<br>皓月当空下大雪，<br>麻雀游泳不飞跃，<br>鹊巢鸠占鹊喜悦。 
帆船       	大帆船，小帆船，竖起桅杆撑起船。<br>风吹帆，帆引船，帆船顺风转海湾。
栽葱和栽松       	冲冲栽了十畦葱，松松栽了十棵松。<br>冲冲说栽松不如栽葱，松松说栽葱不如栽松。<br>是栽松不如栽葱，还是栽葱不如栽松？ 
老翁和老翁       	老翁卖酒老翁买，老翁买酒老翁卖。（重复五遍） 
王庄和匡庄       	王庄卖筐，匡庄卖网，<br>王庄卖筐不卖网，<br>匡庄卖网不卖筐，<br>你要买筐别去匡庄去王庄，<br>你要买网别去王庄去匡庄。 
接水       	威威、伟伟和卫卫，拿着水杯去接水。<br>威威让伟伟，伟伟让卫卫，卫卫让威威，<br>没人先接水。一二三，排好队，一个一个来接水。 
槐树槐       	槐树槐，槐树槐，<br>槐树底下搭戏台，<br>人家的姑娘都来了，<br>我家的姑娘还不来。<br>说着说着就来了，<br>骑着驴，打着伞，<br>歪着脑袋上戏台。 
狼打柴狗烧火       	狼打柴，狗烧火，<br>猫儿上炕捏窝窝，<br>雀儿飞来蒸饽饽。
画蛤蟆帽       	一个胖娃娃，画了三个大花活蛤蟆；<br>三个胖娃娃，画不出一个大花活蛤蟆。<br>画不出一个大花活蛤蟆的三个胖娃娃，<br>真不如画了三个大花活蛤蟆的一个胖娃娃。 
天上七颗星       	天上七颗星，树上七只鹰，<br>梁上七个钉，台上七盏灯。<br>拿扇扇了灯，用手拔了钉，<br>举枪打了鹰，乌云盖了星。 
半边莲       	半边莲，莲半边，半边莲长在山涧边。<br>半边天路过山涧边，发现这片半边莲。<br>半边天拿来一把镰，割了半筐半边莲。<br>半筐半边莲，送给边防连。 
茄子       	姐姐借刀切茄子，<br> 去把儿去叶儿斜切丝，<br>切好茄子烧茄子，<br>炒茄子、蒸茄子，<br>还有一碗焖茄子。 
鸭和霞       	天上飘着一片霞，水上飘着一群鸭。<br>霞是五彩霞，鸭是麻花鸭。<br>麻花鸭游进五彩霞，五彩霞挽住麻花鸭。<br>乐坏了鸭，拍碎了霞，分不清是鸭还是霞。 
陈庄城和程庄城       	陈庄程庄都有城，陈庄城通程庄城。<br>陈庄城和程庄城，两庄城墙都有门。<br>陈庄城进程庄人，陈庄人进程庄城。<br>请问陈程两庄城，两庄城门都进人，<br>那个城进陈庄人，程庄人进那个城？ 
台灯和屏风       	郑政捧着盏台灯，<br>彭澎扛着架屏风，<br>彭澎让郑政扛屏风，<br>郑政让彭澎捧台灯。 
海水长       	海水长，长长长，长长长消。（重复五遍） 
小陈和小沈       	小陈去卖针，小沈去卖盆。<br>俩人挑着担，一起出了门。<br>小陈喊卖针，小沈喊卖盆。<br>也不知是谁卖针，也不知是谁卖盆。
蓝布棉门帘       	出前门，往正南，<br>有个面铺面冲南，<br>门口挂着蓝布棉门帘。<br>摘了它的蓝布棉门帘，<br>棉铺面冲南，<br>给他挂上蓝布棉门帘，<br>面铺还是面冲南。 
忽听门外人咬狗       	忽听门外人咬狗，拿起门来开开手；<br>拾起狗来打砖头，又被砖头咬了手；<br>从来不说颠倒话，口袋驮着骡子走。 
鹅       	坡上立着一只鹅，坡下就是一条河。<br>宽宽的河，肥肥的鹅，鹅要过河，河要渡鹅。<br>不知是鹅过河，还是河渡鹅。 
说日       	夏日无日日亦热，<br>冬日有日日亦寒，<br>春日日出天渐暖，<br>晒衣晒被晒褥单，<br>秋日天高复云淡，<br>遥看红日迫西山。 
小蝌蚪找妈妈       	小蝌蚪找妈妈，<br>找到青蛙蛙，<br>青蛙不知自己是不是妈妈，<br>只会叫着呱呱呱。
画圈圈       	弯弯绕，绕弯弯，<br>宝宝画圈圈，<br>圈圈画的圆圆？<br>问问圈圈，<br>问问圆圆。
柳条条       	柳条条，绿条条，风儿摇摇。<br>摇摇条条，条条摇摇，这是春天的好兆兆。
打狼       	羊群里混了一只披着羊皮的狼，<br>猎人拿枪想打狼，又怕伤着羊。<br>小朋友帮忙想一想，怎样打狼不伤羊？ 
华华和花花       	花花去商店买花，<br>华华给花花拿来画。<br>花花怪华华把画当花不像话，<br>华华说花花把“花”说成了“画”，<br>把“花”说成“画”的花花决心今后学好普通话。 
黑黑和灰灰       	黑黑和灰灰，两人去推水。<br>黑黑推水，灰灰帮黑黑，<br>灰灰推水，黑黑帮灰灰。 
喝汤       	胖胖端了一碗汤，<br>喝汤不等汤晾凉。<br>汤烫烫胖胖，汤烫胖胖烫，<br>要喝汤，汤晾凉了别着忙。 
薄板和短板       	薄板和短板，互相来比板。<br>薄板薄，短板短，<br>薄板要比短板薄，<br>短板要比薄板短，<br>薄板加一寸，薄板还是板薄，<br>短板加一尺，短板还是板短。
比赛画动物       	谷谷和露露，比赛画动物。<br>谷谷画了一只鼠和一只兔，<br>露露画了一只虎和一只鹿。<br>虎追鹿，鹿躲虎，鹿追兔，<br>兔躲鹿，兔追鼠，鼠躲兔。
煮猪肉       	锅里煮猪肉，<br>肉里包着骨，<br>取肉去猪骨，<br>放上一点醋，<br>都吃熟猪肉。 
屋里点个灯       	屋里点个灯，灯底下是个坑，<br>坑边上长棵葱，葱头上钉个钉，<br>钉上挂只鹰，鹰脖里挂张弓。<br>忽然刮了一阵风，刮灭了灯，刮平了坑，<br>刮倒了葱，刮掉了钉，刮飞了鹰，带走了弓。
一匹布、一瓶醋       	肩背一匹布，<br>手提一瓶醋，<br>走了一里路，<br>看见一只兔，<br>卸下布，放下醋，去捉兔。<br>跑了兔，丢了布，洒了醋。 
好饭换坏饭       	好饭换坏饭（连读五遍）
一麻包，一包麻       	一麻包，一包麻；<br>两麻包，两包麻；<br>三麻包，三包麻；<br>四麻包，四包麻；<br>五麻包，五包麻<br>六麻包，六包麻…… 
蛐蛐说大话       	墙头高，墙头低，墙旮旯有对蛐蛐，在那儿吹大气。大蛐蛐说：“昨儿个我吃了两只花不愣登的大老虎。”小蛐蛐说：“今儿个我吃了两只灰不溜秋的大毛驴。”大蛐蛐说：“我在南山爪了一抬，踢倒了十棵大柳树。”小蛐蛐说：“我在北海大嘴一张，吞了十条大鲸鱼。”这两个蛐蛐正在吹大气，扑棱棱打东边飞来一只芦花大公鸡。你看这只公鸡有多愣，它“哆”的一声吃了那只小蛐蛐。大蛐蛐一看生了气，它龇牙捋须一伸腿，唉！它也喂了鸡！哈哈，看它还吹大气不吹大气！
京剧与警句       	京剧叫京剧，<br>警句叫警句。<br>京剧不能叫警句，<br>警句不能叫京剧。 
六只活的绿蛤吧       	六只红花碗里，<br>合个六只活的绿蛤吧。<br>掀开红花碗，<br>六只绿蛤吧，<br>跳到六个红花碗。
老外和小外       	老外打歪一棵树，<br>歪树倒在小外身上。<br>小外骂老外不是好老外，<br>老外说小外不是好小外。 
竹竿和洋枪       	一个老张拿竹竿，一个老詹拿洋枪，<br>两人走上山，走上山的小土岗，<br>老张打老詹，老詹打老张，<br>老张的竹竿打老詹的洋枪，<br>老詹的洋枪打老张的竹竿，<br>两人打得乒乓响，打完谁也没受伤。 
张果老       	张果老，张果老，<br>张果老的门前有棵白核枣，<br>白的多，红的少，看的多，买的少，<br>凭你说得快，一口气说不完一百个枣。<br>一个枣，两个枣，三个枣……一百个枣。
捕鱼的老何       	罗家门前有条河，河里游着群鹅。<br>来个捕鱼的老何，挑来一对竹萝。<br>老何只顾着撒网落河，碰翻了一只萝。<br>竹箩滚下了河，套住了一只鹅。<br>老忙下河，捞萝来救鹅。<br>急坏了老何，吓散了群鹅 
剥虎皮补鼓       	东庙有面鼓，西山有只虎。<br>敲动鼓，惊动虎。<br>鼓面敲破，剥虎皮补鼓。 
冰和灯       	小平冻了一块冰，小英装进一盏灯。<br>只见灯外包着冰，只见冰外包着灯。<br>里亮外亮里外亮，冰明灯明冰灯明。<br>小平小英手儿灵，热爱科学有才能。
背柴       	奶奶背柴，来来提菜。<br>来来替奶奶背柴，<br>奶奶替来来提菜，<br>奶奶叫来来好小孩，<br>来来叫奶奶好奶奶。
帮助邻居剥豆子       	隔壁有个小珍子，<br>拎了两只小篮子，<br>请了三个小孩子，<br>搬来了三个小凳子，<br>帮助邻居剥豆子，<br>人人夸奖好孩子。 
爸爸骑马妈打靶       	爸爸场坝骑马，妈妈靶场打靶。<br>爸爸骑马，妈妈打靶。<br>爸爸骑马冲杀，妈妈打靶练枪法。<br>爸爸骑马马蹄下飞彩霞，妈妈打靶靶环上开红花。<br>爸爸妈妈英姿焕发，叔叔阿姨齐把爸爸妈妈夸。 
爱劳动       	板凳板凳摞摞，里面住着大哥；大哥开动机器，里机住着姨姨；<br>姨姨领着娃娃，里面住着妈妈；妈妈园里浇菜，里面住着奶奶；<br>奶奶奶奶打苍蝇，里面住着小英英；小英英爱劳动，都说我是小英雄。
长方歌       	长方的砖，长方的墙。长方的窗，长方的床。<br>长方的楼房亮堂堂，请你帮忙想一想，<br>除了砖、墙、窗、床和楼房，还有什么是长方。
画画       	小华举花小花画，<br>小花画画看小华，<br>小华问小花，画上画了啥？<br>小花举画答小华，<br>画中有花有小华。
秋风吹       	秋风吹，树枝摇，红叶黄叶往下掉。<br>红树叶，黄树叶，片片飞来象蝴蝶。 
是谁？       	是谁？敲着窗户沙沙沙。<br>是我，我是小雪花，我从天上来，告诉你们冬天来到啦！ 
一颗星，亮晶晶       	一颗星，亮晶晶，两颗星，眨眼睛；<br>许多许多小星星，数呀数不清。 
一颗星，孤零零       	一颗星，孤零零，两颗星，放光明。<br>三四五六许多星，照得满天亮晶晶。 
小蚱蜢       	小蚱蜢，学跳高，一跳跳上狗尾草。<br>腿一弹，脚一翘，“哪个有我跳得高”，<br>草一摇，摔一跤，头上跌个大青包。
我的小鼓       	我的小鼓响咚咚，我说话儿它都懂。<br>我说小鼓响三声，小鼓说“咚咚咚！”<br>哎哟哟，这不行，妹妹睡觉还没醒，<br>我说小鼓别响了，小鼓说声“懂、懂、懂！
大米饭       	大米饭喷喷香，<br>我们大家都来尝。<br>吃得快吃得饱，<br>不把饭粒掉桌上。
排排好       	排排好，排排好，小狗小猫做早操。<br>花鹿姐姐喊口令，一二三四做得好。
牛郎恋刘娘       	牛郎恋刘娘，刘娘念牛郎。<br>牛郎年年恋刘娘。刘娘年年念牛郎。<br>郎恋娘来娘念郎。<br>念娘恋娘，念郎恋郎，念恋娘郎。
捞虾       	小溪流水哗啦啦，小华手拿簸萁去小溪里捞河虾，<br>一捞捞起一只大河虾和半簸萁烂泥沙。<br>虾儿跳水响哗哗，小花簸萁里只剩泥沙没有虾。 
瓜换花       	小花和小华，<br>一同种庄稼。<br>小华种棉花，<br>小花种西瓜。<br>小华的棉花开了花，<br>小花的西瓜结了瓜。<br>小花找小华，<br>商量瓜换花。<br>小花用瓜换了花，<br>小华用花换了瓜。
大锅和小锅       	大哥有大锅，<br>二哥有小锅，<br>大哥要换二哥的小锅，<br>二哥不换大哥的大锅。 
班干部管班干部       	班干部管班干部（重复五遍）
新说喇嘛和哑巴       	从南边来了一个高高大大的喇嘛，手里提着五斤比目鱼的啦。<br>从北边来了一个阿巴阿巴，背上背着一个伸缩喇叭。<br>南边提着比目鱼的啦的高高大大的喇嘛，要拿比目鱼的啦换北边背伸缩喇叭的阿巴阿巴的伸缩喇叭。<br>阿巴阿巴不愿拿伸缩喇叭换高高大大的喇嘛的比目鱼的啦。<br>高高大大的喇嘛非要换背伸缩喇叭阿巴阿巴的伸缩喇叭。<br>高高大大的喇嘛抡起比目鱼的啦抽了背伸缩喇叭阿巴阿巴一比目鱼的啦，阿巴阿巴摘下伸缩喇叭打了提比目鱼的啦的高高大大的喇嘛一伸缩喇叭。也不知是提着比目鱼的啦的高高大大的喇嘛抽了背伸缩喇叭的阿巴阿巴一比目鱼的啦，还是背伸缩喇叭的阿巴阿巴打了提比目鱼的啦的高高大大的喇嘛一伸缩喇叭。<br>高高大大的喇叭回家炖比目鱼的啦。<br>阿巴阿巴滴滴答答吹伸缩喇叭。 
小鸡鸡不尿尿各有各的道       	天有天道地有地道<br>小鸡鸡不尿尿各有各的道<br>听说你会剑道忍道人道学过柔道抬拳道还会空手道和李小龙学过截拳道<br>小服呀说你爹不走正道你妈就走歪道你还不进孝道整天横行霸道还胡说八道脚踏黑白两道出门警车开道你快去你吗了个一群二白3拳4轴无炎六色七上八下五花八门三长两短千变万化五万十色万紫千红里的大比里组织一下语言深空进化一下你的长相吗的~!~气死我了小服呀你在跟我装我就一个大拳头给你打到西伯力亚叫你抱着北极熊叫爸
墙、钉、绳、瓶、灯、盆       	墙上一根钉，强作<br>钉上挂条绳，<br>滑落绳下瓶，<br>打碎瓶下灯，<br>砸破灯下盆。<br>瓶打灯，灯打盆，<br>盆骂灯，灯骂瓶，<br>瓶骂绳，绳骂钉，<br>钉怪绳，绳怪瓶，<br>瓶怪灯，灯怪盆，<br>叮叮当当当当叮，<br>乒乒乓乓乓乓乒。 
爹打弟，弟滚地       	爹打弟，弟滚地，<br>嫂嫂烧苕哄地弟；<br>姐呼鸡，鸡藏箕，<br>叔叔竖黍惊箕鸡。 
理化和理发       	我们要学理化，<br>他们要学理发。<br>理化不是理发，<br>理发不是理化。<br>学会理化不会理发，<br>学会理发也不懂理化。
量窗量床又量墙       	量窗量床又量墙，<br>跳上床量窗，<br>靠住墙量床，<br>墙比张床长，<br>床又比窗长，<br>窗长不过床，<br>床又长不过墙，<br>所以墙比床比窗长，<br>读不顺就去撞墙。 
求自在不自在       	求自在不自在，<br>知自在自然自在；<br>悟如来想如来，<br>非如来如是如来。 
长扁担，短扁担       	长扁担，短扁担，<br>长扁担比短扁担长半扁担；<br>短扁担比长扁担短半扁担。<br>长扁担绑在短板凳上，<br>长板凳不能绑在比短扁担长半扁担的长扁担上；<br>短板凳也不能绑在比长扁担短半扁担的短扁担上。
民兵排选标兵       	民兵排选标兵，<br>六班的标兵、七班的标兵、八班的标兵，<br>评比台前比选先进，<br>比比谁更先进，<br>选拔八名全排标兵上北京。
杨家养了一只羊       	杨家养了一只羊，<br>蒋家修了一垛墙，<br>杨家的羊撞倒了蒋家的墙，<br>蒋家的墙压死了杨家的羊。<br>杨家要蒋家赔杨家的羊，<br>蒋家要杨家赔蒋家的墙。 
墙头一颗草       	墙头一颗草，<br>风吹两边倒，<br>东风吹来向西倒，<br>西风吹来向东倒。<br>墙草墙草我问你：<br>要是没有风，<br>你向哪边倒。 
学习就怕满、懒、难       	学习就怕满、懒、难，<br>心里有了满、懒、难，<br>不看不钻就不前。<br>永不自满，边学边干，<br>蚂蚁也能搬泰山。 
你别动我的豆腐       	你会炖我的炖冻豆腐，<br>你炖我的炖冻豆腐，<br>你不会炖我的炖冻豆腐，<br>你别动我的豆腐。
面铺卖了八块八毛钱       	出南门往正南，<br>有个面铺面向南，<br>面铺挂着蓝布棉门帘，<br>摘了蓝布棉门帘，<br>面铺卖了八块八毛钱。
四辆四轮大马车       	大门外有四辆四轮大马车，<br>你爱拉哪两辆，<br>来拉哪两辆。 
鹅与河       	小乐放鹅到南河，<br>宽宽的河，<br>肥肥的鹅，<br>鹅要过河，<br>河要渡鹅，<br>不知是鹅过河，<br>还是河渡鹅。 
猫闹鸟       	东边庙里有个猫，<br>西边树梢有只鸟。<br>猫鸟天天闹，<br>不知是猫闹树上鸟，<br>还是鸟闹庙里猫。 
胖娃娃和蛤蟆       	一个胖娃娃，捉了三个大花活蛤蟆，<br>三个胖娃娃，捉了一个大花活蛤蟆，<br>捉了一个大花活蛤蟆的三个胖娃娃，<br>真不如捉了三个大花活蛤蟆的一个胖娃娃。 
芜湖徐如玉       	芜湖徐如玉，<br>出去屡次遇大雾。<br>曲阜苏愚卢，<br>上路五回遇大雨。 
肥混肥       	黑肥混灰肥，灰肥混黑肥。<br>黑肥混灰肥，黑肥灰又黑。<br>黑肥混灰肥，肥比黑肥灰。<br>灰肥混黑肥，肥比灰肥黑。 
吊刀       	楼上吊刀刀倒吊着。（重复五遍） 
闷棍       	门背后有根闷棍开门别碰闷棍。（重复三遍） 
谁也不服管       	苏州玄妙观，东西两判官，<br>东判官姓潘，西判官姓管，<br>管判官要管潘判官，潘判官要管管判官，<br>闹得谁也不服管。 
蜻蜓青萍分不清       	蜻蜓青，青浮萍，<br>青萍上面停蜻蜓，<br>蜻蜓青萍分不清。<br>别把蜻蜓当青萍，<br>别把青萍当蜻蜓。
补桶       	桐木桶，桶有洞，<br>补洞用桐不用铜。<br>用铜补洞补不住，<br>用桐补桶桶无洞。 
聋童       	朦胧彩霓虹，<br>玲珑小聋童。<br>聋童采柠檬，<br>聋童不懵懂。 
葱和松       	东院想栽葱，<br>西院想栽松。<br>是东院栽葱，<br>还是西院栽松。 
腿粗兔子和粗腿兔子       	大路上一碗水，<br>两个兔子来洗腿。<br>一个兔子是腿粗，<br>一个兔子是粗腿。<br>腿粗兔子看粗腿，<br>粗腿兔子看腿粗。<br>不知是腿粗兔子的腿粗，<br>还是粗腿兔子的腿粗？ 
一二三四五       	一二三四五，<br>上山打老虎。<br>老虎没打着，<br>打了小松鼠。<br>松鼠有几只？<br>一二三四五。 
母鸡和小鸡       	母鸡骂小鸡，<br>你这笨东西。<br>教你咯咯咯，<br>你偏叽叽叽。
四数字       	四和十、十和四，<br>四十和四十，<br>十四和十四。<br>说好四个数字，<br>全靠舌头和牙齿。<br>谁说四十是“细席”，<br>他的舌头没用力；<br>谁说十四是“实世”，<br>他的舌头没伸直。<br>认真学，常练习，<br>十、四、十四、四十、四十四。 
水连天       	天连水，水连天，<br>水天一色望无边，<br>兰兰的天似绿水，<br>绿绿的水如蓝天。<br>到底是天连水，<br>还是水连天？
倒吊鸟       	梁上两对倒吊鸟，<br>泥里两对鸟倒吊。<br>可怜梁上的两对倒吊鸟，<br>惦着泥里的两对鸟倒吊，<br>可怜泥里的两对鸟倒吊，<br>也惦着梁上的两对倒吊鸟。
白果果       	我走白家门前过，<br>白家门前一棵白果树，<br>树上结了白果果，<br>白果树上歇了只白八哥。 
胡子骑驴子       	胡子骑驴子，<br>驼子挑螺蛳，<br>胡子撞翻了驼子的螺蛳，<br>驼子拖住胡子的驴子，<br>胡子去打挑螺蛳的驼子，<br>驼子来打骑驴子的胡子，<br>胡子打驼子，<br>驼子打胡子。 