冬瓜、黄瓜、西瓜、南瓜都能吃，什么瓜不能吃？	傻瓜 
盆里有6只馒头，6个小朋友每人分到1只，但盆里还留着1只，为什么？	最后一个小朋友把盆子一起拿走了 
你能以最快速度，把冰变成水吗？	把“冰”字去掉两点，就成了“水”。 
冬天，宝宝怕冷，到了屋里也不肯脱帽。可是他见了一个人乖乖地脱下帽，那人是谁？ 理发师 
老王一天要刮四五十次脸，脸上却仍有胡子。这是什么原因？	老王是个理发师 
有一个字，人人见了都会念错。这是什么字？	这是“错”字 
小华在家里，和谁长得最像？	镜中的小华 
鸡蛋壳有什么用处？	用来包蛋清和蛋黄。 
不必花力气打的东西是什么？	打哈欠 
你能做，我能做，大家都做；一个人能做，两个人不能一起做。这是做什么？	做梦 
什么事每人每天都必须认真的做?	睡觉 
什么人始终不敢洗澡	泥人 
小明从不念书却得了模范生，为什么？	小明是聋哑学生 
什么车子寸步难行?	风车 
哪一个月有二十八天?	每个月都有28天 
你知道上课睡觉有什么不好吗?	不如床上舒服嘛 
什么酒不能喝?	碘酒 
什么蛋打不烂，煮不熟，更不能吃?	考试得的零蛋"0" 
打什么东西，不必花力气？	打瞌睡 
火车由北京到上海需要６小时，行使３小时后，火车该在什么地方？	在车轨上 
时钟什么时候不会走?	时钟本来就不会走 
书店里买不到什么书	遗书 
什么路最窄？	冤家路窄 
什么东西不能吃？ “东西”方向 
一个人从飞机上掉下来，为什么没摔死呢？	飞机停在地上 
一年四季都盛开的花是什么花?	塑料花 
什么英文字母最多人喜欢听?	CD 
什么人生病从来不看医生?	盲人 
小明知道试卷的答案,为什么还频频看同学的?	小明是老师 
用铁锤锤鸡蛋为什么锤不破？	铁锤当然不会破了 
拳击冠军很容易被谁击倒？	瞌睡虫 
什么事天不知地知，你不知我知？	鞋底破了 
一个人在沙滩上行走，但在他的身后却没有发现脚印，为什么?	他在倒着走 
一位卡车司机撞倒一个骑摩托车的人，卡车司机受重伤，摩托车骑士却没事，为什么？	卡车司机当时没开车 
早晨醒来，每个人都要做的第一件事是什么？	睁开眼睛 
你能用蓝笔写出红字来吗?	写个“红”字有何难 
汽车在右转弯时，哪只轮胎不转？	备用胎 
孔子与孟子有什么区别?	孔子的子在左边，孟子的子在上边 
为什么小王从初一到初三就学了一篇课文？	初一到初三，两天学一课，算不错了！ 
一个人空肚子最多能吃几个鸡蛋？	一个。因为吃了一个后就不是空肚子了
当哥伦布一只脚迈上新大陆后，紧接着做什么？	迈上另一只脚 
毛毛虫回到家，对爸爸说了一句话，爸爸即场晕倒，毛毛虫说了什么话？	毛毛虫说：“我要买鞋。” 
飞机从天上掉下来，为什么没有一个受伤的？	全都死了 
太平洋的中间是什么？	是平字 
世界上最小的岛是什么？	马路上的安全岛 
把一只鸡和一只鹅同时放在冰箱里，为什么鸡死了鹅没死？	企鹅嘛 
四个人在一间小屋里打麻将（没有其他人在看着），这时警察来了，四个人都跑了，可是警察到了屋里又抓到一个人，为什么？	四个人在屋里打一个叫“麻将”的人，警察抓到的是他 
万兽大王是谁？	动物园园长 
用什么可以解开所有的谜？	答案 
什么样的人死后还会出现？	电影中的人 
专爱打听别人事的人是谁？	记者 
谁说话的声音传得最远？	打电话的人 
什么东西的制造日期和有效期是同一天？	日报 
小咪昨晚花了整整一个晚上在历史课本上，可第二天妈妈还是骂她不用功，为什么？	她用历史课本当枕头睡 
能否用树叶遮住天空？	只要用树叶盖住眼睛 
一头牛，向北走10米，再向西走10米，再向南走10米，倒退右转，问牛的尾巴朝哪儿？	朝地 
为什么黑人喜欢吃白色巧克力？	害怕咬到自己的手 
把8分成两半，是多少？	0 
口吃的人最吃亏的是？	打国际长途电话 
什么东西使人哭笑不得？	口罩 
身份证掉了怎么办？	捡起来
有个人走独木桥，前面来了一只老虎，后面来了只熊，这个人是怎么过去的？	晕过去了 
监狱里关着两名犯人，一天晚上犯人全都逃跑了，可是第二天看守员打开牢门一看，里面还有一个犯人？	逃跑的犯人名字叫“全都” 
小明的妈妈有三个儿子，大独生子叫大明，二儿子叫二明，三儿子叫什么？	当然叫小明 
猫见了老鼠为什么拔腿就跑？	跑去捉老鼠 
大象的左边耳朵象什么？	右边耳朵 
针掉到大海怎么办？	再买一颗 
有一个人走在沙滩上，回头却看不见自己的脚印，为什么？	因为他倒着走 
一只候鸟从南方飞到北方要用一个小时，而从北方飞到南方则需二个半小时，为什么呢？	两个半小时不就是一个小时吗 
经理不会做饭，可有一道菜特别拿手，是什么？	炒鱿鱼 
李先生到16层楼去谈生意，但他只乘电梯到14层楼，然后再步行爬楼梯上去，为什么？	李先生个子太矮，按不到16楼的电梯按键 
一个小孩和一个大人在漆黑的夜晚走路，小孩是大人的儿子，大人却不是小孩的父亲，请问为什么？	因为他们是母子关系 
什么字全世界通用？	阿拉伯数字 
一个人的前面放了一本又厚又宽的大书，他想跨过去可怎么也跨不过去，你知道这是什么原因吗？	因为书就放在墙角 
人的长寿秘诀是什么？	保持呼吸，不要断气 
什么时候看到的月亮最大？	登上月球时 
什么人一年中只工作一天？	圣诞老人 
什么事睁一只眼闭一只眼比较好？	射击 
为什么刚出生的小孩只有一只左眼睛?	人本来就只有一只左眼睛 
哪颗牙最后长出来？	假牙 
房间里着火了，小明怎么也拉不开门，请问他后来是怎么出去的？	推开门 
蓝兰并没生病，但她整个晚上嘴巴一张一合？	她吃瓜子 
什么最会弄虚做假？	魔术师 
有两个面的盒子吗？	有!里面和外面 
铁放在屋外露天会生锈，那么金子呢？	会被偷走 
拿鸡蛋扔石头，为什么鸡蛋没破？	左手拿蛋右手扔石头，鸡蛋怎么会破? 
“新华字典”有多少个字？	四个 
超人和蝙蝠侠有什么不同？	一个内裤穿里面，一个穿外面 
什么人心肠最不好？	得胃肠炎的人 
客人送来一篮草莓，贝贝吵着要吃草莓。可妈妈偏说家里没有草莓为什么	客人送来的只是一幅画 
从来没见过的爷爷他是什么爷爷？	老天爷 
2对父子去打猎，他们每人达了一只野鸭 ，但是总共却只有3只，为什么？	祖孙3人 
一个病人到医院去做健康检查，为什么医生说：“你离我远一点”请问这 病人得了什么病？	斗鸡眼 
什么东西没吃的时候是绿的，吃的时候是红的，吐出来的是黑的？	西瓜 
为什么太阳天天都比人起的早？	因为：人比太阳睡的晚！ 
一只狼钻进羊圈，想吃羊，可是它为啥没吃又没吃羊？	因为：羊圈里没有羊！ 
有卖的，没买的，每天卖了不少的。	门坎 
什么船最安全？	停在海滩里的船 
山坡上有一群羊，来了一群羊。一共有几群羊？	还是一群呀！ 
想把梦变成现实，第一步应该干什么？	起床。 
大熊猫一生中的最大遗憾是什么？	没有彩色照片 
下雨了，大家都急着回家，可有一个人却不紧不慢地走着（他没撑雨伞） 有人问他为什么不赶紧回家，他说了一句话，使那人晕了过去，请问他说 了什么话？	“急什么前面也有雨吗？” 
老板从来不会烧菜，可他每天都会烧相同的一道菜，请问这是什么菜？	“炒鱿鱼” 
读书人最难堪的事是什么？	想买一本书时，猛然发现包里没钱 
哥哥买了3袋米，弟弟买了2袋米，回家后他们把米放在1只大袋里， 现在他们有几袋米？	1袋米 
小明考了100分，为什么哭了？	他本身得了大零蛋。 
小王是一名优秀士兵,在站岗值勤时,明明看到有敌人悄悄向他摸过 来,为什么他却睁一只眼闭一只眼?	他在瞄准敌人~ 
为什么彤彤与壮壮第一次见面就一口咬定壮壮是喝羊奶长大的?	壮壮是一只羊 
有一种东西，上升的时候同时会下降下降的同时会上升，这是什么？	跷跷板 
做什么事要从头来。	剃头 
有一只公鸡在屋顶上下蛋，你说鸡 蛋会从左边掉下还是右边？	公鸡不会下蛋 
大力士永远也举不起的东西是什么？	他（她）自己 
为什么青蛙跳得比树高	树不会跳 
三心二意的人是什么人？	多心的人，因为那个人有三颗心. 
80厘米长的红螃蟹和30厘米长的黑螃蟹比赛跑步，谁会赢？	黑螃蟹。因为红螃蟹是煮熟的。 
元帅比将军高一个等级，什么时候元帅和将军平等？	下象棋 
什么东西掉进水里不会湿？	影子。 
小王是个司机，有一天开车出了车祸，当警察赶到时，发现车上有一个死人，小王确说不管他的事，为什么？	小王开的是灵车 
什么动物天天熬夜？	熊猫，它熬得眼圈都黑了。 
一头小猪卖200元，为什么两头小猪却可以卖几万元人民币？	因为长了两个头的小猪实在罕见。 
一个人,一只船,一只狗,一只兔子,一棵白菜,着个人要把着三样东西,运到 河那边,先送那两个？	先送狗和白菜 
什么人最喜欢别人叫它滚	监狱里的人 
用什么拖地最干净?	用力 
人为什么喜欢往上爬？	因为人是猴子变的。 
大象的长鼻子是怎么长成的？	出生时就有。 
一艘船最多能承受50个人，现在已经坐了49个人了，又来了一个人，那艘 船却沉了，为什么？	因为那是潜水艇 
桌子上有一个蜡烛和一个煤油灯，请问先点哪一个？	火柴 
动物园的大象死了,为什么管理员哭得死去活来?	因为他想到挖这么大的坑,可能会累死. 
为什么现在的猴子越来越少了？	都变成人了。 
小明整天说个不停，为什么今天一句话不说了？	因为他到了外国。 
为什么新买的袜子有两个洞？	要不然怎么穿 
小东上课睡觉，老师却不说他，为什麽？	老师没看见 
为什么一匹大青马掉进饭碗里淹死了？	一只蛐蛐的昵称 
抓到什么贼后可以马上处死刑？	乌贼 
一只毛毛虫（八只脚）走上一堆牛粪，下地以后却发现只有六只脚印，为 什么？	牛粪很臭，两只脚捏住鼻子了 
大雁为什么向南飞？	以为走的太慢了，就飞啊 
有一座桥只能乘重70公斤，一个人重65公斤，他要带两个分别重2.6公斤 的球过桥,没借用任何东西就从桥上把两个球带了过去,他是怎么过去?	抛起一个球,待它要落下的时候把另一个抛起. 
平时吃晚饭都是爸爸洗碗，可今天爸爸为什么吃完饭却不洗碗？	今天在饭馆里吃的饭 
有一只毛毛虫要过河，前面没有桥，问它是怎么过去的	变成蝴蝶飞过去 
什么动物你打死了它，却流了你的血？	蚊子 
一根生锈的绣花针，在7月7日7时7分7秒，浩月当空之时，扔到云南饵海中将会发生什么反应？	掉到海底 
什么筋伤了不能贴膏药？	伤脑筋。 
奇妙的关系 在斜坡上，有两个人推车。迎面走过来一个人，问前面的那个人：“后边 的那个人是你的儿子吗？”那个人说：“是!”他又问后面的那个人： “前面的那个人是你的爸爸吗？”他却说：“不是！”请问这是什么关	母子关系 
打破了什么人人都叫好？	世界纪录 
一个人掉到海里，为什么他的头发没有湿？	因为他是光头 
什么东西人们都不想要？	病。 
森林中有十只鸟，小明开枪打死了一只，其它九只却都没有飞走，为什 么？	鸵鸟 
你每天都能看见的最大的影子是什么?	黑夜,地球的影子 
积木倒了要重搭，房子倒了要怎样？	要逃命 
熊为什么冬眠时会睡这么久？ 因为没人敢叫它起床
有一个小圆孔的直径只有1厘米，而一种体积达100立方米的物体却能顺利 通过这个小孔，那么它是什么物体呢？	答案是水，你猜到了吗？
小明从六楼向下跳，为什么还没有受伤？	他转身向房间里跳的。 
上课时，老师问同学：“没有人类及动物居住的地球是什么呢？”小名很 快便答对了。你知道他的答案是什么吗？	地球仪 
什么地方盛产安哥拉兔毛？	安哥拉兔身上 
为什么金鱼看上去老是傻乎乎的？	它脑袋里灌水了。 
一个老爷爷要过桥，前面是狼，后面是虎，老爷爷该怎么 办？	晕过去 
你爷爷的儿子的爸爸的妈妈的姑姑的小姨的叔叔的大伯跟你是什麽关系?	亲戚! 
一个长方体盒子,有8个角,8条边,请问这个长方体盒子从中剪切开,还剩几 个角,几条边?	还有8个角,8条边! 
读一年级的东东没有学过外文，为什么也会写外国字？	他写的是阿拉伯数字。 
是黑鸡厉害还是白鸡厉害？	黑鸡。因为黑鸡会下白蛋，白鸡不会下黑蛋！ 
为什么老师一看到小宝就知道他爸爸是左撇子？	因为他的右脸上有五道痕。 
你打死了一个动物,为什么流的是自己的血.	因为打死了一只正在吸自己血的蚊子 
有一个东西，你能用左手拿，不能用右手拿，这东西是什么。	自己的右手 
螳螂请蜈蚣和壁虎到家中做客，烧菜的时候发现酱油没了饿，蜈蚣自告 奋勇出去买，却久久未会，究竟发生了什么事？	打开门后，发现蜈蚣还坐在门口穿鞋 
什么人重来不洗头发？	和尚 
一只狗和一只青蛙比赛游泳平常都是青蛙游的快,为什么在一次比赛中狗 赢了?	因为当时的比赛规则是之许用狗刨,不许用蛙泳! 
小伟的书包里藏着一个鸭蛋，他为什么不肯拿出来交给妈妈做菜？	那是考卷上的“大鸭蛋 
人死了为什麽要闭眼睛？	因为睁着眼睛会吓死人的！ 
黑手党为什么喜欢戴白手套？	因为手太黑。 
国歌一共有几个字	两个 
一块天然的黑色大理石，在一月一日扔入太平洋，会发生什敏麽？	大理石沉入太平洋 
有5只小蚂蚁，每只小蚂蚁都说它身后还有1只小蚂蚁，为什么？	有只小蚂蚁在说谎 
什么牛不吃草？	蜗牛 
老师说：“我们的身体里有106块骨头”，可是，小明说：“他身体里有 107块骨头”，这是为什么？	因为小明不小心吃下一块鱼骨头。 
什么书既没有作者，也没人能读懂？	当然是天书啦！ 
一个人一年中哪一天睡觉时间最长？	一年中的最后一天，因为他跨越到第二年。 
树上“qi”个猴，地下“yi”个猴，一共几个猴？	两个猴 
自找苦吃的地方是哪儿？	药房 
一间牢房关了两个犯人，其中一个因偷窃要关一年，另一个是强盗杀人犯 却只关两个星期，为什么？	强盗杀人犯被拉出去枪毙啦 
你怎样才能把你的左手全部放入你身上右边的裤袋内，而同时又把你的右 手全部放入左边的裤袋内？	把裤子前后反着穿 
5只鸡5天生了5个蛋。100天内要100个蛋，需要多少只鸡？	仍然仅需5只鸡 
什么东西越剪越大？	洞 
网是用什么做成的？	用一个个洞做成的。 
没完成作业怎么办？	问老师啊，作业是老师留的。。 
仪式 牧师主持过各种各样的仪式，可是有一种却是他无法主持的。请问是什么？	自己的葬礼。	
考试 在一次监察严密的考试中，有两个学生交了一模一样的考卷。 主考官发 现后，却并没有认为他们作弊，这是什么原因？	他们都交的白卷。	
吃草 草地上画了一个直径十米的圆圈，内有牛一头，圆圈中心插了一根木桩。 牛被一根五米长的绳子栓着，如果不割断绳子，也不解开绳子，那么此牛 能否吃到圈外的草？	能，因为题中并没说牛被栓在木桩上。 
你知道为什么鱼只生活在水里，而不生活在陆地上吗？	陆地上有猫 
有两个硬币，是五角五分，其中一个不是五角，那是哪两个硬币？	就是五角和五分，五角当然不是五分啦！ 
你知道稀饭贵还是烧饼贵？	稀饭。物以稀为贵 
什么时候是摘苹果的最好时机	苹果熟了的时候 
有一个人口袋里有五元钱，掉了五元钱口袋里还剩下什么东西？	一个洞 
什么鱼的肚皮是浮上水面的？	死鱼 
小明今年12岁，为什么只过了三次生日？	生日是2月29日 
有一家动物园死了一只大象，为什么饲养员要抱头痛哭？	因为他要给大象挖很大的一个坑。 
小明每天都吃一个师傅，他是怪兽吗？	吃康师傅嘛！ 
小王刷了一早上的口，为什么别人还是说他口臭	因为小王爱骂人，所以别人说他口臭。 
小力把一个鸡蛋扔到2米多处还没碎，为什么？	因为鸡蛋被扔到2米多处的时候还没落地。 
两个人去陆菅，晚上睡在帐篷里。不久其中一个人醒来叫醒另一 人。问你看到天上的星星。你会想到什么？	账蓬被人偷走了。 
一根长棍子(不准弄断),那怎样才能使它变短?	拿一根更长的棍子和它一比不就短了吗. 
为什么先看见打闪后听见打雷。	因为眼睛长在前面 
什么路人们最不敢走?	绝路 
什么人敢在皇帝的头上胡作非为?	理发师 
什么官,不发工资,却要给别人钱,还要陪笑脸?	新郎官 
一个挖好的长6米、宽7米、高8米的坑里有多少土？	已经挖好，所以没有土！ 
在中国，哪个村庄最大？	石家庄 
马在哪里不需腿也能走？	象棋盘上 
美国总统是怎么进皇宫的?	从大门进去的 
一个数去掉首位是13，去掉末位是40。请问这个数是几？	四十三 
我们都知道把一只大象放进冰箱里分三步：1把冰箱门打开；2把大象放进 去；3把冰箱门关上。 那么，请你把长颈鹿放进冰箱里分几步？	四步：1把冰箱门打开；2把大象拿出来；3把长颈鹿放进去 
有一天老张去集市买小鸡，转了半天买了10只公鸡10只母鸡，回家的路上，不知道想了什么 赶紧有跑到集市上买了5只公鸡5只母鸡为什么？	喂小米啊 
什么样的钉子最可怕？	眼中钉。 
杰克跑的最快，为什么他的长官还要批评他？	逃跑 
穷人和富人在什么地方没有区别？	浴室 
小芬对小芳说：“后天的大前天的后天，也就是昨天的昨天的大后天 是我的生日，请来参加我的生日会。”小芳应该什么时候赴约呢？	是明天赴约。 
一个人，他感觉地球在站动，为什么？	他喝醉酒了。 
从前有三个人，一个是罗锅，一个是摇头，一个是瘸腿，有一天，他门三 个过一座桥，这个不让罗锅.摇头.瘸腿,这三个人的病不许过,你帮他们想 个办法让他们过去。	罗锅先放一个蛐蛐，然后罗锅说蛐蛐，摇头就在那要头说 
什么人喜欢天天下雨	制造雨伞商 
哪座桥不能开车也不能走人？	郑板桥 
有人说“吃鱼可避免患近视眼”,为什么?	你看过猫戴眼镜吗? 
一双鞋卖16元，一只鞋卖多少钱？	不卖。 
哈巴狗去掉尾巴最像什么动物？ 睡觉前要做什么事？	哈巴狗 闭上眼睛 
小华的爷爷有7个儿子，每一个儿子又各有一个妹妹，请问：小华的 爷爷有多少个儿女？	8个，女儿是最小的。 
地上掉了一张5元的和一张50元的钞票，你看见了会捡哪一张？	两张都捡 
将军为什么不用出城做战？	在下象棋。 
世界上谁的头力气最大？	火车头 
什么东西最能让人满足？	袜子 
动物园里有一只可爱的熊猫，为什么人们都不敢接进它	油漆未干 
青蛙和狗比赛游泳，为什么狗赢了？	因为它们比赛的是狗刨式游泳。 
天最顶上是什么？	是“一” 
奶牛天天挤奶，它还有奶这是为什么？？？？	喂草呗 
什么狗身上湿淋淋的？	落水狗。 
能使竹篮提水不一场空的最好办法是什么？	提冰~。 
两个口是吕，三个口是品，那也四个口、五个口分别是什么字？	田、吾 
小明放学回家对妈妈说：“家里有一个地方，我想坐就坐，而你却不能坐”你知道这是什么地方？	妈妈的膝盖上 
一个人有一个，全国12亿人只有12个，这东西是?	12生肖 
乌龟梦见自己中了一百元大奖,醒来梦想成真,它接下去该怎么办?	再睡一觉 
一个商人破产了，有半数朋友不认识他了，为什么？	因为还有一半朋友不知道他破产了。 
动物园里大象的鼻子最长，那谁是第二个长的呢？	小象 
最坚固的锁，最怕什么？	钥匙 
什麽东能逛变世界	风 
小明的妈妈让小明买蛋里没有小鸡的蛋小明应该买啥蛋。	鸭蛋 
一个人有三根头发，为什么把中间那根拔了？	因为他要“中分”。 
小刚唱歌很烂，为什么观众却掌声不断？	观众在拍蚊子。 
为什么拔一颗牙齿需要十个医生？	因为拔牙的是头大象。 
什么枪只能吓跑人，不能打死人？	比赛用的枪 
王奶奶只花了一天，就能从广州扫到北京。她是怎样做到的？	她在火车上扫的。 
一条狗想穿越撒哈拉沙漠，它备足了干粮和水，但最后还是死在沙漠里， 为什么？	因为沙漠里没有电线杆（尿憋死的） 
一只老虎面前有5个山洞，每个山洞都有一只羊，它为什么进了第2个山洞？	它想进哪个山洞就进哪个山洞 
张飞的母亲姓什么？	姓吴（解：无事生飞） 
11+2=1?对吗?	对!11点另2点就是1点啦! 
烧什么汤最“鲜”？	“鱼”肉汤和“羊”肉汤。 
为什么两只公老虎打架，非要拼过你死我活绝不罢休？	因为没有人敢去劝架。 
什么路 走不了。	电路 
为什么太阳总是比人起得早?	因为人总是比太阳睡得晚. 
有一种东西，成熟了会有胡须，这是什么？	玉米 
作家写小说，一般最先从哪里开始写起。	笔尖 
一天，有两人在马路上走着，一人说：“你看前面有辆车”另一个人却 说：“没车”为什么？	煤车 
小明她很聪明，为什么连东南西北也分不清？	因为她的眼睛被蒙住了。 
这个东西别人能用，自己也能用，但它属于自己，它是什么？？？	名字 
什么报只印一份？	电报 
天天和人打架的人是谁?	拳击手. 
船厂老板最怕什么?	地球上没水. 
小明想用钢笔画个圆，问他从那开始？	钢笔尖 
五月最长是那一天？	一样长 
森林里什麽最多?	树叶 
“太阳”的“太”去掉一点是什么字？	去掉“一”，“点”当然是“人”字啦！！ 
世界上哪座城市交通最发达？	罗马 
什么情况下四减一等于五？	四角形剪去一角剩下五角 
什么大楼最便宜？	五角大楼 
小东是钓鱼高手。但有一次，他一条鱼也没钓到，为什么？	因为小东在钓虾场钓虾！ 
国庆节的时候为什么天安门广场上连半个人都没有？	因为人不能算半个的 
插在牛鼻子上的花是什么化？	牵牛花朵 
一个人头戴太阳帽，身穿雨绒衣,手提电风扇,脚穿溜冰鞋,请问他要往哪 里去?	去精神病医院． 
为什么小偷坐车不要钱？	因为他坐的是警车 
一只蚂蚁可以从日本爬到中国，可能吗？	蚂蚁在地图上爬	
医治晕车的最好办法是什么？	不坐车。 
如果朱葛亮还活着，世界上会有什么变话？	多了一个人 
有一个人上身穿棉袄，下身穿短裤，左手拿着冰可乐，右手拿着热咖啡，天天坐在火炉旁，又开着冷器，请问他是谁？	神经病 
1、什么门不能关？2、什么马不会跑？ 3、小康说一只五边形的盒子只有两个面，对吗？	1、球门； 2、木马； 3、对，里面和外面。 
牙科医生最希望什么商品畅销？	糖果呗！ 
我看的见，你看不见，你看的见，我看不见，是什么？	梦 
熊猫最大的心愿是什么？	照一张彩色照片 
奶奶叫孙女擦桌子，擦了半天，奶奶还是说脏，为什么？	因为奶奶的老化眼镜脏了！ 
小孩在一家门口玩，一人问：“你妈在家吗？”小孩说：“在。”此人按门铃，却无人开门。小孩未撒谎，为何？	小孩说：“我没说这是我家！” 
什么饼不能吃	铁饼 
小刚到外面吃饭，为什么不要钱？	因为小刚在家门外吃饭 
动物园里的小象将会变成什麽	大象 
鱼缸里有十条鱼死掉了一条问还有几条？	十条死鱼也是鱼 
用甚麽办法能使眉毛长在眼睛下面	倒立就行了 
请问大家，人能活多少久呢？？？	当然是活到死的时候啦！ 
人最想知道而又无法知道的事是什么？	将来的事 
小王买了一个大西瓜，回到家中，他把西瓜放在桌子边上，一刀切成了五 大块，十小块，问是怎么切的？	因为西瓜掉下去一块，所以是“捂”大块，“拾”小块！ 
哪两个东西人在说“爸爸”的时候会碰撞，人在说“父亲”的时候不会碰撞？	上嘴唇和下嘴唇。 
金太太平时做事一贯很利落，为什么这次却吞吞吐吐？	吃甘蔗。 
一个人左右手各拿着一个碗，同时摔下去，一个摔破了，一个没摔破，为 什么。	应为一个是铁，的一个是瓷的。 
小明初一12岁，初三为什么还12岁？	大年初三嘛 
在什么时候小猫比老虎大。	小猫在凸镜面前，老虎在凹镜面前的时候。 
十二个人有十二个，十二亿人也只有十二个，这是什么？	十二生肖或十二星座 
小明在查字典，他在查什么字？	他在查不认识的字 
什么河里没有水？？？	象棋上的楚河。 
小明在一间很黑的屋子里,为什么什么都看得到?	他在幻想未来. 
有个人被关在一间房间里，房间里只有一扇门。他想拉门却拉不开。 请问他怎样才能出去。	用手推嘛。 
有一对夫妇天天吵架,为什么6月只吵了20天?	因为他们6月10才结婚. 
有一种海里一滴水都没有为什么？	辞海 
什么花盛开时人看不见？	心花怒放 
小成是小芳的姐姐，可是有一天，小成却叫小芳姐姐，这是为什麽？	因为她在做梦。 
怎么使不知道变成知道？	把不擦掉 
什么帽不能戴？	螺帽 
小东考试考了0分证明了什么?	证明了小东考试没做弊. 
于宙飞船须密行？	天机不可泄露 
“孔子”和“孟子”有何不同	“孔子”的子在左边，“孟子”的子在上面 
羊大一点还是狗大一点？	狗大（犬） 
什么虎不吃人？？	爬壁虎 
唐克在竞走比赛中得了第一，为什么无人为他喝彩？	因为他是倒数第一。 
哪种比赛，赢的得不到奖品，输的却有奖品?	划拳喝酒 
路边电线杆上蹲着一只猴子，司机小李看到就立刻停下车来，请问为 什么？	他把猴屁股当红灯了 
老王不小心把一枚硬币吞进了肚子里,但他为什么十年后才动手术取出来 呢?	当时不急着用 
彦明和东杰住在同一条胡同,早晨上学彦明向左东杰向右,同时到达学校, 为什么?	他俩住对门 
下雨的时候，把铁放在外面会生锈，把金子放在外面会怎样？	“会被偷走” 
小明的房间很乱怎样才能用最短的时间内收拾的干干干净净	闭上眼睛 
什么门总是开着？	球门 
什么宫殿进去容易出来难?	迷宫 
什么东西可以举起沉重的木头，却举不起一粒沙子？	大海。 
脸上长什么无药可救。	胡子。 
小英踩入水坑,槭颤N她的鞋]有瘛	因樗]有穿鞋 
什麽桥下没有水？	立交桥 
有一失眠者对医生说：“我晚上睡不着觉，怎么办？”医生对他说：“你从一数到一百，一直这样数下去，就能睡着。”可失眠者说：“这不行。”这是为什么？	失眠者是拳击运动员，数到八一定要起来。 
有一条不到一米宽的窄路,两边是陡峭的绝壁,有一个人被蒙上双眼,捆住 四肢,只能像兔子似的往前跳,却安全地走完了这条路.为什么?	因为陡峭的绝壁把小路给夹住了. 
一个黑人罪犯被警察追捕逃到一家白人俱乐部，警察把那家俱乐部里里外 外都找遍了，就是没有找到那个罪犯，为什么？	黑人罪犯吓得脸色煞白 
什么桶永远装不满？	马桶！ 
什么样的强者不能当。	当然是强盗啦！！！！！ 
一只瞎了左眼的山羊左边放一块猪肉右边防一块牛肉它会吃哪块？	都不吃，山羊不吃肉 
一位司机打开车门后的第一件事是什么？	坐下 
兔子有和乌龟赛跑，这次没睡觉，为什么还是输了？	这次对手是忍者龟。 
9月28日是孔子主诞辰，那10月28日是什么日子？	孔子满月 
什么枪能打跑人去不伤人？	起跑用的发令枪。 
图钉掉了，用什么方法可立刻找到？	光着脚。 
美丽的公主嫁给了一个王子，就不需要挂蚊帐了。为什么？	因为她嫁给了青蛙王子。 
一个人掉进了河里，头发为什么没湿？	他是光头。 
什么人整天工作忙得团团转？	芭蕾舞演员 
啥床不能睡	电床 
雨停了，有个人在大街上脱衣服，却没人管，为什么？	他脱的是雨衣。 
在动物园，最先看见是什么关在笼子里的动物？	售票员。 
动物园起火了，什么动物最先逃走？	人 
医生在给病人做手术时为什么要戴口罩。	因为怕死人被别人认出。 
一个人把窗户关了，为什么等他在回来时窗户却开了？	应为他女朋友帮他开窗户了 
象棋与围棋的区别是什么？	象棋的棋子越下越少，围棋相反 
一只普通手表刚掉到大海里,会不会停?	不会，继续往下落 
为什么你在睡觉时老是做梦呢？	因为你想得太多了。 
小明球技很差，为什么在足球比赛中得了亚军？	因为只有两个队 
一个人从飞机天上跳下来，为什么却没有死。	跳伞 
什麽人能享受免费旅游？	肚子里的婴儿 
小王一直在登自行车为什么旁边的景物一点也没变.	他在登健身车 
有人吃饭前要从嘴巴里拿出一个东西来请问是什么？	牙套 
人们明知道是假东西,为什么还要买?	因为是假发. 
为什么老李的马会把老张的象吃掉?	因为他们在下象棋。 
池是用来装水的。可是有一种池里却永远没有水,为什么?	电池里不能装水 
天平的左边吨棉花，右边是一吨铁，为什麽棉花会比铁重？	因为下雨了。 
秦始皇为什么需要这么多的兵马俑陪葬?	死要奖排场呗! 
一个人，穿着皮大衣，戴着棉帽子，他前面有一条河，对岸有一棵树，问 他是怎么够到那棵树的？	他穿的那么厚，当然是冬天，河已结冰，他是滑过去的。 
什么菜怎么洗也洗不净？	灰菜 
什么东西千万不能背？	罪名！ 
黑人吃黑的东西叫什么？	黑吃黑 
吃出一个虫子可怕，吃出两个虫子更可怕，最可怕的是吃出几个虫子？	半个虫子。 
一块黑石子与一块白石子同时放入水中,有什么变化.	石子变湿 
小波比的一举一动都离不开绳子,你知道这是为什么吗?	因为小波比是个小木偶! 
人们常说,打狗要看主人,那么打虎要看什么?	胆量 
小明的手很脏，这时候他要去弹钢琴但他并没有洗手虽然把钢琴弄脏了可 却看不出来。这是为什么？	因为他弹的这首曲子只弹黑键。 
一个农夫每天都给鸡下的蛋写上日期，可8个星期后就不知道蛋是哪天生的了，为什么？？	因为他每天都写今天！！ 
什么戏人人都演过?	游戏 
所有的人都离不开的地方是那里	地球 
月球上去过外星人吗?	去过,去过地球人! 
从飞机上跳下来最怕忘记什麽？	降落伞 
一个人从万丈峡谷往下跳，为什么没摔疼？	那个人已经摔死拉 
小民生病了，要开刀，换脑。医院里还有脑，为什么不换？	有1000台电脑。 
小明为什么能四个小时不眨眼。	他在睡觉。 
一艘大船已航行多时，为什么从来没沾过一滴水？	因为这是一艘太空船！ 
爸爸、妈妈、小民去奶奶家，小民坐车去，但是爸爸、妈妈却一早到 了？	因为小民坐错车了！ 
人可以登上任何高山,可有一个地方永远上不去?	自己的头顶 
什么花一年四季都开？	假花 
美美的爸爸是天文学家，但对一些星的知识却没有美美多，那是什么？	歌星的知识 
月亮什么时候不发光?	月亮本来就不发光. 
为什么王爷爷擦桌子,怎么也擦不干净?	因为王爷爷的眼镜花了 
有10只鸟，打死了一只，其它九只为什么没飞？	因为那是一群驼鸟。 
有一家叫"友朋小吃"的面包店,每当小朋友经过时都急急忙忙地跑开去,为什么?	因为小朋友将"友朋小吃'看成"吃小朋友"! 
小李薪水很低，可为什么天天一掷千金？	他是银行的运钞员 
如何把撒在地上的芝麻迅速捡完？	把鸡叫起来 
一只乌龟做梦梦到自己中了千元大奖，他醒来时发现美梦竟然成真了。他 下一步该怎么办？	自己在睡一觉。 
什么消费者甘心任人宰割？	上了手术台的病人！ 
冬冬昨晚九个小时花在了英语课本上，可爸爸还是怪他不用功？	他将英语课本当枕头睡着了！ 
什么东西转动不需要动力。	地球。 
一个人他的枪法不怎么样，可是有一天却打中了人家的帽子。	他把帽子罩在枪口上。 
一个跳伞运动员从1000米高空跳下，为什么人们半天也不见他呢？	因为他掉海里了！ 
闪电和电有什么不同？	闪电收费，电不收费。 
什么只能加不能减？	年龄 
小桦每次跑步都跑最后，但这次却在体育考试上拿了个第一，为什么呢？	倒数第一 
小迷糊的成绩单星期一才会发为什么星期天晚上他就因为成绩被爸爸训了 一顿	因为他爸爸是他的老师 
什么东西加上十还是十个,减去十个,还是十个?	戴手套 
锦蛇,蟒蛇,青竹丝,哪种最长?	青竹丝三个字最长. 
打什么最省力又舒服	瞌睡 
小明家的鸡在小亮家里下了一个蛋，蛋是谁的？	蛋是鸡下的，当然是鸡的。 
为什么母鸡的腿比公鸡的短？	因为母鸡要生蛋，腿长了会把蛋弄碎了 
什么东西不细菌还小？	细菌的儿子 
龙生的儿子和狗生的儿子有几点不同	一点不同。龙生的儿子叫太子，狗生的儿子叫犬子 
上课铃响了，却没有一个人进教室。这是为什么？	是体育课。 
老王工作不努力，却能天天步步高升，为什么？	坐电梯上班 
小李司机看见一只猴子蹲在树上，为什么小李司机把车停下来了？	因为小李司机把猴子的屁股当成红灯了。 
什么时候有人敲门，你绝不会说请进？	你在厕所里上厕所的时候 
为什么秋天大雁总要往南飞？	因为飞的比走的快。ok? 
放大镜有什么放不大？	角度 
有人开着出租车出门，为什么没人打车？	他走的是高速公路。 
三个“木”叫“森”，三个“人”叫“众”，三个“鬼”叫什么？	救命！（三个鬼，你不害怕？？） 
小猴到树上摘南瓜，一巴掌打下一个，十巴掌打下几个？	南瓜不长在树上。 
小民说：“我有一瓶万溶胶。什么东西遇到它顷刻之间便会融化。”他的 话有什么破绽吗？	这种东西用什么容器装？ 
什么东西本身不大，但它能装比它还要大的东西，说的是什么？	电视 
煮1只鸡蛋需5分钟，煮4只鸡蛋需多少分钟？	还是5分钟。 
为什么暑假比寒假长？	热胀冷缩 
一只公猫加一只母猫，打三个字	两只猫 
什么东西大象才有,而别的东西没有?	别的东西没有小象 
在什么地方被人打不疼？	在梦里。 
大街上,有个人仰着头站着.旁边的人以为天空中有什么好看的东西.都跟 着仰头望着天空.可天空中什么也没有.你猜那人怎么说?	“我的鼻血总算止住了”那人说 
孔子是世界上著名的什么家	老人家 
卖的人知道，买的人知道，用的人不知道。	棺材 
三个人合撑一把伞在路上走，可没有一个人被淋湿，为什么？	没下雨 
一年前的今天我们都在做着同一件事，你知道是什么事吗？	呼吸 
小明是著名的跳水运动员，可有一天他站在三米板上不敢跳，为什么？	因为池内没水 
什么人生来就称王？	姓王的人 
天上没有星星，也没有月亮，马路上的路灯没有打开。 为什么有一辆汽车能快速安全地行驶着？	在白天 
世界上什么鱼两个眼睛距离最近。	最小的鱼 
小亮要当警察追随父亲的足迹，他父亲是干什么的？？？	小偷 
你有山渣GAO吗？	有是高不是糕 
真理的位置在哪里？	真理无所不在 
小明想梦想成真，他最好的办法是什么？	醒过来。 
有个老人过生日，有人祝他长命百岁，为什么老人马上把他赶出去？	因为那老人正在过99岁生日 
什么树没有叶子？	枯树 
前面一堆草,后面一堆草,你看到了什么花?	没花 
烧饼贵还是稀饭贵？	物以为稀 
有一个口齿伶俐的人,为什么见到他的朋友都不说话呢?	他朋友拿的是这个人的照片 
什么朝代最清净？	清朝 
什么水永远取之不尽，用之不竭？	口水 
为什么有人说岳飞背上的字是他丈母娘刺的？	因为是“岳母”嘛！ 
沙漠里为什么没有鲜花？	因为没有牛，是鲜花插在牛粪上。 
怎样才能买到没有小鸡的蛋?	买鸭蛋 
全世界最大的公鸡从哪里来的？	蛋里 
有一个人丢了头毛驴不去寻找，却不停的喊；“谢天谢地，谢天谢 地......” 为啥呢？	还好他没坐在上面，不然他也丢了。 
客人送来草莓，贝贝吵着吃草莓，可妈妈为什么说家里没草莓？	客人送的是一幅画。 
报纸和电视新闻有什么不同？	报纸看完了可以包油条，电视不可以。 
一只已经饥饿以久的狼看见一只绵羊，却马上逃走了。为什么？	羊的后面有只老虎。 
什么人不怕冷?	雪人 
一只蚊子飞到了老奶奶的额头上，老奶奶动都没动，为什么蚊子却死 了？	被老奶奶的皱纹掐死了呗，傻瓜！ 
烟鬼甲每天抽50支烟，烟鬼乙每天抽30支烟。5年后，烟鬼乙抽的烟比 烟鬼甲抽的还多，为什么？	因为烟鬼甲由于烟抽的太多，死了。 
世界上最大的土豆长在哪里？	地里 
两幢大楼，相隔才10CM，一幢大楼起火了，一个人往另外一幢大楼 跳，为什么还是摔死了？	因为他们相隔高度有30米！ 
两只老虎打架为什么斗得你死我活？	因为没人敢劝架。 
有一种线只能看，怎么也摸不着，为什么？	光线 
一架飞机撞到山上，确没有一个人受伤。为什么？	那是玩具飞机。 
两个爸爸和两个儿子到店去吃饭,服务员只给三份套餐,为什么?	两个爸爸中有一个是爷爷另一个就是爸爸,两个儿子中有一 
一个办公室很简陋，下雨时雨水常常滴在工作人员身上。但有一 天，下暴雨，但工作人员一个都没被水淋着，为什么？	因为那天是周末，没人上班。 
世界上使用的语言很多，那么什么话是世界通用得最多的？	电话 
小明抢了东西就走，为什么大家还为他高兴？	因为小明在踢足球。 
今天晚餐吃咖哩，都快凉掉了，妈妈为什么还不叫大家吃饭？	因为家里的人都还没回来。 
小明把一个鸡蛋扔到4米远地方时，为什么鸡蛋没有碎呢？	鸡蛋在4米远时还没有着地。 
什么人一听到乐曲手就会不停地抖动？	指挥演奏的人 
怎样用一块钱换一百块钱？	打电话向家里要钱。 
谁知道到天上有多颗星星	天知道 
什没东西只能往前走，不能往后退。	时间 
什么人肚子最大?	宰相,因为宰相肚里能撑船. 
有四个中国人：小黄、小李、小王和小张，他们一起去瑞士旅游。小 黄会说拉丁语和德语，小李会说德语和法语，小王会说法语和英语， 小张会说西班牙语和英语。这天他们在饭店里看到一张用拉丁语写的 旅游广告，小黄读	何必那么麻烦，直接用中文不就行了嘛！ 
中国的国内盛产什么？	玉，“国”字内是玉。 
你妈妈小时候有没有打过你？	没有（你妈妈小时候怎么可能打得到你！） 
一名大师他的功夫真不一般，他居然可以在下雨出门时，即便不带任何遮 雨的工具，包括帽子也不戴,就算全身都湿透了的时候，头发也不会湿； 真不知他用的是什么法术，可这都是真的！为什么?	因为他是和尚 
喝什么东西可以让人变成鬼?	酒,酒鬼 
第九届奥运会男子100米赛第一个跑到终点的是谁	工作人员 
一对夫妇天天都吵架，为什么六月份只吵了20天？	因为他们是6月10日结婚的。 
人的一生最需要什么？	吃饭 
一个在意大利工作的人，有没有可能死在美国？	不可能。因为他（她）正在工作。 
大眼霞在38度的高温下运动，为什么没有中暑？	她在游泳。 
什么人没病也天天去看病？	是医生啦！ 
人们常说的三个字是什么?	不知道 
怎样让自行车和火车跑得一样快？	把自行车放在火车上。 
什么事两个人在一起就知道是谁做的，三个人（或以上）在一起就不知道 是谁做的？	在房里放一个不响，但劲臭的屁！ 
什么亮在暗中看不见？	飘亮 
如果地球爆炸，哪两个地方最安全？	天堂和地狱 
一溜三棵树，栓十头羊，怎么栓？	一六三加再一起不就是十棵树！ 
一个成年的胃病病人，为什么去儿童医院？	因为他是儿童医院的医生。 
为什么大眼霞吃葡萄不吐葡萄皮？	因为她在吃葡萄干。 
小鸡和小鸭同伴去郊游，它们要过一座山区，一条小河，它们能到达目地 吗？	不能。因为小鸡不会游水。 
爸爸买了一支钢笔给小阳。小阳就在白纸上画了一个圆圈，他（她）是 从那（哪）里开始画的？	是从钢笔尖开始画的 
三个臭皮匠顶个诸葛亮，一个诸葛亮顶个什么呢？	顶一台电脑。 
圆圆的考试卷上哪个分数最高？	当然是总分最高喽！ 
什默破了比不破好？	破案 
什么东西越洗越脏？	水。 
什么车最长？	堵车 
小丽对小花说：“后天的大前天的后天也就是昨天的昨天的大后天是我 的生日，请来参加我的生日会。小花应该什么时候去呢？	明天 
什么老鼠跑的最快	见到猫的老鼠 
什么火没有烟？	萤火 
小明跟爸爸妈妈去外国旅行。不会外语的小明为什么没有感到不方便？	小明是婴儿 
老张是一位出色的小说家。可是，为什么老张在近一个月里，一篇文章的 题目也写不出来？	他在写日记。 
一个人从小到大一直流浪，为什么有一天他不流浪了	因为他死了 
一个东西有四条腿却不能走路，为什么？	是桌子。 
鸟类的绝症是什么？	畏高症 
青蛙为什么跳得比树高?	应为树不会跳. 
一架飞机在天上飞，忽然没油了，什么先掉下来？	油表先掉下来 
什么花没有枝？	雪花 
小东聪明过人，为什么今天连北都找不着？	因为他被蒙着眼睛。 
什么鸡没有翅膀？	田鸡 
什么东西你只要叫一声它的名字它就会破坏？	沉默 
十个人打架八个人劝驾六个人回家两个人关门	校 
一只小狗在沙漠中行走，它带了充足的水和食物，也找到了直的电线竿， 上面也没有挂上“请勿随地大小便”，为什么还是死了？	那时小狗太多，它无法靠近电线竿。 
白雪公主和黑马王子结婚后生下一个小姑娘叫什么名字？	灰姑娘 
什么寨人最多？	柬普寨 
什么水是按日期发的？	薪水 
什么池里没有水？	电池里没有水。 
你能把一张崭新的十元钱立在桌子上吗？	把钱折一下 
什么东西越旧越好？	古董 
一年四季都不热的水是什么水？	冰水。 
一只小猪跑了，主人拿一根棍子赶它,院子特别大可是小猪却撞死在树上了,为什么？	因为小猪不会脑筋急转弯，哈哈 
什么东西人们都不喜欢吃？	吃亏 
有一个盲人走路，在路上捡到一个大鸭梨，他拿起梨说了一句话，这句话是一个国家的名，这国家的名是什么？	澳大利亚（噢大梨呀！） 
雨下大了，人们都争先恐后地往前跑，可是阿呆却不紧不慢地走着，为什么？	他说前面也在下雨。 
小华才四岁为什么就当爸爸了？	玩过家家嘛。 
什么人每天弄虚作假？	演员 
在一个房间里，有很多人，要把一个萍果放在哪里，才能使一个人看不见，别的人看的见。	放在一个人头上。 
一只船在水中破了一个洞，漏水了，怎么办？	再挖一个洞 
什么东西倒着放比顺着放好？	“福”字 
什么车用绳子拽动了轮子也跑不起来？	纺车 
一个人用一根米线上吊,他死了.他是怎么死的?	摔死的 
哭和笑有什么相同之处？	都是十笔。 
火箭为什么飞的那么快?	你屁股上着火当然跑的快了. 
睡美人最怕什么？	失眠 
一个农场没有鸡，为什么有蛋？	因为养鸭 
什么歌唱起来最危险？	《长恨歌》 
什么河里没有水？	银河 
什么船从来不下水？	宇宙飞船 
什么字半个月才能写完	胖 
每次吃完饭都是爸爸洗碗，可今天却没洗碗，为什么？	因为在餐厅里吃饭。 
投资哪种票，风险最大？	绑票 
坐什么板凳最不好受？	冷板凳 
胖姐生病了，最怕探病人说什么？	多多保重 
什么是倾城倾貌？	地震 
什么杯不能装水人们却想得到它？？？	奖杯 
有两位爸爸，两位儿子，为什么只有三个人？	他们是祖宗三代 
小偷看见一辆车为什么不去偷？	车是自己的。 
什么果不能吃？	恶果 
念“清华大学 ”要多长时间？	最多需要四秒钟。 
一天里，时钟的长短针多少次完全叠合？	它们的长短不同，所以不可能叠合。 
小明被汽车撞到了，但是没有撞伤，为什么？	是玩具汽车 
小花不是哑吧，但却不会说话，为什么？	小花是只小狗。 
什么人不敢透视检查？	狼心狗肺的人。 
一个坏人朝小明走过来，小明为什么不躲开？	小明在看电影 
什么海没有水？	火海 
什么东西天气越热它爬的最高？	温度计 
3个1加3个等于多少？（打一个字）	田 
一个司机在一个没有星星和月亮的天空，没有开车灯，突然停下车把公路上的一块黑布捡了上车。你知道他为什么能看见吗？	因为是白天。 
你们知道谁是万兽之王吗？	动物园的园长。 
牢里有两个犯人，一个抢劫犯，一个杀人犯。杀人犯却比抢劫犯先出来。为什么？	因为杀人犯要被带到刑场上执行枪决。 
“先天”是指父母所遗传的体质，那“后天是指什么呢？	后天就是“明天的明天”。 
为什么大雁每年要飞到南方去？	走会太慢嘛 
小红的爸爸带了一些兔子去卖，回来时，小红爸爸即带来了钱又带回了兔子。这是怎么回事？	小红爸爸卖了兔毛。 
一个2米长，3米宽，4米深坑里有的多少方土？	因为是坑所以没有土。 
学生考试要注意什么？	监考老师 
刚刚买的袜子怎麽有一个洞？	没有洞怎麽穿呢 
什么时候别人敲门你绝对不会说请进。	上厕所的时候。 
一个人对着电风扇吹可是他却满头大汗，为什么？	他在吹风扇 
将西瓜和葡萄分别从离头顶半米高的地方砸到你头上，哪个比较痛？	你的头比较痛！ 
两个考生交了一模一样的卷子，但监考老师认为他们肯定没作弊，为什么？	两人交的是白卷 
老王家有客人来，老王马上戴上了一只手套。这是为什么？	因为他要“露一手”。 
小明一点儿也不会数学，可老师说他的数学程度是数一数二的。为什么？	因为小明只会数一和数二。 
一个人向你问路 你最怕他问你什么？	这是地球吗？ 
3个人吃3张饼用3分钟，9个人吃9张饼用几分钟？	3分钟（同时吃） 
3个人3天用3桶水，9个人9天用几桶水？	27桶 
一条凶猛的眼镜蛇，在一个森林里它为什么不吃人。	因为它在一个没有人的森林里。 
小明和他妈妈为什么都在一年级教室里？	因为他妈妈是一年级的老师。 
什么药在药铺买不到。	后悔药 
什么人靠运气赚钱？	运送煤气的人 
小明的爷爷为什么能一边刷牙，一边唱歌。	刷的是假牙 
怎样把今天变冷天？	加三点“冷“ 
印度人为什么要用手抓饭吃呢？	因为用脚不方便呀！ 
请人吃没人吃,自己也难咽下去的东西是什么?	亏. 
全世界各国之间通用的话是什么?	电话. 
一辆自行车往北行驶请问冒得烟往哪飘？	自行车不冒烟 
丹顶鹤为什么睡觉用一只腿站着?	因为它两只脚都不站就掉下来了. 
盲人夜行手提一盏灯，这是为什么？	怕别人撞到他	
你的爸爸的妹妹的堂弟的表哥的爸爸与你是什么关系?	亲戚关系 
一个人从十楼上往下跳却没摔死，这是为什么？	因为是从十楼窗户上往里跳。 
一个人在炒一锅豆子，豆子有两种颜色，分别是红色和绿色。当他炒完了，他就将一锅豆子泼了出去，可是两种颜色的豆子却自动分开了，为什么？	因为锅里只有两颗豆，一颗红豆，一颗绿豆。 
一个人面向南，一个人面向北，为什么他们还能看到对方的脸？	因为他们是面对面。 
世界上死亡率最高的地方在那里？	床上 
有一次，一个电梯里挤满了人这时候电梯从高空掉了下来可是没有一个人受伤？	这是因为人全死了。 
小民的袜子为什么要破个洞？	不破个洞怎么穿！ 
什么水在太阳的照耀下会越来越多？	汗水 
把3个鸡蛋分别装在2个盘子里,一个盘子只能装一个,请问你该怎么装?	另一个盘子装2个 
有一堆鸡蛋，2只2只的拿，剩一只、3只3只的拿，剩一只、4只4只的拿， 剩一只、5只5只的拿，也剩一只、6只6只的拿，还是剩一只、7只7只的拿 刚好拿完。请问这堆鸡蛋有多少只？	有301只 。 
现代科学家，大部分出生在哪里？	产房 
一个喝醉酒的人，回家时最想的好事是什么？	走时忘记锁门。 
什么东西掉过来,增加一半?	数字6 
一个酒鬼看到一本书上写着酒对身体有害处做出了一个什么决定？	从此不在看书了。 
有一艘船能乘50人，现在已经上了49人，又来了一个孕妇，船就沉了。为 什么？	潜水艇 
小明和小刚是双胞胎，身高和体重都相同，有一天，小明突然比小刚高了 2厘米。为什么？	小明头上被别人打了一个包。 
为什么现代女性都喜欢用沐浴露,而不喜欢用肥皂?	怕越洗越脏 
“哭”和“笑”的最大共同点是什么？	笔划都是十划 
星期六,小明来到电影院,为什么没有看见半个人影!	哪来没有半个人. 
两个长的一模一样的人，可他们不是双胞胎，这是为什么？	三胞胎 
一只蚂蚁从飞机(高空中)上掉下来，为什麽会死？	饿死 
一只黄狗在沙漠里，为什么会被尿憋死？	因为沙漠里没有电线杆 
把大象放到冰箱要分几部？	三部，一打开冰箱门，二把大象放去，三关一冰箱门。 
有十只蜡烛被风吹灭了六只，其它四只继续燃烧，第二天剩下几只？	六只。 
一个人晚上在马路上行走，他从迎面而来的两盏车灯中间穿过，他却 没有事，为什么？	因为两盏车灯是两辆摩托车。 
为什么人们的"杯"字不是木头做.而还用木字旁?	可是"杯"字旁边写了一个"不" 
青春豆长在那里，你比较不担心？	别人的脸上 
偷什么东西不犯法？	偷笑 
什么鬼不可怕，反而可爱？	机灵鬼 
去商店买东西,可是柜台的橱窗里却什么也没有. 为什么?	买柜台 
老师在黑板上写了123，问：能除净吗？	能，黑板擦就能除净 
什么“光”会给人带来痛苦？	耳光！ 
一只狗从来不洗澡，为什么不生虱子？	狗本来就不生虱子，狗生狗崽儿。 
老师要江春学习要开动脑筋,江春却回答了个什么样的怪问题?	开动脑筋的开关在哪儿? 
除了动物园和非洲可以看到长颈鹿外，还有什么地方可以看到？	考场。 
为什么好马不吃回头草？ 什么东西有两个脑袋，六条腿，一根尾巴？	因为后面已经没草可吃了。 
树上有1000只鸟，用什么方法一下就能全部抓住？	照相机 
小明坐在单车上，开车的人说：“他是我儿子。”但小明却说：“他不是我爸爸”为什么？	开车的人是他妈妈嘛！ 
一个人生病,摸头,疼,摸脸,疼.这是什么病?	手指骨折. 
黑人为甚摸吃白色巧克力？	怕咬到手指头。 
牛的舌头和尾巴在什么时候能碰到一起？	在饭店 
华先生有个本领，就 是能让见到他的人，都会自动手心朝上。这是怎么回事？	因为华先生是个中医师	
一个人举起一根手指问另一个人：“贝多芬为什么不用这根手指弹琴？”	“这根手指”不是贝多芬的。 
一个人不会游泳，但是当他跳进了河里却没有被淹死，这是为什么？	河里没水。 
什么蛋可以看不可以吃。	脸蛋 
有个东西它在一个角落里不动,但却可以走遍世界,是什么>	邮票 
树上有十只鸟，打死三只，为何七只不飞走？	不在一棵树上。 
我把一只鸡和一只鹅放在冰箱里，当我再打开冰箱时鸡已经死了但鹅没有死，为什么？	因为那是只企鹅 
一辆汽车与另一辆汽车相撞，为什么不爆炸？	碰碰车 
王小明的哥哥叫王小明弟弟，但王小明却叫他哥哥小弟，这是为什么？	因为他哥哥，叫王小弟。 
小鸟最怕得什么病？	恐高症 
一条蜈蚣过了一个臭水沟后只有两个脚没湿，为什么？	因为水沟太臭，那两只脚捂着鼻子。 
什么人赶在皇上的头上糊做非为?	打一人物:理发师 
小华一次能吃好几头牛，为什么？	他吃蜗牛。 
老王家的房子为什么有时漏雨有时不漏呢?	下雨时漏,不下雨时不漏 
怎样才能使8个"8"相加得1000?	8+8+8+88+888=1000 
什么东西生的可以吃，熟的可以吃，用刀切不开，洗过之后就没人吃？	那是水嘛！ 
什么项目越往后退越能夺得冠军?	拔河. 
在吃什么东西之前不用洗?	冰棍 
小雷平时最怕狗，可是今天小雷看见了狗却很喜欢，为什么？	热狗 
欧美人就餐头一道菜是汤，你知道汤里经常会有什么吗？	盐 
小何去医院看病，为什么既不挂号,也不找医生?	他去看看最近流行什么病 
丛前有一只狗狗前边有一只猫，猫前边有一只老鼠狗后边是什么？	丛吗！ 
什么书里毛病最多？	医书 
什麽螺丝不能钉东西？	当然是俄罗斯啦 
什么人最喜欢下雨？	卖雨伞的人。 
一个小姑娘再打排球，她发了一个球，可无论谁都接不着，为什麽？	球没发过去或发界外了。 
一天，小名考了100分，可他回到家，妈妈还是打他，是为什么？	因为是五门功课加起来的 
小明洗了很久的衣服，为什么自己的衣服还是脏的	他洗的是别人的衣服 
什么地方的东西最贵？	贵州 
老师请一个同学回答问题，同学们都听出他说的是错的，但老是却表扬了他。	老师上面写的是两个字（错的） 
什么字在世界字典里永远都找不到	错别字 
一个人站在三百米的高空下扔鸡蛋。为什么鸡蛋掉了三百米而它却没有破	因为没有加上人的高度 
什么东西越擦越黑？	黑板 
什么是最好的写作方式？	从左往右写。 
有家医院从建院以来，从没有收过一个病人，请问这是为什么？	因为这是一家动物医院！！ 
世界上最大的东西是什么?	眼皮(因为眼皮一闭，就什么也看不见了!) 
不小心吞下一个硬币怎么办?	再向妈妈拿一个!! 
今天阿尾早上掉了19元钱，又捡到8元钱,今天阿尾掉了多少钱?	不是说过了吗,19元钱. 
谁敢站在老虎头上？	虱子。 
一个胖子和一个瘦子跳楼谁先到达地面？	围观的人 
把一个西瓜用四刀切成九块，吃完后共有十块皮，你能做的到吗？	把瓜按“井”字切，便有九块皮，中间一块瓜两边都有皮 
毛毛说：１０＋４＝２，老师也说对，为什么?	10点+4点=下午2点 
世界上哪里的海不产鱼？	辞海 
生米不小心煮成熟饭时该怎么办？	准备开饭 
什么东西愈生气，它便愈大?	脾气 
有一位老太太上了公车，为什么没人让座？	车上有空坐。 
太阳爸爸和太阳妈妈生了个太阳儿子，我们应该说什么祝贺辞恭喜他们？	生「日」快乐！ 
某富翁的左右邻居都养狗，一到晚上，这二条狗就吠叫不停。无法忍受这种折磨的富翁，便出搬家费一百万元，希望左右邻居搬走。的确，两个邻居是连狗一起搬家了，但是一到夜晚，富翁还是可听到完全相同的狗吠声。这是为	两邻居互相交换房屋 
小明对小华说：“我可以坐在一个你永远也坐不到的地方！”他坐在哪里?	小华的身上 
什么情况下5大于O，O大于2，2大于5？	石头，剪刀，布 
要想成功的闯红灯，它的秘决在哪里？	要等S灯和绿灯结束才过马路 
1，2，3所能组成的最大数是多少？	3的21次方 
拿鸡蛋撞石头为何不烂?	石头当然不会烂 
为了怕身材走样，结婚后不生孩子的美女怎么称呼？	绝代佳人 
一场大雨，忙着栽种的农民纷纷躲避，却仍有一人不走，为什么？	稻草人 
有一个女生，她可以不洗澡、不换衣服，但她的衣服是世界最F的，问他是谁？	她是自由女神 
在冰天雪地的北极找不到防身的武器r该怎么办？	撒泡尿制成冰剑。 
妈妈叫大雄赶快起床上学校，因为就快迟到了！但是前天被殴，昨天被打的大雄，说什么也不肯去，只表示已经“没法子了！”这是为什么？	因为大雄是学校的老师 
每个成功男人背后有一个女人，那一个失败的男人背后会有什么？	有太多的女人 
什么交通工具速度越慢越让人恐惧?	正在飞行的飞机 
有一种布很长很宽很好看，就是没有人用它来作衣服也不可能作成衣服，为什么？	瀑布 
我们在平常生活中最常讲什么话？	电话 
一百个男人无法抬起的物体，却有一女子可单手举起，此物体究竟为何物？	鸡蛋 
油漆工的徒弟叫啥?	好色之徒 
当你向别人夸耀你的长处的同时，别人还会知道你的什么？	你不是个哑巴 
中国古贤人曾将兰色外衣，浸泡于黄河中，结果产生何种现象？	沾湿 
废除早自习会造成什么影响？	让学生和家长可以多赖床半小时。 
小明在街上散步时见到一张百元大钞和一块骨头，它却捡了一块骨头，为什么?	它是一只狗 
请你把九匹马平均放到十个马圈里，并让每个马圈里的马的数目都相同，怎么分？	把九匹马放到一个马圈里，然后在这个马圈外再套九个马 
大灰狼拖走了羊妈妈，小羊为什么也不声不响地跟了去？	小羊在羊妈妈的肚子里 
总是在舌头比头脑快时才产生的感觉是什么？	愚蠢 
为什么大家都喜欢坐在电视机前看电视？	因为站久了脚会酸。 
有一位刻字先生，他挂出来的价格表是这样写的：刻“隶书”4角；刻“仿宋体”6角刻“你的名章”8角；刻“你爱人的名章”1.2元。那么他刻字的单价是多少？	每个字两角 
为什么有一个人经常从十米高的地方不带任何安全装置跳下?	跳水运动员 
盲人都是怎么吃桔子的？	瞎掰 
一人被老虎穷追不舍，突然前有条大河, 他不会游泳,也没有交通工具，但他过去了，为 什么?	他昏过去了 
胖姐阿英站上人体秤时，为何指针却只指着5？	指针已转过一圈了。 
为什么今天全球股市指数下跌？	今天是「世界环保日」 
有一只蜗牛从新疆维吾尔自治区爬到海南省为什么只需三分钟?	它在地图上爬 
小明的肚子明明已经胀得受不了了，为什么他还要不停地猛喝水？	他掉进河里了 
小王有五颗糖，吃了两颗后，被大林和他的女友看见，大林说:「好东西要和老朋友分享。」请问小王该怎么做？	向大林说声「谢谢」，然后带走大林的女友。 => 大林说 
徐先生犯了一个大错误。当他在太太面前，掏口袋的一刹那，一些袋内的酒吧火柴盒、未中奖的马票，以及旧情人的照片等，均散落一地。他在慌张之余，为了避免吵架，双手各遮起一件东西 。试问，他所遮起最有效的东	她太太的左眼和右眼 
什么事你明明没有做却要受罚?	做作业 
好心的约翰去世了，天使要带他上天堂，为什么他坚决不肯去？	他有恐高症 
红和绿豆放在一个碟子里,小王为什么一下就把它们分开了?	红豆和绿豆一样只有一颗 
明明是个近视眼，也是个出名的馋小子，在他面前放一堆书，书后放一个苹果，你说他会先看什么？	什么都看不到 
同事们在小张家喝酒、聊天，酒过三巡后，为什么大家都知道小张喝醉了？	因樾≌耪在穿鞋子，准备回家 
有辆载满货物的货车，一人在前面推，一人在后面拉，货车还可能向前进吗？（限时10分钟)	可能，货车在下坡路上 
小郭很爱唱歌，就连用牙刷、牙膏刷牙时，他也与众不同，竟还在放声大唱，结果还可以把牙刷的很干净，你说为什么?	不知道啊，哈哈 
某地发生了大地震，伤亡惨重，收音机里不断传出受灾情况以及寻人启事，一位老大爷一直在注意收听收音机的报道。有人问他：“收音机里播放过你孙子的消息了吗？”他回答说：“没有。”接着他又说：“但我知道我孙子肯	他孙子是那个播音员 
把什么打破了不会受到处分而会得到奖励?	记录 
船边挂着软梯，离海面2米，海水每小时上涨半米，几个小时海水能淹没软梯？	水涨船高，水不会淹没软梯。 
天气愈碛冷，为什么小华不多加件衣服，反而要衣服？	因为他准备要洗澡了。 
前些日子，小高与双亲头一次出国旅行，他们三人来到一个完全陌生的国度。由于语言上的不通，他的父母显得不知所措。而只有小高未感受丝毫不方便，仿佛仍在自己的国家中，这是什么道理呢？	原来小高仅是一名婴儿 
有一名囚犯，被抓到警察局，并被单独关到了一间密封非常好的小囚室里，在没有可能外人进入的情况下，第二天早晨，囚室里居然多出了一名男士！这是为什么?	她是名女囚犯，第二天生了一个小男孩 
小张走路从来脚不沾地，这是为什么？	因为穿着鞋 
王和李都睁一只眼闭一只眼做事,为什么王得表演,李受处分?	因为王是射击运动员,李是仓库保管员 
爱吃零食的小王体重最重时有50公斤，但最轻时只有3公斤，为什么？	那是他刚出生的时候 
东西掉了该怎么办？	]关系，还有四张空白麻。 
芳龄二十四，自认窈窕美丽的丁小姐，逐渐厌烦这种游戏人间的爱情，于是便于夏天下定决心――要和第一个向她求婚的人，踏入地毯的那一端。但是，当我于秋天再度碰到丁小姐时，她虽然表示：“有人要我结婚，已高达四十	因为要她结婚的是他父母 
五月五日是我国人民传统节日：端午节，是伟大诗人屈原投江的日子，那么你知道五月十二日是什么日子吗?	屈原烧头七的日子 
车祸发生不久，第一批警察就赶到了现场，他们发现司机完好无损，翻覆的车子内外血迹斑斑，却没有见到死者和伤者，而这里是荒郊野外，并无人烟，这是怎么回事？	这是一辆献血车 
为什么自由泳比赛中青蛙输给了狗？	青蛙用蛙泳犯规 
什么水永远用不完 ?	泪水 
阿美在事业并没有什么成就，为什么也有女强人的外号？	因为她常常强人所难 
小丁在游泳池游泳，游着游着，为什么水突然变深了？	因为有人刚撒了一泡尿 
住在山谷中的志明，突然想吃泡面，便支起小锅来烧水。水快开了才发现家里的泡面已吃完了，急急忙忙到山脚下的杂货店去买。30分钟后回到家，发现锅里的热水全都不见了。这究竟是为什么？	因为热水都变成冷水了 
3个人3天用3桶水，9个人9天用几桶水?	9桶水 
为什么关羽比张飞死的早？	红颜薄命 
一群女孩在正在河边洗澡，突然一陌生男人闯入，你觉得她们最想遮住哪儿？	男人的眼睛 
一个学生住在学校里，为什么上学还经常迟到？	家所在的学校不是他上学的学校 
~与熊掌要如何才可兼得？	养一只会抓~的熊 
A君与B君的家均位于新兴的住宅地，相距只有一百米。此地除这两家之外，还没有其他邻居，而且也没有安装电话。现在A君想邀请B君“来家里玩”，在不去B君家邀约的情况下，以何种方法能最早通知B君？假设A君身边装着十	他只要大声吼叫就可以了 
如果有机会让你移民,你一定不会去哪个国家?	天国 
为什么老虎打架,非要拼个你死我活绝不罢休？	没有人敢去劝架 
下雨天时，两个人共我话焉。结果两个人都被淋湿；三个人共我话焉∈保为什么]有人再被淋湿？	因为雨停了 
古时候，什么人没当爸爸就先当公公？	太监 
迄今为止，你所见到的最大的影子是什么?	黑夜，它是地球的影子 
一个自讨苦吃的地方在哪里？	药店 
什么东西晚上才生出尾巴呢?	流星 
不小心溺水时，若附近]有其他人该如何自救？	把水喝光 => 但是还是会胀死 
电影院内禁止吸烟，而在剧情达到高潮时，却有一男子开始抽烟，整个银幕笼罩着烟雾。但是，却没有任何一位观众出来抗议，这是为什么？	因为那男子是电影里的主人公 
有一个穿着泳装的女人，她在松软的沙滩上漫步，这一切虽然都很正常，但是，你会发现她的身后竟然没有脚印！这是为什么?	她是倒着走的 
“好马不吃回头草”最合乎逻辑的解释是什么？	后面的草都给吃光了 
大勇说他和学校的老师很熟，在学校里哪里都能进去，但小涵偏说他有一处地方永远也不能进去，是什么地方呢？	换辆大一点的车进教室 
爷爷熟读兵书，可是每次下棋都输给别人，请问他用的是什么兵法？	兵来将挡 
早上睡过头了，结果发现是因为闹钟]响时，你会如何？	叫闹钟该起床罗！ 
纸上写着某一份命令。但是，看懂此文字的人，却绝对不能宣读命令。那么，纸上写的是什么呢？	不要念出此文 
为什么大雁秋天要飞到南方去？	因为走太慢了 
一对健康夫妇，为什么生出只有一只右眼的婴儿？	每个人都只有一只右眼 
8个数字“8”，如何使它等于1000？	8+8+8+88+888。 
人最怕屁股上有什么东西？	一屁股的债 
马路上发生车祸碰撞事件，当警察立刻赶往时虽然司机全力相助，一人却已死亡。依司机的说法，此人并非死于车祸，而是因肺癌丧命。因同坐车的只有司机和死者二人，根本没有目击者；但是，警察却立刻明白，司机并没有说	因为这是辆灵车，死者在车祸前就经死了 
小王过十三岁的生日，为什么桌子上有十四根蜡烛?	那晚停电，有一根是用来照明的 
小明正在吹电扇,为什么还是满头大汗？	他在吹电扇，电扇没吹他 
最不听话的是谁？	聋子 
世界上有那一种花通常夏天是冰冷的，冬天是温热的？	豆花 
妻子：“糟糕，亲爱的，你送给我的钻石戒指，落到红茶里去了……” 结果，戒指又平安回到妻子的手上，而且一点也没有弄湿的痕迹。这难道是奇迹吗？	是掉到红茶罐里去了 
有一位大师武功了得，他在下雨天不带任何防雨物品出门，全身都被淋湿了，可是头发一点没湿，怎么回事?	他是和尚，没有头发 
什么地方看到的月亮最大？	在月球上 
有一个小圆孔的直径只有1厘米，而有一种体积达100立方米的物体却能顺利通过这个不孔，那么它是什么物体呢？	水 
老李刚理完发，便要求理发师将他的头发“中分”，理发师却说做不到，为什么？	理发师给老李理了光头 
高考发榜了，为什么志明榜上无名却一点也不难过？	因为志明还在念小学。 
市里新开张了一家医院，设备先进，服务周到。但令人奇怪的是：这儿竟一位病人都不收，这是为啥?	兽医院 
新买的袜子怎么会有一个洞？	袜口 
兰兰经过某市时，正巧那里发生了大地震，为什么兰兰却安然无恙呢？	她坐飞机路过 
乌龟有]有牙齿？	你]张开嘴巴我怎么知道？ 
幼儿园放学了，但却没有一个小朋友从大门出去，是怎么回事呢？	大门检修，请走侧门 
什么东西明明是你的，别人却用的比你多得多？	你的名字 
地上的积水因太阳照射蒸发，会愈碛少	身上的汗水 
在狩猎公园的池子中，鳄鱼正咬住管理员的帽子游走；只见池子外的所有管理员都一起叫骂着。但是，并没有人的帽子不见了！为什么？	因为那个管理员被鳄鱼吃了 
什么书谁也没见过？	天书 
什么地方恶人们不再干扰得你心烦意乱，而只好与你生活在一起？	天堂 
什么事是林先生和林太太每天睡觉时都要做的事？	闭上眼睛 
什么人是不用电的?	缅甸人 
有一只公狗在沙漠中突然死掉了，请问为什么?	找不到电线杆和大树 
有一种棋只有两种棋子，你知道是什么棋类吗？	围棋，只有黑棋和白棋 
有对一模一样的双胞胎兄弟，哥哥的屁股有黑痣，而弟弟没有。但即使这对双胞胎穿着相同的服饰，仍然有人可立刻知道谁是哥哥，谁是弟弟。究竟是谁呢？	他们自己 
有一群小鸡在菜地里乱窜 ，小鸡是谁的？	鸡妈妈 
王太太委托征信社二十四小时日夜跟踪、监视王先生，以防他出轨， 但是为什么最后王先生还是出轨了？	因为王先生搭乘地铁出轨了 
什么情况一山可容二虎？	一公一母 
下雨天不怕雨淋的是什么?	雨伞和雨衣 
什么东西将一间屋子装满，人又能活动自如？	空气和光 
进浴室洗澡时，要先脱衣服还是裤子？	先关门比较好 
身子里面空空洞洞而却拥有一双手的是什么N?	手套 
阿珠结婚后，为什么宁愿睡地板也不肯跟丈夫睡水床?	她有晕船的毛病 
大家都不想得到的是什么？	得病 
把24个人按5人排列，排城6行，该怎样排？	排成正六边形即可 
世界上什么东西以近2000公里/小时的速度载着人奔驰,而不必加油或其它燃料?	地球 
用1、2、3这3个数码表示的最大数字是多少？	“3”的“21”次方 
什么话可以世界通用?	电话 
为什么自由女神像老站在纽约港?	她不能坐 
一天慢24小时的表是什么表？	停着不走的表 
为什么阿郎穿着全新没破洞的雨衣,却依然弄的全身湿透？	因为他在炎热的太阳底下穿着雨衣 
一头公牛加一头母牛，猜三个字?	两头牛 
放一支铅笔在地上,要使任何人都无法跨过,怎么做?	放在墙边 
用什么擦地最干净？	用力 
熊掌和鱼什么时候才能兼得?	在饭店里 
为什么现代人越来越言而无信?	因为打电话比写信方便 
什么样的桶子永远b不满？	R桶 
有一种地方专门教坏人，但没有一个警察敢对它采取行动加以扫荡。这是什么地方？	看守所 
你在学校学到的知识越多，什么就会少？	不知道的东西 
小赵买一张奖票,中了一等奖,去领奖却不给?	没到领奖的日期 
在船上见得最多的是什么？	水 
用什么方法立刻可以找到遗失的图钉？	光着脚走 
什么样的强者千万别当？	强盗 
什么布是用剪子剪不断的？	瀑布 
一只毛毛虫,过一条没桥的河,它怎么过去?	变成蝴蝶飞过去的 
什么数字让女士又爱又恨？	三八 
一只鸡，一只鹅，放冰箱里，鸡冻死了，鹅却活着，为什么？	企鹅 
有一块天然的黑色的大理石，在九月七号这一天，把它扔到钱塘江里会有什么现象发生？	沉到江里 
刚起飞的飞机突然冒烟掉在地上，为什么没人受伤?	所有人都死了 
林老生大手术后换了一个人工心脏。病好了后,她的女友却马上提出分手,为什么会这样?	没有真心爱她 
世界上除了火车啥车最长？	塞车 
哪一种竹子不长在土里？	爆竹 
什么样的水不能喝？	薪水 
老师说蚯蚓切成两段仍能再生，小东照老师话去做，蚯蚓却死了，为什么?	小东是竖着将蚯蚓切开的 
满满一瓶牛奶，怎么才能先喝到瓶底的部分？	用吸管 
网要什么时候可以提水?	当水结成冰的时候 
相同内容的书，为什么小高要同时买两本？	送人 
打狗要看主人,那打老虎要看什么？	看你有没有“种” 
有一座独木桥承重80公斤,请问一个体重70公斤并带着两个重量均为10公斤的铁球的人如何在桥上通过?	颠着球 
有两个人决定进行自行车比赛，看谁的自行车跑的快，比赛在一个平坦宽敞的体育场里进行，但当比赛开始时，他们两个却谁也不愿意领先，反而都在慢悠悠的骑，已知他们两人都不会互相谦让，也没有外来因素干扰，总之，一	他们交换了自行车 
一个长宽各一米，深两米的土坑，坑里没有水，为什么有人不慎跌落下去淹死了?	因为那是粪坑 
什么时候子女相逢能并肩？	好 
小王用捕鼠笼在家抓老鼠,第二天一早发现笼子里抓了一只活老鼠,而笼子外面却有二只死老鼠四脚朝天的死老鼠,为什么？	那二只看见同伴竟然笨得上当被捕活活笑死的。 
烟缸，打一字。	盔 
小华说他能在1秒钟之内把房间和房间里的玩具都变没了，这可能吗?	把眼睛闭上 
开什么车最省油?	开夜车 
以下石头城、太阳城、凤凰城、瓜果城、汽车城、英雄城、足球城分别都是哪几个城市吗？	江苏省南京市；西藏拉萨市；广西南宁市；甘肃省兰州市 
一字六笔无竖横，同心同德力无穷,打一字。	众 
你能否用3跟筷子搭起一个比3大比4小的数？	搭成圆周率“∏” 
中国人最早的姓氏是什么?	是善，没听说人之初，姓本善吗 
一个招牌突然由高处掉落,砸向并排行走的五个人,为什么只有三个人受伤?	因为是麦当劳（M）的招牌 
去教堂向神父忏悔之前，都事先做了些什么事?	犯罪 
伴奏。打一成语	肋人为乐 
地球上什么东西每天要走的距离最远?	地球（自转一周） 
被鳄鱼咬和被鲨鱼咬后的感觉有什么不同?	没有人知道 
环球旅行。猜一现代香港名星名	周星驰 
小戴手里拿着火柴走到厨房，这有一个煤气灶和一个酒精灯，他如果想烧开水，请问：他应该先点燃什么？	火柴 
什么时候最好还是要高高举起你的双手好些?	有人用枪指着你的时候 
不相信恋人。猜一公安用语	怀疑对象 
爸爸问小明，什么东西浑身都是漂亮的羽毛，每天早晨叫你起床？小明猜对了，但却不是鸡，那是什么？	是鸡毛掸子 
离婚的主要起因是什么？	结婚 
请仔细想一想，你所见到的最大影子是什么？	地球的影子，即每天的晚上 
三个孩子吃三个饼要用3分钟，九十个孩子九十个饼要用多少时间?	三分钟，大家一起吃 
阿勇做事总是拖泥带水，但上级部门总是表彰他，这是为什么？	他是泥瓦匠 
木兰之子，猜食名物一	花生 
什么东西经常会来，但却从没真正来过？	明天 
什么事可以在这里不仅可以练就一身钢筋铁骨，而且能成就一双不惧“风雨”的眼睛？	洗澡 
三更半夜回家才发现忘记带钥匙,家里又没有其他人在,这时你最大的愿望是什么?	门忘锁了 
如果你有一只下金蛋的母鸡，你该怎么办？	打自己一嘴巴，不要做梦了！ 
小明家住在五楼，可是电梯坏了，他自己也没有走楼梯，他却上了五楼回到家里，这可能吗?	他妈妈背他上楼 
一字四十八个头，内中有水不外流。猜一字。	井。此迷的关键理解出四个十和八个头，而不是四十八个 
有一个人被从几千米的高空掉下来的东西砸在头上，却没有受伤，为什么？	砸下来的是雪花 
要想使梦成为现实，我们干的第一件事会是什么?	醒来 
人在什么情况下会变得目中无人?	眼睛瞎了的时候 
有两个人，一个面朝南，一个面朝北的站立着，不准回头，不准走动，不准照镜子，问他们能否看到对方的脸？	当然能，他们是面对面站着的 
我不会轻功，反一只脚搭在鸡蛋上，鸡蛋却不会破，这是为什么？	另一只脚站在地上 
有半瓶酒，瓶口用软木塞塞住，在不敲碎瓶子，不准拔去木塞，不准在塞子上钻孔的情况下，怎样喝到瓶子里的酒？	把塞子推到瓶子里去 
一种饮料，由恶意和谎言加上微量事实配制而成的，能有效地削弱领导的洞察力，是什么？	小报告 
什么人每天靠运气赚钱？	煤气工人 
什么时候四减三会等于五？	四个角的东西切去一个角 
小张说的相声大家都喜欢听，为什么他有的时候说话却要付钱?	打公用电话肯定要付钱 
什么东西有五个头，但人不觉的它怪呢?	手和脚 
如果明天就是世界末日，为什么今天就有人想自杀？	去天堂占位子	
什么是在废除死刑制度之后的民主、法治国度里，授予医生的一种宣判死刑的特权？	癌症
在一个寒冷冬日清晨，有一位西装革履的先生在河里拼命游水，你说这是为什么?	他不小心掉进河里了 
黑人和白人生下的婴儿，牙齿是什么颜色的?	婴儿没有牙齿 
什么枪把人打跑却不伤人？	水枪 
大部分人出生在什么地方？	产床上 
一架飞机坐满了人，从万米高空落下坠毁，为什么却一个伤者也没有？	因为为都摔死了 
猪的全身都是宝，用处很大，猪对人类还有什么用处?	骂人 
人们能以坦然、自得的心情面对贷币大幅度贬值的地方是什么地方？	精品屋 
如果有人向你问路,你最怕听到哪一句话?	这里是地球吗？ 
高骑自行车骑了十公里，但周围的景物始终没有变化。为什么?	因为他骑的健身车 
每对夫妻在生活中都有一个绝对的共同点，那是什么？	同年同月同日结婚 
一个被指控的人，在其清白无辜被证明之前，他是有罪的。他是什么人？	被告 
家有家规，国有国规，那动物园里有啥规?	乌龟 
9个橙分给13个小朋友,怎么分才公平?	榨成汁 
一个老老人头顶上只剩三根头发，有一天他要参加重要盛会，为什么他仍忍痛拔掉其中一根头发呢？	因为他要梳中分 
夜夜看落花　（打一礼貌用语）	多谢 
有人说，女人象一本书，那么胖女人象什么书？	合订本 
书店买不到的书是什么书？	秘书 
六岁的小明总是喜欢把家里的闹钟整坏，妈妈为什么总是让不会修理钟表的爸爸代为修理?	爸爸是修理小明 
没有铁栏杆的牢笼。在这种牢里，患者面临现代医学所知的各种传染性病毒的威胁，并经常忍受种种科学的折磨。这是哪里？	医院 
什么东西在用之前是干的，用完了以后是湿的，而且在使用的过程中还给人以沁人心脾的满足感？	茶袋 
阿里巴巴和四十大盗的故事是东方夜谭还是西方夜谭?	天方夜谭 
冶金学------打一本书（小说）名	《钢铁是怎样炼成的》。 
王先生养了一只很漂亮的孔雀,有一天,王先生的孔雀在先生的花园里生了一只蛋,请问这只蛋应属于谁的?	孔雀的 
当地球爆炸时，什么地方最安全?	地狱 
农夫养了10头牛，为什么只有19只角？	因为一只是犀牛 
上无片瓦遮身，下无立锥之地。腰间挂个葫芦，只知阴阳之理。猜一字。	卜 
有一次，老李买了一只狗，买了一篮子骨头，他休息时，用一根5米的绳子将狗拴在路边树上，将骨头放在离狗8米的地方，但过了一会儿，他发现骨头被狗叼走了，你知道为什么吗？	狗在树的另一端，骨头在这一端时，他们相距8米 
换心手术失败，医生问快要断气的病人有什么遗言要交代，你猜他会说什么？	其实你不懂我的心 
有一只羊，一年吃了草地上一半的草，问它把草全部吃光，需要多少年？	永远吃不完，因为草每年都在长！ 
妇女们在不知不觉中丢失掉的东西是什么？	美貌 
哪个连的人员比一般连队的人员要多得多？	大连 
狐狸精最擅长迷惑男人,那么什么"精"男女一起迷?	酒精 
盒子里有四块蛋糕，四个小朋友，每人都分到一块，但盒子里还留下一快蛋糕，为什么？	其中一个小朋友连盒子一起拿走，所以盒子里还有一个蛋 
杰克应该把游艇开到红海去，却到了黑海，为什么？	他是色盲 
为什么一只青蛙在水里游不过一只狗？	因为比赛中禁止用蛙泳 
阿呆从热气球上掉下来，却没有受伤，为什么？	因为热球就在地面上 
什么地方开口说话要付钱?	打电话 
小明每天写信给他的女朋友，每天寄七封，但他的女朋友珍妮，每天却只收到一封信，为什么？	因为他有七个女朋友 
给你一本杂志和一个火柴盒，你能使杂志只有三分之一放在桌边而不掉落下来吗?	把杂志掀开三分之一放在桌边，自然就不会掉下来了 
只能一个人去做的事是什么？	做梦 
南来北往的二个人，一个挑担，一个背包，他们没争也没吵，也没有人让路，却顺利的通过了独木桥，为什么	南来北往是一个方向，当然可以顺利的度过独木桥 
黑头发有什么好处？	不怕晒黑 
什么东西越洗越脏？	水 
有风不动无风动，不动无风动有风(猜一物)	扇子 
往一个篮子里放鸡蛋，假定篮子里的鸡蛋数目每分钟增加1倍，这样，12分钟后，篮子满了。那么，请问在什么时候是半篮子鸡蛋?	11分钟 
侍儿扶起娇无力（打一食品名）	玉环稣 
警方发现一出智慧型的谋杀案,F场]有留下任何线索,也]有目击者,但警方在一小时后宣布破案,为什么	凶手自首了 
什么酒价格最贵?	喜酒 
有两面与你一样高的大镜子平行竖放，如果你脱光了站在中间就会有很多人像排成一列反映出来，那么，将前后左右上下不留一点缝隙的用镜子封成一个立体房间，并且，镜面都朝内，当一个裸体的人进到里面，会看到什么？	因为不留一点缝隙，光线透不进来，所以里面乌七嘛黑什 
江河流水归一处（打一字）	“珂”，因为“江河”两字去“水”后成“工可”，再加 
阿研的口袋里共有10个硬币，漏掉了10个硬币，口袋里还有什么？	一个破洞 
阿明给蚊子咬了一大一小的包，请问较大的包，是公蚊子咬的，还是母蚊子咬的？	公蚊不咬人 
当今社会，个体户大都靠什么吃饭?	嘴巴 
一个人在什么情况下，才处于真正的任人宰割的地步？	手术台上 
一个人被关在密闭的房间里，只有一扇门，但无法拉开，他该如何出来？	把门推开 
什么时候太阳会从西边出来？	发誓的时候 
什么时候，四减一等于五？	四边形，减去一个角，变成五边形 
四个9加起来为什么等于100？	9/9+99 
小王坐着对小李说：“我坐的这个地方，你永远也不可能坐的到。”你知道小王坐在哪里吗？	小王坐在小李肩上 
为什么一瓶标明剧毒的药对人却无害?	只要你不去喝它 
文文在洗衣服，但洗了半天，她的衣服还是脏的，为什么？	她在洗别人的衣服 
一个不会游泳的人掉进了水里却没有淹死，为什么?	他穿了救生衣 
亚当和夏娃结婚后最大的遗憾是什么?	没人来喝喜酒. 
数字0到1之间加一个什么号，才能使这个数比0大，而比1小呢？	加个“.”成为 0.1 
有一种细菌，经过1分钟，分裂成2个，再过1分钟，又发生分裂，变成4个。这样，把一个细菌放在瓶子里到充满为止，用了1个小时。如果一开始时，将2个这种细菌放入瓶子里，那么，到充满瓶子需要多长时间?	59分钟 
刘邦破咸阳―城市名一	秦皇岛 
有一样东西，你只能用左手拿它,右手却拿不到,这是什么东西?	右手 
有两对母女，到餐厅吃午餐，每人各叫一个70元的套餐，付账时却只付210元，为什么？	她们是祖孙三代 
什么样的轮子只转不走？	风车轮 
法国人的笑声跟我们有什么不同？	他们是用法语笑的 
三国谜:猛翼德千杯不醉(乐人一)	张洪量 
跳伞时，怎样才能分的出老兵和新兵?	新兵的屁股上有鞋印。 
什么鞋子，你绝不会穿着它去逛街?	溜冰鞋 
一只凶猛的饿猫，看到老鼠，为何却拨腿就跑？	去追老鼠 
“水蛇”“蟒蛇”“青竹蛇”哪一个比较长？	青竹蛇 
重男轻女打一地名	贵阳 
共公汽车上，两个人正在热烈的交谈，可围观的人却一句话也听不到，这是因为什么？	这是一对聋哑人 
那一种飞弹可以用每小时３０公里的超低速，并贴近地表二公尺左右的高度直扑目标而去，中途还可以９０度急转弯?	戴在车上的飞弹。 
电单车时速80公里，向北行驶。有时速20公里的东风，请问电单车的烟，朝那个方向吹？	电车是没有烟的 
别人跟阿丹说她的衣服怎么没衣扣，她却不在乎，为什么？	因为她的衣服只有拉链，没有扣子 
超人使用超高性能望远镜观察地球时，发现外星人正且欲毁灭地球。超人只要使用瞬间移动装置，便可于一秒内到达地球，请问超人究竟能否拯救地球?	那要看外星人毁灭地球的速度了， 如果外星人从几万光年 
男人在一起喝酒，为什么非划拳不可？	敬酒不吃吃罚酒 
为什么警察对闯红灯的汽车司机视而不见？	汽车司机在步行。 
小王13岁的生日为何点了14根蜡烛?	用一根点着那十三根 
用椰子和西瓜打头哪一个比较疼？	头比较疼 
F在有二枚市面常用的硬币，面值共为六毛，其中有一枚不是一毛，请问二枚硬币面值各为多少	一枚不是一毛，那另一枚是一毛，因此是一毛和五毛 
“Kiss”是动词,形容词还是名词?	连词 
楚楚的生日在三月三十日，请问是哪年的三月三十日？	每年的三月三十日 
甲、乙两只狼狗举行1000米赛跑，假如两只狼狗同时跑到终点，那么哪只狼狗出汗多？	狼狗不出汗 
为什么人们要到市场上去？	因为市场不会来 
嫦娥为什么喜欢住在月球上？	嫦蛾爱吃兔肉 
在香港生活的人，是不是可以埋葬在广州呢	不可以，活人是不能埋葬的 
梁山伯和祝英台变成了一对比翼双飞的蝴蝶之后怎样了？	生了一堆毛毛虫 
一个人从五十米高的大厦上跳楼自杀,重重的摔在了地上,为什么没被摔死?	他在半空就已经吓死了 
有个汽车司机，在交叉路口上突然撞进人群中，全速向前跑，警察也不责怪他。你说这是为什么？	汽车司机今天没开车 
下雪天，阿文开了暖气，关上门窗，为什么还感到很冷？	他在门外 
一个人被老虎穷追不舍，突然前面有一条大河, 他不会游泳,但他却过去了，为什么？	昏过去了 
从前有只鸡，鸡的左面有只猫，右面有条狗，前面有只兔子，鸡的后面是什么？	注意第一句话，从的前面有只鸡，那么鸡的后面当然是“ 
阿呆开车去动物园玩，动物园很近，他的路并没有走错，为何却总到不了目的地？	早开过了 
IX---这个罗马数字代表9，如何加上一笔，使其变成偶数？	加S，因为SIX是六的意思' 
既没有生孩子、养孩子也没有认干娘，还没有认领养子养女就先当上了娘，请问：这是什么人？	新娘 
在什么时候1+2不等于3？	算错了的时候 
孔子与孟子有何不同？	“子”的位置不同。孔子的“子”在左边，孟子的“子” 
在地上有100元钱和一块肉骨头，可是阿明却拣起了肉骨头而没有捡钱，为什么？	这里的“阿明”是条狗的名字 
蝎子和螃蟹玩猜拳，为什么它们玩了两天，还是分不出胜负呢？	两个都出剪刀 
铁锤锤鸡蛋为什么锤不破？	锤怎么会破 
有一本书，兄弟俩都想买。如果用哥哥的钱单买要缺5元钱，如果用弟弟的钱买缺1角钱，如果两人把钱和起来只买一本书，钱仍然不够。那么这本书的价钱是多少呢？	这本书的价钱是5元钱；哥哥没有钱，弟弟有4元9角 
进动物园后，最先看到的是哪种动物？	人 
一对侨居意大利的中国夫妇，某天太太到市场买鸡胸，因为她不懂意语，只好学鸡叫，再指指自己的胸部，想买鸡角便指自己的脚，老板看懂了；后来她想买香肠，却回家叫丈夫来，为什么？	因为他丈夫懂意大利语 
一群惧内的大丈夫们正聚集在一起商量怎样重振男子汉的雄风，突然听说他们的老婆来了，大家四处逃窜，惟独一人没有跑，为什么？	吓死了 
马亚买了新音响，电源开了录音带也放了，为什么没有声音呢？	停电了 
小张开车，不小心撞上电线杆发生车祸，警察到达时车上有个死人，小张说这与他无关，警察也相信了，为什么？	小张是开灵车的 
报纸上登的消息不一定百分之百是真的，但什么消息绝对假不了？	报纸上的年、月、日 
李哲看起来平平常常，并无什么特别之处，但他却可以连续数小时不眨眼睛，他是怎么做到的呢？	把眼睛闭上就可以做到了 
两对父子去买帽子，为什么只买了三顶？	是祖孙三人 
十只鸟，小明开枪打死了一只，其它九只却都没有飞走，为什么?	那是一群驼鸟 
袋鼠和猴子参加跳高比赛，为什么猴子一开始就赢了？	袋鼠双脚起跳犯规 
什么贵重的东西最容易不翼而飞?	人造卫星 
有一个人，他是你父母生的，但他却不是你的兄弟姐妹，他是谁？	你自己！！ 
农民、工人、军人、科学家都靠什么吃饭？	靠嘴吃饭 
问医生病人的情况,医生只举起5个手指家人就哭了,是什么原因呢?	三长两短 
一位服装模特儿小姐，即使在平日也穿着未经发表的新款服饰，但她常常看到穿着和她完全相同服饰的人。这是为什么？	因为她看到镜子中的自己 
有一种水果，没吃之前是绿色的，吃下去是红色的，吐出时却是黑色的，是请问这是什么水果?	西瓜 
有一死刑犯，在执刑时挨了两枪还未死，等挨了第三枪才死，为什么？	他里面穿着三枪牌内衣 
什么水要按计划发放?	薪水 
拥有很多牙齿,能咬住人的头发的东西是什么N?	发夹 
太平洋的正中间是什么？	“平” 
小红与妈妈都在同一个班里上课，这是为什么？	妈妈 是小红的班主任 
哪儿的海不产鱼?	辞海 
什么时候时钟会响13下？	坏的时候 
一架飞机在天空飞翔时突然没油了，请问：什么东西会最先掉下来？	油表的指针。 
在罗马数字中，零该怎么写？	罗马数字没有零 
为什么白鹭莺总是缩者一只脚睡觉？	缩两只脚就会跌 
警察面对两名歹徒，但他只剩下一颗子弹，他对歹徒说：谁动就打谁，结果没动的反而挨子弹，为什么？	因为不动较好打 
小张被关在一间并没有上锁的房间里，可是他使出吃奶的力气也不能把门拉开，这是怎么回事？	推开门就行 
提早放工回家的小李，一进卧室，看隔壁的小刘与自己老婆睡在床上，但小李却毫不动怒，为什么？	因为小刘是女的 
胖胖是个颇有名气的跳水运动员，可是有一天，他站在跳台上，却不敢往下跳。这是为什么？	因为水池里没有水 
刮风的晚上，停电了，晓晓上床睡觉时忘了吹蜡烛，第二天醒来时，蜡烛居然还有很长一支没有燃完，怎么回事呢？	被风吹熄了 
中国哪个地方的东西最不便宜？	贵州 
说从天津坐火车到北京1个小时15分钟,问火车从天津出发1个小时45分钟后在哪?	在铁轨上 
什么东西越热越爱出来？	汗。 
王子吻了睡美人之后，睡美人为何]有起恚	她在赖床 
失恋的黄先生在一个月黑风高的晚上,走上街头,迎面过来飞车,他站在两个车灯中间,车子呼啸而过,人竟毫发无损,为什么?	迎面而来的是两辆摩托车，而不是汽车 
一对健康的夫妇,为什么会生出没有眼睛的婴儿?	鸡生蛋 
什么越洗越脏，不洗有人吃，洗了没人吃？	水 
台湾最大的湖是什么湖？	澎湖 
沙沙声称自己是辨别母鸡年龄的专家，其绝招是用牙齿，为什么？	把鸡吃了亲口辨认母鸡的老嫩 
有一座大大厦发生火灾，陈先生逃到楼后，想跳过距离只有1米的隔壁楼顶，结果却摔死了，为什么？	因为高度相差太远 
小明只会花钱，天天花很多钱,可最后却成了百万富翁,为什么?	以前是亿万富翁 
什么时候有人敲门，你绝不会说请进?	在厕所里的时候 
什么东西往上升永远掉不下来？	年龄。 
服b仪容检查时，明明有理头发，为什么教官不信？	秀才遇到兵，「有理」f不清 
有个男人站在时速240公里的列车顶上，虽然他不是一个会飞墙走壁的超人，但是，他仍然显得从容自如，毫不紧张，为什么？	因为当时火车还没开动 
小明拿了一百元去买一个七十五元的东西，但老板却只找了五元给他，为什么？	因为他只给了八十元给老板 
由于什么原因死亡的人最多？	抢救无效。 
乌龟为什么会突然「一个头两个大」？	因为乌龟正在想这个问题 
今天下午到旺角看电影，到了旺角，半个人也看不，为什么？	人很多，但没有半个人 
两只狗赛跑，甲狗跑得快，乙狗跑得慢，跑到终点时，哪只狗出汗多?	狗不会出汗 
有一个眼睛瞎了的人，走到山崖边上，突然停住了，然后往回走。	单眼瞎。 
考试时，小光全部都抄小明的，为什么小明得到一百分，小光却零分呢？	因为小光连名字都抄小明的 
什么照片看不出照的是谁？	X光片 
小胖为什么吃两个便当？	因为三个便当吃不下 
时钟敲了十三下,请问现在该做什么呢	修理钟表 
地球末日来临。地球上最后一位男人正坐在书桌前写遗书，突然听到敲门声，是幽灵，外星人，动物吗？全都不是。更不是因风或石子等无生命的东西发出的声音，那么是谁发出的敲门声呢？	女人 
有种动物，大小像只猫，长相又像虎，这是什么动物?	小老虎 
大海上有一艘很大的舰艇，它本来的定员是60人，结果，在上到第59人的时候，它居然就沉进海里了！这是为什么？（船内没有怀孕以及体重过重的人存在；也没有重物上船）	这是一艘潜水艇 
一本书放在地上什么地方你跨不过去？	放在一墙角里 
养过电子鸡和电子狗的人，会有什么感受？	鸡犬不宁 
有一个年轻人，他要过一条河去办事；但是，这条河没有船也没有桥。于是他便在上午游泳过河，只一个小时的时间他便游到了对岸，当天下午，河水的宽度以及流速都没有变，更重要的是他的游泳速度也没有变，可是他竟用了	两个半小时就是一小时啊 
如果诸葛亮活着，世界现在会有什么不同？	会多一个人。 
牛顿因掉落苹果发现引力；如你在椰树下等被椰子打中会发现什么？	会发现这种行为很愚蠢 
如何才能把你的左手完全放在你穿在身上的右裤袋里,而同时把你的右手完全放在你穿在身上的左裤袋里？	反穿裤子 
先有男人，还是先有女人?	因为男人是先生的，所以叫“先生” 
一天夜里狂起了狂风，这时一个桌子上总共有12支点燃的蜡烛，先被风吹灭了3根，不久又一阵风吹灭了2根，最后桌子上还剩几根蜡烛？	5根，其它的烧完了 
猴子每分钟能掰一个玉米，在果园里，一只猴子５分钟能掰几个玉米?	没掰到一个 
三个人，竖着站成一排。有五个帽子，三个蓝色，两个红色，每人带一个，各自不准看自己的颜色。然后问第一个人带的什么颜色的帽子，他说不知道，然后又问第二个人带的什么颜色的帽子，同样说不知道，又问第三个人带的	是蓝色。 
槭裁茨腥撕团人会分手？	因为男女有「e」 
世界上什么样的海最大？	苦海，苦海无崖 
有个人不是官，却负责全公司职工干部上上下下的工作。这个人是干什么的?	开电梯的 
为什么流氓坐车不要钱？	囚车。 
考试时，阿财一}都不会写，但是为什么突然眼睛一亮，开始振笔疾书？	他在写班级、座号、姓名。 
王大婶整天说个不停，可有一个月她说的最少，那时哪个月？	二月份 
一个并非神枪手的人手持猎枪，另一个人将一顶帽子挂起来，然后将持枪人的眼睛蒙上，让他向后走10步，再向左转走10步，最后让他转身对帽子射击，结果他一枪打中了帽子，这怎么一回事？	另一个人把帽子挂在他枪口上 
三个金“鑫”，三个水叫“淼”，三个人叫“众”，那么三个鬼应该叫什么?	叫“救命” 
小胖在大扫除时偷吃t豆冰棒被老师看见，老师生气的问：「太闲了是不是!?」，结果小胖说了什么，害老师差点当场昏倒？	小胖f：「老师，t豆冰棒是甜的。」 
芳芳在学校门口将学生证掉了，它该怎么办？	她该捡起来 
有两个棋友他们在同一天中一共下了9盘棋，结果在没有和局的情况下他俩赢的次数相同，这是怎么一回事？	这九盘棋不都是他们俩之间下的 
上海的南京路，来往最多的是什么人?	中国人 
大人上班迟到的原因是塞车，小孩上学迟到的原因是什么？	大人睡过头了 
人在什么情况下会七窍生烟？	火葬的时候 
老师用篮子拿来了五个苹果，准备分给五个小朋友，每个小朋友分一个，但是篮子里还要留一个，请问怎么分？	五个人分一个，分四次 
小李因工作需要常应酬交际，虽然每天都很早回家，可是老婆还是抱怨不断。为什么？	他是早上才回家 
S皮肤的人是S种人，绿皮肤的人属于哪一种？	新品种 
有爷俩，娘俩和兄妹俩，只有6个烧饼，但却每人分得了两个，这是为什么？	他们只有三个人：母亲，儿子，舅舅 
一个猎人，一只枪，抢射程１００米，有一个狼离猎人２００米，猎人和狼都不动，可是猎人却开枪把狼打死了？	枪长一百米。 
卖火柴的小女孩如果投胎转世淼较执，最有可能变成什么？	兼售打火机的槟榔西施 
为什么全世界的母鸡都是短腿？	这样鸡蛋就不会摔破 
什么地方的水太阳愈烈照射，水反而愈碛多？	雪地 
小明从来没去过美国，他想去美国，至少应花多少钱？	光想是不用花钱的。 
什么东西说“父亲”是不会相碰，叫“爸爸”时却会碰到两次？	上下嘴唇 
有两个人同时来到了河边，都想过河，但却只有一条小船，而且小船只能载1个人，请问，他们能否都过河？	能，因为他们分别在河的两边。
动物园里只比大象鼻子短的动物是什么？	小象