急性乙型黄疸性肝炎中药方剂	内科	传染病
急性黄疸性病毒肝炎中药方剂	内科	传染病
迁延性肝炎中药方剂	内科	传染病
慢性乙型肝炎中药方剂	内科	传染病
慢性活动性肝炎中药方剂	内科	传染病
慢性迁延性乙型肝炎中药方剂	内科	传染病
急性传染性黄疸性肝炎中药方剂	内科	传染病
急性病毒性肝炎中药方剂	内科	传染病
慢性病毒性肝炎中药方剂	内科	传染病
慢性肝炎中药方剂	内科	传染病
慢性萎缩性胃炎中药方剂	内科	消化类
腹泻的秘方	内科	消化类
治胃溃疡偏方4	内科	消化类
胃炎中药方剂	内科	消化类
治胃溃疡偏方2	内科	消化类
慢性胃炎中药方剂	内科	消化类
菠萝叶治肠炎腹泻	内科	消化类
胆囊炎、胆石症秘方	内科	消化类
胃溃疡中药方剂	内科	消化类
治胃溃疡偏方	内科	消化类
胃溃疡偏方3	内科	消化类
胃下垂的偏方	内科	消化类
胃下垂的偏方2	内科	消化类
溃疡性结肠炎中药方剂	内科	消化类
非特异性溃疡性结肠炎中药方剂	内科	消化类
消化性溃疡的偏方	内科	消化类
消化不良的偏方2	内科	消化类
消化不良1的偏方	内科	消化类
慢性结肠炎中药方剂	内科	消化类
治疗便秘的偏方14	内科	泌尿类
治疗便秘的偏方13	内科	泌尿类
治疗便秘的偏方10	内科	泌尿类
胆结石中药方剂	内科	消化类
粘连性肠梗阻中药方剂	内科	消化类
萎缩性胃炎中药方剂	内科	消化类
治疗便秘的偏方11	内科	泌尿类
治疗便秘的偏方15	内科	泌尿类
治疗便秘的偏方2	内科	泌尿类
治疗便秘的偏方16	内科	泌尿类
治疗便秘的偏方17	内科	泌尿类
治疗便秘的偏方18	内科	泌尿类
治疗便秘的偏方21	内科	泌尿类
治疗便秘的偏方19	内科	泌尿类
治疗便秘的偏方9	内科	泌尿类
治疗便秘的偏方20	内科	泌尿类
治疗便秘的偏方7	内科	泌尿类
治疗便秘的偏方23	内科	泌尿类
丝瓜花治疗便血	内科	泌尿类
治疗便秘的偏方22	内科	泌尿类
肝硬化腹水中药方剂	内科	消化类
十二指肠球部溃疡中药方剂	内科	消化类
干艾叶治排便不畅	内科	泌尿类
直肠溃疡中药方剂	内科	消化类
胃结石中药方剂	内科	消化类
十二指肠溃疡中药方剂	内科	消化类
脾脏肿大中药方剂	内科	消化类
蜂蜜治便秘	内科	泌尿类
便秘的临床表现及疗法	内科	泌尿类
便秘常用的有效的偏方	内科	泌尿类
枣树皮煎水治腹泻	内科	消化类
便秘治疗的新疗法	内科	泌尿类
老年结肠功能紊乱中药方剂	内科	消化类
民间治老年便秘方	内科	泌尿类
治妊娠便秘方	妇科	妊娠病
合理饮食治便秘	内科	泌尿类
润肠通便单味中药	内科	泌尿类
中药对便秘的治疗	内科	泌尿类
应用甘露醇治疗便秘	内科	泌尿类
哪些维他命可以治疗便秘	内科	泌尿类
肠粘连中药方剂	内科	消化类
便秘良方	内科	泌尿类
慢性便秘药膳方	内科	泌尿类
治习惯性便秘民间方	内科	泌尿类
洋葱糖浆止泻	内科	消化类
佛手治胃痛	内科	消化类
治胃源性腹泻方	内科	消化类
黄鳝治久痢虚症	内科	消化类
菱角治痢疾胃溃疡	内科	消化类
海蜇大枣治胃溃疡	内科	消化类
胃下垂中药方剂	内科	消化类
车前子治水泻	内科	消化类
食蒜治拉肚子	内科	消化类
蛔虫性肠梗阻中药方剂	内科	消化类
蒜酒治便秘	内科	泌尿类
肠梗阻中药方剂	内科	消化类
中毒性菌痢中药方剂	内科	消化类
胆石症急性发作验方	内科	消化类
早期肝硬化中药方剂	内科	消化类
肝脓肿中药方剂	内科	消化类
治疗胆结石偏方	内科	消化类
胃扭转中药方剂	内科	消化类
治疗便秘的偏方12	内科	泌尿类
热敷疗法治便秘	内科	泌尿类
麸皮拌萝卜丝治便秘	内科	泌尿类
喝艾叶水治便秘	内科	泌尿类
冬瓜瓤治便秘	内科	泌尿类
核桃仁治便秘	内科	泌尿类
猕猴桃治便秘	内科	泌尿类
便秘中药方剂	内科	泌尿类
治疗便秘秘方三则	内科	泌尿类
治疗便秘的秘方	内科	泌尿类
排毒调补法治老年性便秘	内科	泌尿类
便秘的偏方2	内科	泌尿类
便秘的偏方4	内科	泌尿类
便秘的偏方3	内科	泌尿类
便秘的偏方	内科	泌尿类
习惯性便秘的几个偏方	内科	泌尿类
急性细菌性痢疾中药方剂	内科	消化类
肝炎的偏方7	内科	传染病
治疗便秘三法	内科	泌尿类
攻补兼施治便秘	内科	泌尿类
消化不良选啥药	内科	消化类
胃下垂食疗	内科	消化类
民间用豆腐治病验方	内科	消化类
腹泻验方	内科	消化类
鲜松叶治急性肠炎	内科	消化类
快速止嗝法	内科	消化类
红薯叶通便	内科	泌尿类
山姜籽治腹泻	内科	消化类
18种解决便秘的方法	内科	泌尿类
治疗便秘的偏方5	内科	泌尿类
产后便秘处置法	妇科	产后病
便秘治疗	内科	泌尿类
奶蜜葱汁治老人便秘	内科	泌尿类
胃下垂验方	内科	消化类
空腹喝紫菜汤可治便秘	内科	泌尿类
治疗便秘的偏方1	内科	泌尿类
治疗便秘的偏方4	内科	泌尿类
治疗便秘的偏方6	内科	泌尿类
治疗便秘的偏方3	内科	泌尿类
芋头粥治便秘	内科	泌尿类
胃炎良方	内科	消化类
土豆汁治便秘	内科	消化类
成人上吐下泻秘方	内科	消化类
治下痢秘方	内科	消化类
胆囊炎的偏方	内科	消化类
慢性盲肠炎秘方	内科	消化类
消化性溃疡的偏方2	内科	消化类
腹泻偏方1	内科	消化类
胆结石验方	内科	消化类
肝硬化秘方	内科	消化类
消化不良的偏方3	内科	消化类
枇杷叶治便秘	内科	泌尿类
便秘的偏方5	内科	泌尿类
公务人员的胃肠秘方	内科	消化类
一般有损胃肠之青果	内科	消化类
感冒的偏方5	内科	呼吸类
胃寒痛方	内科	消化类
消化不良奇方	内科	消化类
十二指肠溃疡秘方	内科	消化类
治习惯性便秘方	内科	泌尿类
胃溃疡秘方	内科	消化类
胃痛、胃涨良方	内科	消化类
阿米巴痢疾偏方	内科	消化类
土豆汁治十二指肠溃疡	内科	消化类
胃部出血良方	内科	消化类
胆石症秘方	内科	消化类
阿胶治结肠炎	内科	消化类
胃痛胃窦炎胀气吐酸	内科	消化类
慢性胃炎胃寒胃下垂	内科	消化类
胃、十二指肠溃疡	内科	消化类
急性肠炎	内科	消化类
慢性肠炎、腹泻	内科	消化类
消化不良	内科	消化类
内热口干	内科	消化类
黄疸肝炎	内科	传染病
慢性肝炎	内科	传染病
肝硬化腹水	内科	消化类
胆囊炎	内科	消化类
痢疾、泄泻	内科	消化类
如何治疗咳嗽	内科	呼吸类
民间常用的润喉清音方	内科	呼吸类
贝母	内科	呼吸类
党参百合粥	内科	呼吸类
川明参烧雅鱼	内科	呼吸类
润肺止咳的杏梨饮茶	内科	呼吸类
瓜蒌饼	内科	呼吸类
附子生姜炖狗肉	内科	呼吸类
有止咳化痰作用的中药	内科	呼吸类
落花生粥	内科	呼吸类
四仁大战	内科	呼吸类
车前子粥	内科	呼吸类
腐竹鲜蘑	内科	呼吸类
银耳羹	内科	呼吸类
玉竹猪心	内科	呼吸类
批杷叶	内科	呼吸类
洋金花	内科	呼吸类
银杏	内科	呼吸类
青礞石	内科	呼吸类
橘梗	内科	呼吸类
润肺止咳药膳	内科	呼吸类
苦杏仁	内科	呼吸类
止咳	内科	呼吸类
肺肾虚咳嗽偏方	内科	呼吸类
猪肺粥	内科	呼吸类
马儿铃	内科	呼吸类
银杏蒸鸭	内科	呼吸类
八宝粥	内科	呼吸类
慢性支气管炎病的预防及治疗	内科	呼吸类
急性支气管炎中药方剂	内科	呼吸类
支气管哮喘中药方剂	内科	呼吸类
清水煮蒜治风寒咳嗽	内科	呼吸类
咳嗽的偏方	内科	呼吸类
咳嗽多吃梨和百合	内科	呼吸类
咳嗽秘方	内科	呼吸类
咳嗽的偏方2	内科	呼吸类
咳嗽的偏方1	内科	呼吸类
感冒、流鼻涕、打喷嚏、头晕骨酸、四肢无力、咽喉痛、消化不良之秘方	内科	呼吸类
支气管炎的偏方	内科	呼吸类
大叶性肺炎中药方剂	内科	呼吸类
巧治老慢支咳喘	内科	呼吸类
治疗咳嗽的偏方16	内科	呼吸类
久咳验方	内科	呼吸类
米醋金银花治咽喉炎	内科	呼吸类
慢性支气管炎中药方剂	内科	呼吸类
治疗咳嗽的偏方17	内科	呼吸类
慢性阻塞性肺气肿病防治	内科	呼吸类
支气管扩张咯血中药方剂	内科	呼吸类
气喘妙方	内科	呼吸类
肺结核验方	内科	呼吸类
治疗咳嗽的偏方6	内科	呼吸类
治疗咳嗽的偏方7	内科	呼吸类
咳嗽的偏方3	内科	呼吸类
治疗咳嗽的偏方8	内科	呼吸类
治疗咳嗽的偏方13	内科	呼吸类
治疗咳嗽的偏方9	内科	呼吸类
芦荟鸡蛋治咳喘	内科	呼吸类
治疗咳嗽的偏方12	内科	呼吸类
治疗咳嗽的偏方11	内科	呼吸类
治疗咳嗽的偏方10	内科	呼吸类
哮喘秘方	内科	呼吸类
红楼梦中的神秘的冷香丸	内科	呼吸类
油炸姜片治咳	内科	呼吸类
莱阳梨冰糖治咳嗽	内科	呼吸类
萝卜、冰糖治咳嗽	内科	呼吸类
立秋燥咳可以用点偏方	内科	呼吸类
鸡蛋食醋治咳嗽	内科	呼吸类
支气管哮喘常用的秘方	内科	呼吸类
咳嗽的疾病描述及治疗	内科	呼吸类
肺结核的食疗方	内科	呼吸类
大叶性肺炎的偏方秘方	内科	呼吸类
肺脓疡疾病描述及治疗	内科	呼吸类
支气管哮喘食疗验方法	内科	呼吸类
气喘疾病的治疗和验方	内科	呼吸类
老年慢性支气管炎验方	内科	呼吸类
肺气肿的各种治疗方法	内科	呼吸类
哮喘常用的偏方、验方	内科	呼吸类
天门冬粥	内科	呼吸类
治疗咳嗽较为有效偏方	内科	呼吸类
白及冰糖燕窝	内科	呼吸类
止咳妙方	内科	呼吸类
贝母甲鱼	内科	呼吸类
巧用生姜疗咳嗽	内科	呼吸类
热水袋敷背止咳	内科	呼吸类
咳嗽效验方-1	内科	呼吸类
冲鸡蛋治咳嗽	内科	呼吸类
油炸姜片治咳嗽	内科	呼吸类
秋梨膏治疗什么样咳嗽	内科	呼吸类
咳嗽治疗的偏方	内科	呼吸类
治疗哮喘的偏方4	内科	呼吸类
治疗哮喘的偏方3	内科	呼吸类
治疗哮喘的偏方2	内科	呼吸类
治疗哮喘的偏方19	内科	呼吸类
治疗哮喘的偏方22	内科	呼吸类
治疗哮喘的偏方16	内科	呼吸类
治疗咳嗽的偏方1	内科	呼吸类
治疗咳嗽的偏方5	内科	呼吸类
治疗咳嗽的偏方4	内科	呼吸类
治疗咳嗽的偏方3	内科	呼吸类
治疗咳嗽的偏方2	内科	呼吸类
治疗哮喘的偏方15	内科	呼吸类
治疗哮喘的偏方20	内科	呼吸类
治疗哮喘的偏方23	内科	呼吸类
治疗失眠的偏方24	内科	呼吸类
治疗哮喘的偏方17	内科	呼吸类
止咳验方	内科	呼吸类
治疗哮喘的偏方12	内科	呼吸类
治疗哮喘的偏方11	内科	呼吸类
治疗咳嗽的偏方19	内科	呼吸类
治肺癌一法	内科	呼吸类
治疗哮喘的偏方1	内科	呼吸类
治疗咳嗽的偏方14	内科	呼吸类
治疗哮喘的偏方14	内科	呼吸类
治疗哮喘的偏方18	内科	呼吸类
治疗哮喘的偏方10	内科	呼吸类
治疗哮喘的偏方21	内科	呼吸类
治疗哮喘的偏方13	内科	呼吸类
治疗咳嗽的偏方15	内科	呼吸类
治疗哮喘的偏方9	内科	呼吸类
川贝橘子止顽咳	内科	呼吸类
治疗哮喘的偏方8	内科	呼吸类
治疗咳嗽的偏方18	内科	呼吸类
治疗哮喘的偏方7	内科	呼吸类
治疗哮喘的偏方5	内科	呼吸类
治咽炎小验方	内科	呼吸类
治疗咳嗽的偏方20	内科	呼吸类
治疗慢性咽炎效方	内科	呼吸类
治疗哮喘的偏方6	内科	呼吸类
治慢性支气管炎方	内科	呼吸类
麦冬白莲子治慢性咽炎	内科	呼吸类
伤风感冒	内科	呼吸类
病毒感冒	内科	呼吸类
干咳	内科	呼吸类
有痰咳	内科	呼吸类
支气管炎	内科	呼吸类
肺气肿	内科	呼吸类
哮喘	内科	呼吸类
胸闷气胀	内科	呼吸类
高血脂的偏方2	内科	循环类
高血脂的偏方5	内科	循环类
血栓闭塞性脉管炎的秘方	内科	循环类
山药紫荆皮汤治贫血	内科	循环类
治疗高血压的偏方22	内科	循环类
治疗高血压的偏方24	内科	循环类
治疗高血压的偏方23	内科	循环类
治疗高血压的偏方21	内科	循环类
动物肝粥治贫血	内科	循环类
治疗高血压的偏方20	内科	循环类
治疗高血压的偏方19	内科	循环类
治疗高血压的偏方18	内科	循环类
羊骨粥治贫血	内科	循环类
莲子龙眼粥治贫血	内科	循环类
养心定志汤	内科	循环类
猕猴桃与心脏病	内科	循环类
益气活血汤治冠心病	内科	循环类
柿子汁牛奶方治高血压	内科	循环类
醋浸花生米治高血压	内科	循环类
夏枯草糖浆治高血压	内科	循环类
穴位贴药能够治疗高血压	内科	循环类
玉米须治高血压	内科	循环类
高血压治疗方芹菜粥	内科	循环类
草决明治高血压	内科	循环类
苦丁茶治高血压	内科	循环类
高血压治疗方胡萝卜粥	内科	循环类
高血压方治疗决明子粥	内科	循环类
高血压治疗方桃仁粥	内科	循环类
花生壳治高血脂	内科	循环类
治神经衰弱医方大全	内科	循环类
蜂蜜治疗高血压偏方	内科	循环类
慢性心肌梗死中药方剂	内科	循环类
老人肾虚脚痛验方	内科	循环类
中风中药方剂	内科	循环类
中风的醋疗法	内科	循环类
房性早搏中药方剂	内科	循环类
血小板减少性紫癜中药方剂	内科	循环类
血小板减少症中药方剂	内科	循环类
小儿营养性贫血中药方剂	内科	循环类
再生障碍性贫血中药方剂	内科	循环类
贫血患者秘方	内科	循环类
玉米花治高血压	内科	循环类
高血脂症中药方剂	内科	循环类
米须降糖降压	内科	循环类
高血压中药方剂	内科	循环类
高血压的秘方	内科	循环类
头痛难忍、脚酸难忍、心跳得厉害、眼睛发痒、高血压良方	内科	循环类
头痛难忍、四肢无力、呼吸困难、心脏无力、高血压良方	内科	循环类
高血压的偏方4	内科	循环类
高血压的偏方3	内科	循环类
高血压的偏方2	内科	循环类
高血压的偏方1	内科	循环类
荠菜治高血压	内科	循环类
急性脑血管病	内科	循环类
心肌梗死中药方剂	内科	循环类
急性心肌梗死中药方剂	内科	循环类
心动过速中药方剂	内科	循环类
心力衰竭中药方剂	内科	循环类
治心慌胸闷方	内科	循环类
冠心病的偏方	内科	循环类
冠心病的偏方2	内科	循环类
风湿性心脏病治疗方法	内科	循环类
向日葵叶治高血压	内科	循环类
室性早搏中药方剂	内科	循环类
杞菊地黄丸新用途	内科	循环类
针灸与心律失常的治疗	内科	循环类
治疗贫血方	内科	循环类
心绞痛的各种治疗方法	内科	循环类
牛蒡子治偏头痛	内科	循环类
肺原性心脏病治疗方法	内科	循环类
吴茱萸敷脚降压	内科	循环类
蕃石榴治心脏无力	内科	循环类
白果治老年眩晕	内科	循环类
心律失常各种治疗方法	内科	循环类
心肌梗塞各种治疗方法	内科	循环类
补血的中药有哪些	内科	循环类
高血压的偏方5	内科	循环类
治疗高血压的偏方16	内科	循环类
何首乌治贫血	内科	循环类
龙眼核治心动过速	内科	循环类
治疗高血压的偏方17	内科	循环类
风湿性心脏病中药方剂	内科	循环类
心律失常中药方剂	内科	循环类
心力衰竭中药秘方	内科	循环类
心绞痛心肌梗死中药方剂	内科	循环类
治疗高血压的偏方15	内科	循环类
脑血栓中药方剂	内科	循环类
菊花粥	内科	循环类
脑溢血中药方剂	内科	循环类
贫血药膳方四则	内科	循环类
冠心病中药方剂	内科	循环类
治疗高血压的偏方14	内科	循环类
动脉硬化中药偏方	内科	循环类
治疗高血压的偏方13	内科	循环类
白细胞减少症中药方剂	内科	循环类
病态窦房结综合症中药方剂	内科	循环类
治疗低血压偏方	内科	循环类
治疗高血压的偏方4	内科	循环类
治疗高血压的偏方3	内科	循环类
心脏病验方	内科	循环类
治疗高血压的偏方12	内科	循环类
治疗高血压的偏方11	内科	循环类
治疗高血压的偏方1	内科	循环类
淡菜荠菜汤	内科	循环类
糖饯加味红枣治贫血	内科	循环类
冠心病的偏方3	内科	循环类
心慌胸闷的偏方	内科	循环类
治疗高血压的偏方10	内科	循环类
治疗高血压的偏方9	内科	循环类
治疗高血压的偏方8	内科	循环类
生姜药用有奇效	内科	循环类
九味煎治疗心悸	内科	循环类
降压芹菜粥	内科	循环类
高血压性头痛药茶方	内科	循环类
鱼鳔当归汤治贫血	内科	循环类
蜂蜜治贫血	内科	循环类
小米龙眼粥治贫血	内科	循环类
荔枝干大枣治贫血	内科	循环类
鸡血藤煲鸡蛋治贫血	内科	循环类
山药天花粉汤治贫血	内科	循环类
治疗高血压的偏方5	内科	循环类
治疗高血压的偏方7	内科	循环类
红枣黑木耳汤治贫血	内科	循环类
治疗高血压的偏方6	内科	循环类
花生衣治贫血	内科	循环类
心悸的疾病描述及治疗	内科	循环类
鸡汁粥治贫血	内科	循环类
高血压治疗方山楂粥	内科	循环类
高血压治疗方海蜇荸荠汤	内科	循环类
高血压治疗方冰糖酸醋饮	内科	循环类
治疗高血压的偏方25	内科	循环类
高血压	内科	循环类
低血压	内科	循环类
血小板少	内科	循环类
高血脂、高胆固醇	内科	循环类
心脏病、冠心病	内科	循环类
贫血	内科	循环类
神经衰弱各种治疗偏方	内科	神经类
神经性头痛中药方剂	内科	神经类
癫痫常用有效偏方验方	内科	神经类
治面神经炎偏方	内科	神经类
帕金森综合征偏方	内科	神经类
治疗慢性骨髓炎一法	内科	神经类
天麻擅治眩晕	内科	神经类
多发性神经炎药膳（一）	内科	神经类
指甲治手足抽搐	内科	神经类
清府息痛汤	内科	神经类
多发性神经炎药膳（二）	内科	神经类
肋间神经痛药膳1	内科	神经类
黄鳝血治口眼歪斜	内科	神经类
坐骨神经痛中药方剂	内科	神经类
神经官能症中药方剂	内科	神经类
神经衰弱中药方剂	内科	神经类
神经衰弱医方大全	内科	神经类
三叉神经痛中药方剂	内科	神经类
面神经麻痹中药方剂	内科	神经类
面神经神炎中药方剂	内科	神经类
精神分裂症中药方剂	内科	神经类
各种头痛	内科	神经类
头昏头晕	内科	神经类
失眠、多梦	内科	神经类
慢性肾盂肾炎中药方剂	内科	泌尿类
急性尿潴留中药方剂	内科	泌尿类
尿潴留中药方剂	内科	泌尿类
小便失禁中药方剂	内科	泌尿类
急性肾功能衰竭中药方剂	内科	泌尿类
消渴方	内科	泌尿类
四季治疗糖尿病良方	内科	泌尿类
糖尿病的偏方4	内科	泌尿类
糖尿病的偏方2	内科	泌尿类
糖尿病的偏方3	内科	泌尿类
糖尿病的偏方1	内科	泌尿类
慢性肾功能衰竭防治	内科	泌尿类
肾病综合症中药方剂	内科	泌尿类
急性肾小球肾炎中药方剂	内科	泌尿类
膀胱发炎验方	内科	泌尿类
治便秘良方	内科	泌尿类
治疗糖尿病的偏方20	内科	泌尿类
治疗糖尿病的偏方21	内科	泌尿类
蜂蜜治疗便秘偏方	内科	泌尿类
治疗糖尿病的偏方18	内科	泌尿类
老人小便不通方	内科	泌尿类
南瓜治糖尿病	内科	泌尿类
治疗糖尿病的偏方8	内科	泌尿类
核桃治肾结石	内科	泌尿类
治疗糖尿病的偏方12	内科	泌尿类
治疗糖尿病的偏方10	内科	泌尿类
治小便不通方	内科	泌尿类
糖尿病患者饮食要限钠盐吗?	内科	泌尿类
治疗糖尿病的偏方16	内科	泌尿类
糖尿病患者：可以轻松吃主食	内科	泌尿类
治疗糖尿病的偏方7	内科	泌尿类
治疗糖尿病的偏方6	内科	泌尿类
消渴从心论治	内科	泌尿类
治疗糖尿病的偏方4	内科	泌尿类
含哪些微量元较多的食物对糖尿病有利?	内科	泌尿类
治疗糖尿病的偏方5	内科	泌尿类
治糖尿病偏方	内科	泌尿类
红参泡茶治年老尿不畅	内科	泌尿类
治疗糖尿病的偏方24	内科	泌尿类
糖尿病患者不应该吃什么?	内科	泌尿类
龟肉鱼鳔汤治老年尿频	内科	泌尿类
治疗糖尿病的偏方1	内科	泌尿类
猕猴桃治病方	内科	泌尿类
治疗糖尿病的偏方2	内科	泌尿类
红枣生姜治尿频	内科	泌尿类
糖尿病患者可以吃薯类食品吗?	内科	泌尿类
老头草治尿频尿急	内科	泌尿类
红枣干姜治老年尿频	内科	泌尿类
糖尿病患者可以饮酒吗?	内科	泌尿类
糖尿病患者这样试试看	内科	泌尿类
糖尿病患者要限制饮水吗?	内科	泌尿类
小便短少喝三汁	内科	泌尿类
肾结石中药方剂	内科	泌尿类
哪些食物富含胆固醇?	药膳	
糖尿病中药方剂	内科	泌尿类
糖尿病患者可以吃海产品吗?	内科	泌尿类
输尿管结石中药方剂	内科	泌尿类
乳糜尿中药方剂	内科	泌尿类
肾盂肾炎中药方剂	内科	泌尿类
急性肾炎中药方剂	内科	泌尿类
慢肾功能衰竭中药方剂	内科	泌尿类
清蒸茶鲫鱼治糖尿病	内科	泌尿类
枸杞子粥治疗糖尿病	内科	泌尿类
苦瓜粥治糖尿病	内科	泌尿类
豇豆汤治糖尿病	内科	泌尿类
山药粥治糖尿病	内科	泌尿类
急性尿路感染中药方剂	内科	泌尿类
尿毒症中药方剂	内科	泌尿类
尿血中药方剂	内科	泌尿类
细菌性痢疾中药方剂	内科	消化类
中药治糖尿病泌尿感染.	内科	泌尿类
糖尿病的偏方5	内科	泌尿类
尿路结石中药方剂	内科	泌尿类
泌尿系统感染中药方剂	内科	泌尿类
尿道炎中药方剂	内科	泌尿类
膀胱结石中药方剂	内科	泌尿类
泌尿系结石中药方剂	内科	泌尿类
便血偏方	内科	泌尿类
尿毒症验方	内科	泌尿类
治疗糖尿病的偏方26	内科	泌尿类
治疗糖尿病的偏方3	内科	泌尿类
治疗糖尿病的偏方9	内科	泌尿类
老年人尿频食疗方	内科	泌尿类
治疗糖尿病的偏方23	内科	泌尿类
治疗糖尿病的偏方11	内科	泌尿类
治疗泌尿系结石效方	内科	泌尿类
治疗糖尿病的偏方25	内科	泌尿类
治疗糖尿病的偏方27	内科	泌尿类
治疗糖尿病的偏方15	内科	泌尿类
治疗糖尿病的偏方14	内科	泌尿类
治疗糖尿病的偏方22	内科	泌尿类
治疗糖尿病的偏方13	内科	泌尿类
治疗糖尿病的偏方19	内科	泌尿类
肾脏病验方	内科	泌尿类
肾炎的偏方	内科	泌尿类
小便不通	内科	泌尿类
小便失禁	内科	泌尿类
尿频	内科	泌尿类
急、慢性肾炎	内科	泌尿类
大便下血	内科	泌尿类
便秘	内科	泌尿类
胆、肾、尿道结石	内科	泌尿类
糖尿病	内科	泌尿类
成人遗尿	内科	泌尿类
黄疸的偏方2	内科	内分泌
黄疸的偏方1	内科	内分泌
甲状腺机能亢进中药方剂	内科	内分泌
甲状腺机能亢进症防治	内科	内分泌
黄疸的偏方3	内科	内分泌
淋巴结核	内科	内分泌
甲亢	内科	内分泌
流行性脑膜炎中药方剂	内科	传染病
流行性急性腮腺炎中药方剂	内科	传染病
肝炎的偏方3	内科	传染病
肝炎的偏方4	内科	传染病
肝炎的偏方2	内科	传染病
肝炎的偏方1	内科	传染病
急性黄疸型肝炎的偏方	内科	传染病
急性黄疸型肝炎的偏方2	内科	传染病
肝炎的偏方6	内科	传染病
肝炎的偏方5	内科	传染病
治疗肺结核的偏方21	内科	传染病
治疗肺结核的偏方17	内科	传染病
治疗肺结核的偏方2	内科	传染病
治疗肺结核的偏方1	内科	传染病
治疗肺结核的偏方13	内科	传染病
肺结核的各种治疗方法	内科	传染病
抗药性肺结核的中医药治疗	内科	传染病
治疗肺结核的偏方8	内科	传染病
治疗肺结核的偏方14	内科	传染病
治疗肺结核的偏方18	内科	传染病
治疗肺结核的偏方15	内科	传染病
治疗肺结核的偏方16	内科	传染病
治疗肺结核的偏方12	内科	传染病
浸润型肺结核的治疗法	内科	传染病
病毒性脑炎中药方剂	内科	传染病
治疗肺结核的偏方9	内科	传染病
治疗肺结核的偏方19	内科	传染病
治疗肺结核的偏方5	内科	传染病
治疗肺结核的偏方4	内科	传染病
治疗肺结核的偏方6	内科	传染病
治疗肺结核的偏方10	内科	传染病
治疗肺结核的偏方3	内科	传染病
治疗肺结核的偏方11	内科	传染病
治疗肺结核的偏方20	内科	传染病
治疗肺结核的偏方7	内科	传染病
揉走落枕的小偏方	内科	其他类
柠檬治呃逆	内科	其他类
偏头痛中药方剂	内科	其他类
头痛中药方剂	内科	其他类
偏头痛偏方	内科	其他类
花生酱治失眠	内科	其他类
苦瓜治中暑	内科	其他类
瑶池金母青果药方八	内科	其他类
春来防病小偏方	内科	其他类
感冒的偏方1	内科	其他类
小儿感冒中药方剂	内科	其他类
感冒的偏方	内科	其他类
瑶池金母青果药方七	内科	其他类
感冒的偏方2	内科	其他类
国外研究新发现――治感冒8个偏方	内科	其他类
感冒真的要吃维他命C	内科	其他类
六月感冒未好又中暑	内科	其他类
橄榄萝卜茶治感冒	内科	其他类
蒜头冰糖治感冒	内科	其他类
风热感冒的饮食疗法	内科	其他类
当孩子感冒发烧时	内科	其他类
儿童感冒为何会引起颈椎脱位	内科	其他类
孕妇感冒秘方	内科	其他类
公务员感冒之良方	内科	其他类
都市人感冒良方	内科	其他类
中学生感冒良方	内科	其他类
十二月感冒	内科	其他类
教师感冒秘方	内科	其他类
十月感冒	内科	其他类
十一月感冒	内科	其他类
八月感冒	内科	其他类
七月感冒	内科	其他类
五月感冒	内科	其他类
牙痛速效汤	内科	其他类
牙疼漱口剂	内科	其他类
韭菜根花椒治牙疼	内科	其他类
治疗感冒的偏方18	内科	其他类
治疗感冒的偏方4	内科	其他类
治腰腿痛	内科	其他类
治疗感冒的偏方3	内科	其他类
治疗感冒的偏方6	内科	其他类
金银花药用便方	内科	其他类
治疗感冒的偏方24	内科	其他类
治疗落枕效方	内科	其他类
治疗感冒的偏方5	内科	其他类
鸡内金药用便方	内科	其他类
韭菜治疗漆疮	内科	其他类
治疗感冒的偏方22	内科	其他类
红眼病中药验方	内科	其他类
治顽固性头痛方	内科	其他类
伤食小验方	内科	其他类
治疗感冒的偏方9	内科	其他类
治顽固性呃逆	内科	其他类
治疗感冒的偏方10	内科	其他类
大蒜能治疗中暑	内科	其他类
治疗感冒的偏方19	内科	其他类
感冒足疗法	内科	其他类
按摩疗法治失眠	内科	其他类
小苏打治牙痛	内科	其他类
红花椒治腰酸腿软	内科	其他类
冷毛巾消渴法	内科	其他类
耳鸣喝淡绿茶	内科	其他类
柿蒂治呃逆	内科	其他类
非药物防治感冒十五法	内科	其他类
老年感冒的家疗	内科	其他类
治感冒有了外用药	内科	其他类
白菜姜葱汤	内科	其他类
白僵蚕治头痛	内科	其他类
荷藿苡仁粥治空调病	内科	其他类
治感冒茶疗方	内科	其他类
日常小偏方	内科	其他类
夏日绿豆食疗方	内科	其他类
热花生油治蜂蜇	内科	其他类
打喷嚏、流眼泪、筋骨酸痛、头痛、颈部酸痛、背部酸良方	内科	其他类
甜石榴汁润喉	内科	其他类
清热解毒金银花	内科	其他类
妙用冬瓜巧治病	内科	其他类
百合莲子治盗汗	内科	其他类
鸡汤是感冒良药	内科	其他类
小儿夏季高热中药方剂	内科	其他类
失眠的中医治疗	内科	其他类
香菜根熬水退烧	内科	其他类
治感冒偏方	内科	其他类
流鼻涕、咽喉痛、头重、骨头酸良方	内科	其他类
失眠中药方剂	内科	其他类
针灸治疗肥胖症	内科	其他类
醒酒方	内科	其他类
头痛的偏方、验方	内科	其他类
神仙粥治感冒	内科	其他类
中暑共4方	内科	其他类
治疗流感偏方	内科	其他类
治疗感冒偏方	内科	其他类
农人容易染患病痛	内科	其他类
失眠症应做哪些检查？	内科	其他类
季节转换防感冒	内科	其他类
感冒初期的食疗三验方	内科	其他类
失眠常用有效验方偏方	内科	其他类
咳嗽不一定都是气管炎	内科	其他类
临床常用主治中暑偏方	内科	其他类
入冬怎样防治感冒	内科	其他类
感冒小验方数则	内科	其他类
流感的治疗	内科	其他类
感冒的一些秘方、验方	内科	其他类
葡萄酒治感冒	内科	其他类
治慢性咽炎验方	内科	其他类
治疗感冒的国际化偏方	内科	其他类
蜂蜜对抗感冒	内科	其他类
治疗中暑的偏方11	内科	其他类
治疗中暑的偏方8	内科	其他类
咽喉肿痛偏方	内科	其他类
方失眠剂10	内科	其他类
治疗中暑的偏方12	内科	其他类
治疗中暑的偏方9	内科	其他类
葱白、生姜治感冒	内科	其他类
失眠方剂6	内科	其他类
感冒的治疗偏方	内科	其他类
鼻塞偏方	内科	其他类
失眠偏方	内科	其他类
头痛方	内科	其他类
治疗中暑的偏方5	内科	其他类
失眠方剂3	内科	其他类
白胡椒热汤面治感冒	内科	其他类
失眠方剂11	内科	其他类
失眠方剂12	内科	其他类
环境巨变儿童患忧郁症	内科	其他类
失眠方剂9	内科	其他类
冬青、蒲公英治感冒	内科	其他类
患了忧郁症试试四疗法	内科	其他类
忧郁症导致老年痴呆症	内科	其他类
治疗中暑的偏方4	内科	其他类
崇名年轻人易得忧郁症	内科	其他类
孕妇忧郁影响胎儿发育	内科	其他类
治疗中暑的偏方3	内科	其他类
治疗中暑的偏方10	内科	其他类
冰糖鸡蛋治感冒	内科	其他类
适度少睡眠可以保长寿	内科	其他类
治疗中暑的偏方6	内科	其他类
失眠方剂8	内科	其他类
排除失眠侵扰睡出健康	内科	其他类
失眠方剂2	内科	其他类
什么是非心因性忧郁症	内科	其他类
失眠方剂7	内科	其他类
怎么样才能攻克失眠症	内科	其他类
失眠方剂4	内科	其他类
失眠方剂5	内科	其他类
预测精神病患者将大增	内科	其他类
含蒜按足治牙龈肿	内科	其他类
感冒的偏方4	内科	其他类
感冒的偏方3	内科	其他类
治疗感冒的偏方29	内科	其他类
治疗感冒的偏方27	内科	其他类
治疗感冒的偏方26	内科	其他类
治疗感冒的偏方23	内科	其他类
治疗失眠的偏方5	内科	其他类
治疗感冒的偏方20	内科	其他类
治疗失眠的偏方2	内科	其他类
核桃药用小方	内科	其他类
治疗失眠的偏方3	内科	其他类
治疗失眠的偏方9	内科	其他类
治疗感冒的偏方7	内科	其他类
治疗失眠的偏方8	内科	其他类
治疗失眠的偏方7	内科	其他类
治疗感冒的偏方14	内科	其他类
治疗失眠的偏方6	内科	其他类
治疗感冒的偏方16	内科	其他类
治疗感冒的偏方17	内科	其他类
治老年人虚性便秘	内科	其他类
治疗感冒的偏方15	内科	其他类
治疗感冒的偏方8	内科	其他类
治疗感冒的偏方21	内科	其他类
治疗感冒的偏方25	内科	其他类
中暑方	内科	其他类
治疗感冒的偏方2	内科	其他类
治疗感冒的偏方28	内科	其他类
治疗感冒的偏方13	内科	其他类
治疗感冒的偏方12	内科	其他类
治疗感冒的偏方11	内科	其他类
治疗失眠的偏方4	内科	其他类
治疗失眠的偏方11	内科	其他类
黑豆当药	内科	其他类
治病广泛的马鞭草	内科	其他类
治疗失眠的偏方10	内科	其他类
回乳茶疗方	妇科	产后病
治疗失眠的偏方12	内科	其他类
治头痛验方	内科	其他类
方剂14	内科	其他类
方剂16	内科	其他类
方剂15	内科	其他类
方剂17	内科	其他类
药粥送你入梦乡	内科	其他类
方剂18	内科	其他类
方剂13	内科	其他类
缓解失眠四法	内科	其他类
治疗感冒六法	内科	其他类
方剂19	内科	其他类
方剂20	内科	其他类
教你几招防治中暑	内科	其他类
苹果减肥法	内科	其他类
治偏头痛六法	内科	其他类
10大失眠元凶扰人清梦	内科	其他类
老人失眠慎用巴比妥类	内科	其他类
失眠的原因与对策	内科	其他类
治神经衰弱失眠方	内科	其他类
感冒难治愈原是汞中毒	内科	其他类
失眠概述	内科	其他类
过度压力让人变笨	内科	其他类
感冒有什么危害	内科	其他类
失眠试试六道汤	内科	其他类
手脚酸软、四肢无力、眼睛酸、背骨酸软、口内苦涩良方	内科	其他类
老人睡眠三注意	内科	其他类
感冒不必频投医	内科	其他类
上呼吸道感染－感冒	内科	其他类
过分紧张导致失眠	内科	其他类
为何睡着了却偏说没睡着	内科	其他类
靓汤一煲清暑热	内科	其他类
焦虑性失眠	内科	其他类
防感冒的5个小妙方	内科	其他类
失眠症的自我调节须知	内科	其他类
失眠症的放松训练疗法	内科	其他类
失眠的疾病描述及治疗	内科	其他类
治疗中暑的偏方1	内科	其他类
失眠症的催眠疗法	内科	其他类
生活小偏方治大病	内科	其他类
失眠可分为那几种类型	内科	其他类
治疗中暑偏方2	内科	其他类
失眠的诊断	内科	其他类
引起失眠的原因	内科	其他类
失眠的类型	内科	其他类
关于爱发脾气与忧郁症	内科	其他类
对失眠者的建议	内科	其他类
失眠方剂1	内科	其他类
绿豆茶饮治流感	内科	其他类
打呼	内科	其他类
打嗝	内科	其他类
晕车	内科	其他类
中风	内科	其他类
水肿	内科	其他类
癫痫	内科	其他类
落枕	内科	其他类
戒烟	内科	其他类
戒酒	内科	其他类
喝酒不醉	内科	其他类
跌打丸治能治疗落枕	外科	跌打伤
脑震荡的偏方3	外科	跌打伤
外伤性胸痛	外科	跌打伤
脑震荡的偏方	外科	跌打伤
脑震荡的偏方2	外科	跌打伤
黄芪杜仲治劳伤腰痛	外科	跌打伤
地龙治下肢溃疡	外科	跌打伤
少林寺跌打损伤秘方	外科	跌打伤
踝关节扭伤的偏方	外科	跌打伤
砂糖治褥疮	外科	跌打伤
蛇、虫、兽咬伤的偏方	外科	跌打伤
外伤的偏方1	外科	跌打伤
踝关节扭伤验方	外科	跌打伤
腰痛偏方	外科	跌打伤
葛根治褥疮	外科	跌打伤
迎春花瓣治跌打	外科	跌打伤
大蒜内膜“创可贴”	外科	跌打伤
四肢麻木可以这么治	外科	跌打伤
腰肌劳损中药方剂	外科	跌打伤
急性腰扭伤中药方剂	外科	跌打伤
腰部扭挫伤中药方剂	外科	跌打伤
头颅外伤后遗症中药方剂	外科	跌打伤
脑震荡中药方剂	外科	跌打伤
挫伤的偏方	外科	跌打伤
烧伤酒	外科	烧烫伤
烫伤的偏方1	外科	烧烫伤
蛋清治疗烧烫伤	外科	烧烫伤
新鲜葡萄可治疗烫伤	外科	烧烫伤
石灰麻油疗轻度烫伤	外科	烧烫伤
蚯蚓治水烫伤	外科	烧烫伤
治疗冻疮小秘方	外科	冻伤类
萝卜水洗脚防冻疮	外科	冻伤类
白萝卜治冻疮	外科	冻伤类
防冻疮小验方	外科	冻伤类
松子仁治冻疮	外科	冻伤类
偏方治冻疮	外科	冻伤类
烧伤偏方	外科	烧烫伤
冻疮的偏方	外科	冻伤类
烫伤的偏方2	外科	烧烫伤
云南白药治烧伤	外科	烧烫伤
治疗烧烫伤验方	外科	烧烫伤
葡萄能治疗烫伤	外科	烧烫伤
芙蓉花治老烂脚	外科	炎症类
啤酒治冻疮	外科	冻伤类
桂圆核治烫伤	外科	烧烫伤
芥末治脚裂口	外科	炎症类
白酒泡桃治冻耳朵	外科	烧烫伤
烫伤	外科	烧烫伤
冻耳方三	外科	冻伤类
冻耳二	外科	冻伤类
冻耳一	外科	冻伤类
冻疮未破	外科	冻伤类
冻疮已破	外科	冻伤类
跟骨骨质增生中药方剂	外科	骨症类
非化脓性肋软骨炎中药方剂	外科	骨症类
骨结核的症状和秘方	外科	骨症类
醋泡透骨草治足足跟骨刺	外科	骨症类
颈椎病偏方	外科	骨症类
骨髓炎、骨结核病	外科	骨症类
骨髓炎中药方剂	外科	骨症类
颈椎病中药方剂	外科	骨症类
骨刺增生中药方剂	外科	骨症类
骨刺中药方剂	外科	骨症类
骨质增生症中药方剂	外科	骨症类
髌骨软骨炎中药方剂	外科	骨症类
陈旧性骨折中药方剂	外科	骨症类
治疗足跟痛方集锦	外科	骨症类
慢性骨髓炎中药方剂	外科	骨症类
骨质疏松症的偏方	外科	骨症类
颈椎病的偏方	外科	骨症类
腰椎间盘突出症的偏方	外科	骨症类
针灸治疗颈椎病	外科	骨症类
治脊椎病方	外科	骨症类
韭菜治关节痛	外科	骨症类
米醋浸泡红花治骨刺	外科	骨症类
腰椎骨质增生中药方剂	外科	骨症类
肋软骨炎中药方剂	外科	骨症类
颈椎增生中药方剂	外科	骨症类
关节炎、肩周炎	外科	骨症类
劳伤腰痛	外科	骨症类
腰椎盘突出	外科	骨症类
肾亏腰痛	外科	骨症类
坐骨神经痛	外科	骨症类
颈椎痛	外科	骨症类
骨刺	外科	骨症类
四肢酸麻、腿抽筋	外科	骨症类
扭伤、四肢无力	外科	骨症类
褥疮中药方剂	外科	炎症类
破伤风的偏方	外科	炎症类
颌面部急性化脓性淋巴结炎中药方剂	外科	炎症类
血栓闭塞性脉管炎中药方剂	外科	炎症类
下肢静脉曲张中药方剂	外科	炎症类
指甲剥离症中药方剂	外科	炎症类
肛窦炎方二消炎栓	外科	炎症类
喷气式治肩周炎	外科	炎症类
睾丸鞘膜积液中药方剂	外科	炎症类
血栓脉管炎的秘方	外科	炎症类
膀胱发炎秘方	外科	炎症类
化脓性乳腺炎中药方剂	妇科	乳腺癌
血栓性脉管炎中药方剂	外科	炎症类
血栓性静脉炎中药方剂	外科	炎症类
胆道蛔虫并发胰腺炎中药方剂	外科	炎症类
褥疮的偏方	外科	炎症类
急性血栓性深静脉炎中药方剂	外科	炎症类
胸腹壁血栓性静脉炎中药方剂	外科	炎症类
风湿性关节炎中药方剂	外科	炎症类
丹毒	外科	炎症类
强直性脊柱炎验方	外科	炎症类
乳腺增生中药方剂	妇科	乳腺癌
急性淋巴结炎中药方剂	外科	炎症类
急性乳腺炎中药方剂	妇科	乳腺癌
胸椎骨结核中药方剂	外科	炎症类
膝关节滑膜炎中药方剂	外科	炎症类
乳腺小叶增生中药方剂	妇科	乳腺癌
急性淋茵性尿道炎中药方剂	外科	炎症类
结核性关节炎中药方剂	外科	炎症类
肩关节周围炎中药方剂	外科	炎症类
急性睾丸炎中药方剂	外科	炎症类
瘰疬的偏方	外科	炎症类
指头炎的偏方	外科	炎症类
全身淋巴结肿大中药方剂	外科	炎症类
下肢溃疡的偏方	外科	炎症类
腹股沟斜疝中药方剂	外科	炎症类
淋巴结结核秘方	外科	炎症类
乳痈偏方	外科	炎症类
胸腹壁血栓性静脉炎秘方	外科	炎症类
淋巴结核偏方	外科	炎症类
阑尾周围脓肿中药方剂	外科	炎症类
多发性细菌性肝脓肿中药方剂	外科	炎症类
蜂窝组织炎中药方剂	外科	炎症类
大动脉炎中药方剂	外科	炎症类
痛风中药方剂	外科	炎症类
类风湿性关节炎中药方剂	外科	炎症类
尿道发炎验方	外科	炎症类
破伤风的偏方2	外科	炎症类
痔疮的偏方	外科	治痔疮
急性化脓性骨髓炎的秘方	外科	炎症类
肩关节周围炎的秘方	外科	炎症类
化脓性睾丸炎中药方剂	外科	炎症类
强直性脊柱炎中药方剂	外科	炎症类
肩周炎验方	外科	炎症类
乳腺炎中药方剂	妇科	乳腺癌
丹毒的偏方	外科	炎症类
打针结块	外科	炎症类
狐臭	外科	炎症类
口眼歪	外科	炎症类
痛风	外科	炎症类
静脉曲张	外科	炎症类
猫、狗咬伤	外科	炎症类
毒蛇、毒虫咬伤	外科	炎症类
臁疮	外科	炎症类
流火、丹毒	外科	炎症类
痔疮14	外科	治痔疮
痔疮1	外科	治痔疮
痔疮13	外科	治痔疮
生豆腐渣可治疗痔疮	外科	治痔疮
痔疮11	外科	治痔疮
肛窦炎方一大黄元明煎	外科	治痔疮
治疗痔疮一法	外科	治痔疮
痔疮10	外科	治痔疮
痔疮12	外科	治痔疮
痔疮9	外科	治痔疮
痔疮8	外科	治痔疮
椿树皮治痔疮	外科	治痔疮
痔疮7	外科	治痔疮
防止痔疮出血“小窍门”	外科	治痔疮
痔疮中药方剂	外科	治痔疮
外痔、内痔奇方	外科	治痔疮
小儿急性肾炎的秘方	儿科	泌尿类
痔疮6	外科	治痔疮
痔疮5	外科	治痔疮
痔疮4	外科	治痔疮
痔疮临床常用偏方秘方	外科	治痔疮
痔疮治疗的偏方	外科	治痔疮
治外痔验方	外科	治痔疮
褥疮的疾病描述及治疗	外科	炎症类
痔疮保健偏方	外科	治痔疮
痔疮的偏方秘方	外科	治痔疮
巧法治痔疮	外科	治痔疮
痔疮的针灸疗法	外科	治痔疮
痔疮3	外科	治痔疮
脚尖走路治痔疮	外科	治痔疮
痔疮2	外科	治痔疮
韭菜汁熏治痔疮	外科	治痔疮
治外痔验方1	外科	治痔疮
提脚跟走路治痔疮	外科	治痔疮
无花果叶治痔疮	外科	治痔疮
痔疮15	外科	治痔疮
内、外痔疮	外科	治痔疮
脱肛	外科	治痔疮
白血病方剂6	肿瘤	白血病
白血病方剂7	肿瘤	白血病
白血病方剂8	肿瘤	白血病
白血病方剂2	肿瘤	白血病
白血病方剂3	肿瘤	白血病
白血病方剂4	肿瘤	白血病
白血病方剂5	肿瘤	白血病
白血病方剂1	肿瘤	白血病
白血病方剂10	肿瘤	白血病
白血病方剂11	肿瘤	白血病
白血病方剂12	肿瘤	白血病
白血病偏方9	肿瘤	白血病
白血病不宜服用益血生	肿瘤	白血病
白血病患者的饮食治疗	肿瘤	白血病
白血病的中医食疗	肿瘤	白血病
白血病的各种治疗方法	肿瘤	白血病
由中医八法治疗白血病	肿瘤	白血病
用于白血病患者食疗方	肿瘤	白血病
白血病病人的膳食调配	肿瘤	白血病
苹果当药吃 肿瘤远离你	肿瘤	肝癌类
肝癌秘方	肿瘤	肝癌类
肝癌方二	肿瘤	肝癌类
肝癌方一	肿瘤	肝癌类
肝癌方十八	肿瘤	肝癌类
肝癌方十九	肿瘤	肝癌类
肝癌方三十	肿瘤	肝癌类
肝癌方二十三	肿瘤	肝癌类
肝癌方二十七	肿瘤	肝癌类
肝癌方二十	肿瘤	肝癌类
肝癌方二十一	肿瘤	肝癌类
肝癌方二十八	肿瘤	肝癌类
肝癌方二十九	肿瘤	肝癌类
肝癌方二十六	肿瘤	肝癌类
肝癌方二十四	肿瘤	肝癌类
肝癌方三	肿瘤	肝癌类
肝癌方四	肿瘤	肝癌类
肝癌方三十二	肿瘤	肝癌类
肝癌方三十五	肿瘤	肝癌类
治疗肝癌常用偏方验方	肿瘤	肝癌类
肝癌方五	肿瘤	肝癌类
肝癌方六	肿瘤	肝癌类
原发性肝癌的中医药治疗	肿瘤	肝癌类
肝癌方七	肿瘤	肝癌类
肝癌方二十五	肿瘤	肝癌类
肝癌方十	肿瘤	肝癌类
肝癌方九	肿瘤	肝癌类
肝癌方八	肿瘤	肝癌类
肝癌方十一	肿瘤	肝癌类
原发性肝癌民间秘方	肿瘤	肝癌类
肝癌方十二	肿瘤	肝癌类
原发性肝癌中医疗法	肿瘤	肝癌类
肝癌方十四	肿瘤	肝癌类
肝癌方十三	肿瘤	肝癌类
肝癌方十五	肿瘤	肝癌类
肝癌方十六	肿瘤	肝癌类
肝癌方十七	肿瘤	肝癌类
肝癌方二十二	肿瘤	肝癌类
肝癌中药方剂	肿瘤	肝癌类
中医学肝癌综合治疗概述	肿瘤	肝癌类
肺癌方二十一	肿瘤	肺癌类
肺癌方十五	肿瘤	肺癌类
肺癌中药方剂	肿瘤	肺癌类
肺癌方十六	肿瘤	肺癌类
肺癌共8方	肿瘤	肺癌类
肺癌方十七	肿瘤	肺癌类
肺癌方十八	肿瘤	肺癌类
肺癌方十九	肿瘤	肺癌类
肺癌方二十	肿瘤	肺癌类
肺癌方二	肿瘤	肺癌类
肺癌胸痛偏方	肿瘤	肺癌类
肺癌方三	肿瘤	肺癌类
肺癌	肿瘤	肺癌类
肺癌方四	肿瘤	肺癌类
肺癌方五	肿瘤	肺癌类
肺癌方十四	肿瘤	肺癌类
肺癌方二十四	肿瘤	肺癌类
肺癌方二十六	肿瘤	肺癌类
肺癌方二十八	肿瘤	肺癌类
肺癌方七	肿瘤	肺癌类
肺癌方一	肿瘤	肺癌类
肺癌方三十一	肿瘤	肺癌类
肺癌方六	肿瘤	肺癌类
肺癌临床常用有效偏方	肿瘤	肺癌类
肺癌方三十三	肿瘤	肺癌类
肺癌方二十二	肿瘤	肺癌类
肺癌方十二	肿瘤	肺癌类
肺癌方二十五	肿瘤	肺癌类
肺癌方二十三	肿瘤	肺癌类
肺癌方八	肿瘤	肺癌类
肺癌方九	肿瘤	肺癌类
肺癌方十三	肿瘤	肺癌类
肺癌方十	肿瘤	肺癌类
肺癌方十一	肿瘤	肺癌类
胃癌方二	肿瘤	胃癌类
胃癌方三	肿瘤	胃癌类
胃癌方二十二	肿瘤	胃癌类
胃癌方十八	肿瘤	胃癌类
胃癌秘方	肿瘤	胃癌类
胃癌方六	肿瘤	胃癌类
胃癌方五	肿瘤	胃癌类
胃癌方四	肿瘤	胃癌类
胃癌方十九	肿瘤	胃癌类
胃癌方十七	肿瘤	胃癌类
胃癌方二十五	肿瘤	胃癌类
胃癌饮食疗法	肿瘤	胃癌类
胃癌方二十四	肿瘤	胃癌类
胃癌方二十六	肿瘤	胃癌类
胃癌方三十	肿瘤	胃癌类
胃癌方三十二	肿瘤	胃癌类
胃癌方三十一	肿瘤	胃癌类
胃癌常用的有效的偏方	肿瘤	胃癌类
胃癌方二十七	肿瘤	胃癌类
胃癌方十一	肿瘤	胃癌类
胃癌方九	肿瘤	胃癌类
胃癌中药方剂	肿瘤	胃癌类
胃癌方十五	肿瘤	胃癌类
胃癌方二十三	肿瘤	胃癌类
胃癌方十六	肿瘤	胃癌类
胃癌方二十	肿瘤	胃癌类
胃癌方一	肿瘤	胃癌类
胃癌方二十一	肿瘤	胃癌类
胃癌共11方	肿瘤	胃癌类
胃癌方十	肿瘤	胃癌类
胃癌方七	肿瘤	胃癌类
胃癌方二十八	肿瘤	胃癌类
胃癌方二十九	肿瘤	胃癌类
胃癌方八	肿瘤	胃癌类
胃癌方十三	肿瘤	胃癌类
胃癌方十二	肿瘤	胃癌类
胃癌方十四	肿瘤	胃癌类
食管癌方十三	肿瘤	食管癌
食管癌方十四	肿瘤	食管癌
食管癌中药方剂	肿瘤	食管癌
食管癌方十六	肿瘤	食管癌
食管癌方十八	肿瘤	食管癌
食管癌方十九	肿瘤	食管癌
食管癌方二十	肿瘤	食管癌
食管癌方二十二	肿瘤	食管癌
食管癌方二十一	肿瘤	食管癌
食管癌方二	肿瘤	食管癌
食管癌方三	肿瘤	食管癌
食管癌方四	肿瘤	食管癌
食管癌方五	肿瘤	食管癌
食管癌方十七	肿瘤	食管癌
食管癌方二十七	肿瘤	食管癌
食管癌方二十四	肿瘤	食管癌
食管癌方二十八	肿瘤	食管癌
食管癌方二十六	肿瘤	食管癌
食管痛的各种治疗方法	肿瘤	食管癌
食管癌方六	肿瘤	食管癌
食管癌方三十三	肿瘤	食管癌
食管癌食疗方	肿瘤	食管癌
食管癌方二十三	肿瘤	食管癌
食管癌方二十五	肿瘤	食管癌
食管癌方二十九	肿瘤	食管癌
食管癌方八	肿瘤	食管癌
食管癌方三十二	肿瘤	食管癌
食管癌方三十	肿瘤	食管癌
食管癌方七	肿瘤	食管癌
食管癌方十	肿瘤	食管癌
食管癌方三十一	肿瘤	食管癌
食管癌方九	肿瘤	食管癌
食管癌方十一	肿瘤	食管癌
食管癌方十二	肿瘤	食管癌
鼻咽癌方二十二	肿瘤	鼻咽癌
治疗鼻咽癌的偏方4	肿瘤	鼻咽癌
喉癌中药方剂	肿瘤	鼻咽癌
鼻咽癌方十六	肿瘤	鼻咽癌
鼻咽癌方十四	肿瘤	鼻咽癌
鼻咽癌方十五	肿瘤	鼻咽癌
鼻咽癌中药方剂	肿瘤	鼻咽癌
鼻咽癌方十七	肿瘤	鼻咽癌
喉癌秘方	肿瘤	鼻咽癌
鼻咽癌方十八	肿瘤	鼻咽癌
鼻咽癌方一	肿瘤	鼻咽癌
鼻咽癌方十九	肿瘤	鼻咽癌
鼻咽癌方二十	肿瘤	鼻咽癌
鼻咽癌方二	肿瘤	鼻咽癌
鼻咽癌方三	肿瘤	鼻咽癌
鼻咽癌方四	肿瘤	鼻咽癌
鼻咽癌方五	肿瘤	鼻咽癌
鼻咽癌方二十一	肿瘤	鼻咽癌
鼻咽癌方二十四	肿瘤	鼻咽癌
治疗鼻咽癌的偏方6	肿瘤	鼻咽癌
治疗鼻咽癌的偏方7	肿瘤	鼻咽癌
治疗鼻咽癌的偏方3	肿瘤	鼻咽癌
鼻咽癌方六	肿瘤	鼻咽癌
鼻咽癌方二十三	肿瘤	鼻咽癌
鼻咽癌方七	肿瘤	鼻咽癌
鼻咽癌方八	肿瘤	鼻咽癌
鼻咽癌方九	肿瘤	鼻咽癌
5种鼻炎的防治方法	肿瘤	鼻咽癌
鼻咽癌方十	肿瘤	鼻咽癌
鼻咽癌方十三	肿瘤	鼻咽癌
鼻咽癌方十一	肿瘤	鼻咽癌
鼻咽癌方十二	肿瘤	鼻咽癌
鼻咽癌的各种治疗方法	肿瘤	鼻咽癌
治疗鼻咽癌的偏方1	肿瘤	鼻咽癌
治疗鼻咽癌的偏方2	肿瘤	鼻咽癌
治疗鼻咽癌的偏方5	肿瘤	鼻咽癌
红斑狼疮中药方剂	皮肤	痤疮类
痤疮的治疗	皮肤	痤疮类
治疗痤疮的偏方14	皮肤	痤疮类
治疗青年痤疮方	皮肤	痤疮类
治疗痤疮的偏方1	皮肤	痤疮类
蜂蜜可治青春痘	皮肤	痤疮类
白果治青春痘	皮肤	痤疮类
百合蜂蜜治痤疮	皮肤	痤疮类
中药美容膜粉	皮肤	痤疮类
痤疮方六	皮肤	痤疮类
治疗痤疮的偏方15	皮肤	痤疮类
黄瓜藤治脓疱疮	皮肤	痤疮类
囊肿性痤疮中药方剂	皮肤	痤疮类
泻心汤治疗痤疮	皮肤	痤疮类
消痤方治疗痤疮	皮肤	痤疮类
人参健脾丸治疗痤疮	皮肤	痤疮类
治疗痤疮的偏方9	皮肤	痤疮类
治疗痤疮的偏方11	皮肤	痤疮类
治疗痤疮的偏方10	皮肤	痤疮类
痤疮常用的有效的偏方	皮肤	痤疮类
治疗痤疮的偏方7	皮肤	痤疮类
治疗痤疮的偏方6	皮肤	痤疮类
治疗痤疮的偏方4	皮肤	痤疮类
痤疮偏方	皮肤	痤疮类
青春痘之治疗法	皮肤	痤疮类
枇把叶治粉刺	皮肤	痤疮类
面上有疾中医有方	皮肤	痤疮类
治疗痤疮的偏方5	皮肤	痤疮类
丝瓜水治粉刺	皮肤	痤疮类
治疗痤疮的偏方3	皮肤	痤疮类
薏米粥治粉刺	皮肤	痤疮类
治疗痤疮的偏方13	皮肤	痤疮类
治疗痤疮的偏方12	皮肤	痤疮类
痤疮方四	皮肤	痤疮类
痤疮方五	皮肤	痤疮类
痤疮方二	皮肤	痤疮类
治疗痤疮的偏方8	皮肤	痤疮类
痤疮方一	皮肤	痤疮类
痤疮方七	皮肤	痤疮类
雀斑秘方	皮肤	除雀斑
治雀斑方4例	皮肤	除雀斑
白癜风治疗偏方	皮肤	除雀斑
嫩肤祛斑丝瓜药膳	皮肤	除雀斑
中药护肤美容验方	皮肤	除雀斑
治疗雀斑方6	皮肤	除雀斑
糯米膏祛雀斑	皮肤	除雀斑
蜂蜜祛雀斑	皮肤	除雀斑
香菜水治雀斑	皮肤	除雀斑
治疗雀斑的外台秘药	皮肤	除雀斑
冬瓜瓤美容方	皮肤	除雀斑
雀斑方二	皮肤	除雀斑
雀斑方四	皮肤	除雀斑
雀斑方三	皮肤	除雀斑
雀斑方五	皮肤	除雀斑
治疗雀斑方7	皮肤	除雀斑
枸杞美容酒	皮肤	除雀斑
雀斑的治疗方法1	皮肤	除雀斑
白附子治雀斑方	皮肤	除雀斑
雀斑的治疗方法3	皮肤	除雀斑
雀斑的治疗方法2	皮肤	除雀斑
治雀斑常用的偏方2	皮肤	除雀斑
治雀斑常用的偏方5	皮肤	除雀斑
治雀斑常用的偏方1	皮肤	除雀斑
治雀斑常用的偏方3	皮肤	除雀斑
治雀斑常用的偏方4	皮肤	除雀斑
治雀斑常用的偏方6	皮肤	除雀斑
黑木耳红枣汤	皮肤	除雀斑
治雀斑常用的偏方11	皮肤	除雀斑
治雀斑常用的偏方7	皮肤	除雀斑
柠檬冰糖汁	皮肤	除雀斑
治雀斑常用的偏方9	皮肤	除雀斑
治雀斑常用的偏方10	皮肤	除雀斑
治雀斑常用的偏方8	皮肤	除雀斑
黄瓜粥	皮肤	除雀斑
西红柿汁	皮肤	除雀斑
治雀斑常用的偏方验方	皮肤	除雀斑
治雀斑方1	皮肤	除雀斑
治雀斑方2	皮肤	除雀斑
治疗雀斑方4	皮肤	除雀斑
治雀斑方3	皮肤	除雀斑
杉木树皮治漆疮	皮肤	除雀斑
冬瓜籽桃仁蜜治雀斑	皮肤	除雀斑
桃花祛雀斑	皮肤	除雀斑
雀斑方六	皮肤	除雀斑
雀斑方七	皮肤	除雀斑
治疗雀斑方5	皮肤	除雀斑
雀斑方八	皮肤	除雀斑
雀斑方九	皮肤	除雀斑
白芷擦面净	皮肤	除雀斑
山楂橘皮饮	皮肤	黄褐斑
消斑饮	皮肤	黄褐斑
羊奶鸡蛋羹	皮肤	黄褐斑
治疗黄褐斑方2	皮肤	黄褐斑
蛋清治疗老年斑	皮肤	黄褐斑
苡仁治老年斑	皮肤	黄褐斑
枸杞能预防黄斑变性	皮肤	黄褐斑
治疗黄褐斑方3	皮肤	黄褐斑
治疗黄褐斑方1	皮肤	黄褐斑
治疗黄褐斑方5	皮肤	黄褐斑
三仁美容粥	皮肤	黄褐斑
治疗黄褐斑方4	皮肤	黄褐斑
黄褐斑偏方	皮肤	黄褐斑
系统性红斑狼疮中药方剂	皮肤	黄褐斑
黄褐斑方一	皮肤	黄褐斑
治肝郁气滞型黄褐斑方	皮肤	黄褐斑
黄褐斑方三	皮肤	黄褐斑
黄褐斑方二	皮肤	黄褐斑
猪肾薏苡仁粥	皮肤	黄褐斑
黄褐斑方四	皮肤	黄褐斑
牛奶核桃饮	皮肤	黄褐斑
桃仁牛奶芝麻糊	皮肤	黄褐斑
黄褐斑方六	皮肤	黄褐斑
黄褐斑方五	皮肤	黄褐斑
干柿去斑方	皮肤	黄褐斑
肝肾阴虚滞型黄褐斑方	皮肤	黄褐斑
黄褐斑外治法方2	皮肤	黄褐斑
黄褐斑外治法方1	皮肤	黄褐斑
针灸治疗黄褐斑	皮肤	黄褐斑
去黄褐斑验方1	皮肤	黄褐斑
去黄褐斑验方2	皮肤	黄褐斑
去黄褐斑验方4	皮肤	黄褐斑
中药祛除黄褐斑	皮肤	黄褐斑
去黄褐斑验方3	皮肤	黄褐斑
中药祛除黄褐斑1	皮肤	黄褐斑
中药祛除黄褐斑2	皮肤	黄褐斑
中药祛除黄褐斑3	皮肤	黄褐斑
巧祛黄褐斑	皮肤	黄褐斑
祛除黄褐斑	皮肤	黄褐斑
食疗法防治黄褐斑	皮肤	黄褐斑
治疗黄褐斑	皮肤	黄褐斑
面部雀、黄褐斑	皮肤	黄褐斑
蜂花粉与黄褐斑	皮肤	黄褐斑
黄褐斑的各种治疗方法	皮肤	黄褐斑
治慢性湿疹方	皮肤	湿疹类
湿疹散	皮肤	湿疹类
湿疹的局部治疗	皮肤	湿疹类
治慢性阴囊湿疹内服方	皮肤	湿疹类
大枣绿豆治皮肤瘙痒	皮肤	湿疹类
蛋黄油治疗皮肤湿疹	皮肤	湿疹类
慢性湿疹中药方剂	皮肤	湿疹类
湿疹的全身治疗	皮肤	湿疹类
血热型湿疹的治疗方	皮肤	湿疹类
血燥型湿疹的治疗方	皮肤	湿疹类
湿阻型湿疹的治疗方	皮肤	湿疹类
中医辨证分型治疗：	皮肤	湿疹类
湿热型湿疹的治疗方	皮肤	湿疹类
湿疹外敷方	皮肤	湿疹类
急性期外治方	皮肤	湿疹类
亚急性期外治方	皮肤	湿疹类
肛周湿疹中药方剂	皮肤	湿疹类
湿疹偏方	皮肤	湿疹类
治疗小儿湿疹的偏方3	儿科	皮肤病
传染性湿疹样皮炎中药方剂	皮肤	湿疹类
湿疹洗方	皮肤	湿疹类
湿疹方四	皮肤	湿疹类
湿疹方二	皮肤	湿疹类
肛门湿疹方	皮肤	湿疹类
中医治疗痱子	皮肤	湿疹类
湿疹方一	皮肤	湿疹类
湿疹方五	皮肤	湿疹类
胶布巧治牛皮癣	皮肤	湿疹类
治疗小儿湿疹的偏方2	儿科	皮肤病
湿疹方六	皮肤	湿疹类
湿疹方七	皮肤	湿疹类
慢性期的外治方	皮肤	湿疹类
湿疹方八	皮肤	湿疹类
湿疹方	皮肤	湿疹类
治湿疹方	皮肤	湿疹类
治湿疹偏方7	皮肤	湿疹类
治湿疹偏方5	皮肤	湿疹类
治疗小儿湿疹的偏方1	儿科	皮肤病
治湿疹的偏方7	皮肤	湿疹类
治湿疹偏方4	皮肤	湿疹类
治湿疹偏方3	皮肤	湿疹类
治湿疹偏方2	皮肤	湿疹类
治湿疹偏方1	皮肤	湿疹类
湿疹临床常用有效偏方	皮肤	湿疹类
荨麻疹方八	皮肤	荨麻疹
荨麻疹方九	皮肤	荨麻疹
荨麻疹方七	皮肤	荨麻疹
治慢性荨麻疹效方	皮肤	荨麻疹
桃仁能治什么病	皮肤	荨麻疹
治慢性荨麻疹方：	皮肤	荨麻疹
大蓟治疗荨麻疹	皮肤	荨麻疹
治疗荨麻疹方1	皮肤	荨麻疹
荨麻疹方1	皮肤	荨麻疹
荨麻疹中药方剂	皮肤	荨麻疹
荨麻疹方	皮肤	荨麻疹
治疗荨麻疹偏方8	皮肤	荨麻疹
枣树皮治荨麻疹	皮肤	荨麻疹
顽固性荨麻疹中药方剂	皮肤	荨麻疹
慢性荨麻疹中药方剂	皮肤	荨麻疹
小儿麻疹中药方剂	皮肤	荨麻疹
鲜丝瓜叶可治荨麻疹	皮肤	荨麻疹
治疗荨麻疹偏方9	皮肤	荨麻疹
麻疹小偏方	皮肤	荨麻疹
治疗荨麻疹偏方6	皮肤	荨麻疹
验方治疗荨麻疹	皮肤	荨麻疹
治疗荨麻疹偏方7	皮肤	荨麻疹
麻疹合并肺炎中药方剂	皮肤	荨麻疹
急性荨麻疹中药方剂	皮肤	荨麻疹
茶叶饭	皮肤	荨麻疹
荨麻疹方一	皮肤	荨麻疹
韭菜外搽疗荨麻疹	皮肤	荨麻疹
香菇饭	皮肤	荨麻疹
荨麻疹方二	皮肤	荨麻疹
过敏性紫癜	皮肤	荨麻疹
治荨麻疹一方	皮肤	荨麻疹
香莱根治荨麻疹	皮肤	荨麻疹
荨麻疹方四	皮肤	荨麻疹
荨麻疹方三	皮肤	荨麻疹
荨麻疹方六	皮肤	荨麻疹
荨麻疹方五	皮肤	荨麻疹
醋加白酒可治风疹	皮肤	荨麻疹
治荨麻疹一法	皮肤	荨麻疹
荨麻疹风寒型治疗	皮肤	荨麻疹
荨麻疹风热型治疗	皮肤	荨麻疹
荨麻疹血虚型治疗	皮肤	荨麻疹
荨麻疹血虚型治疗2	皮肤	荨麻疹
荨麻疹血虚型治疗1	皮肤	荨麻疹
荨麻疹血虚型治疗3	皮肤	荨麻疹
治疗荨麻疹的偏方3	皮肤	荨麻疹
荨麻疹血虚型治疗4	皮肤	荨麻疹
治疗荨麻疹的偏方4	皮肤	荨麻疹
治疗荨麻疹的偏方2	皮肤	荨麻疹
治疗荨麻疹的偏方1	皮肤	荨麻疹
荨麻疹的各种治疗方法	皮肤	荨麻疹
小白菜能治荨麻疹	皮肤	荨麻疹
斑秃方十六	皮肤	治斑秃
斑秃方二十	皮肤	治斑秃
斑秃方八	皮肤	治斑秃
斑秃方二十三	皮肤	治斑秃
众多验方治斑秃	皮肤	治斑秃
猪胆汁治脱发	皮肤	治脱发
治斑秃二方	皮肤	治斑秃
斑秃方十五	皮肤	治斑秃
斑秃方十九	皮肤	治斑秃
斑秃方十八	皮肤	治斑秃
斑秃方二十二	皮肤	治斑秃
斑秃方二十四	皮肤	治斑秃
治疗斑秃的偏方1	皮肤	治斑秃
斑秃方二十一	皮肤	治斑秃
治疗斑秃的偏方4	皮肤	治斑秃
治疗斑秃的偏方2	皮肤	治斑秃
治疗斑秃的偏方5	皮肤	治斑秃
斑秃中药方剂	皮肤	治斑秃
斑秃偏方	皮肤	治斑秃
白信石合剂治斑秃	皮肤	治斑秃
治疗斑秃的偏方6	皮肤	治斑秃
治疗斑秃的偏方3	皮肤	治斑秃
斑秃方二	皮肤	治斑秃
治疗斑秃的偏方11	皮肤	治斑秃
斑秃方一	皮肤	治斑秃
斑秃方三	皮肤	治斑秃
治疗斑秃的偏方10	皮肤	治斑秃
斑秃方四	皮肤	治斑秃
斑秃方二十五	皮肤	治斑秃
斑秃方五	皮肤	治斑秃
斑秃方十一	皮肤	治斑秃
斑秃方九	皮肤	治斑秃
斑秃方七	皮肤	治斑秃
斑秃方十二	皮肤	治斑秃
斑秃方十三	皮肤	治斑秃
斑秃方十四	皮肤	治斑秃
治疗斑秃的偏方12	皮肤	治斑秃
治疗斑秃的偏方13	皮肤	治斑秃
治疗斑秃的偏方17	皮肤	治斑秃
治疗斑秃的偏方15	皮肤	治斑秃
治疗斑秃的偏方18	皮肤	治斑秃
治疗斑秃的偏方16	皮肤	治斑秃
治疗斑秃的偏方20	皮肤	治斑秃
治疗斑秃的偏方22	皮肤	治斑秃
治疗斑秃的偏方19	皮肤	治斑秃
治疗斑秃的偏方24	皮肤	治斑秃
治疗斑秃的偏方23	皮肤	治斑秃
治疗斑秃的偏方26	皮肤	治斑秃
治疗斑秃的偏方25	皮肤	治斑秃
治疗斑秃的偏方27	皮肤	治斑秃
治斑秃的单方验方	皮肤	治斑秃
治斑秃的外用方	皮肤	治斑秃
治斑秃的中成药	皮肤	治斑秃
治疗斑秃的偏方9	皮肤	治斑秃
治疗斑秃的偏方8	皮肤	治斑秃
治疗斑秃的偏方7	皮肤	治斑秃
治疗斑秃的偏方、秘方	皮肤	治斑秃
治疗斑秃的偏方28	皮肤	治斑秃
治疗脱发的偏方12	皮肤	治脱发
治疗脱发的偏方10	皮肤	治脱发
治疗脱发的偏方17	皮肤	治脱发
治疗脱发的偏方15	皮肤	治脱发
治脱发小窍门	皮肤	治脱发
脱发的偏方秘方四	皮肤	治脱发
脱发的偏方秘方五	皮肤	治脱发
治疗脱发的偏方22	皮肤	治脱发
治疗脱发的偏方14	皮肤	治脱发
治疗脱发的偏方13	皮肤	治脱发
治疗脱发的偏方16	皮肤	治脱发
脱发的偏方秘方三	皮肤	治脱发
脱发的偏方秘方一	皮肤	治脱发
脱发的偏方秘方二	皮肤	治脱发
治疗脱发的偏方20	皮肤	治脱发
一组治脱发的偏方	皮肤	治脱发
治疗脱发的偏方19	皮肤	治脱发
治疗脱发的偏方24	皮肤	治脱发
治疗脱发的偏方11	皮肤	治脱发
治疗脱发的偏方21	皮肤	治脱发
治疗脱发的偏方23	皮肤	治脱发
治疗脱发的偏方2	皮肤	治脱发
治疗脱发的偏方25	皮肤	治脱发
治疗脱发的偏方18	皮肤	治脱发
慈禧太后的治脱发秘方	皮肤	治脱发
透骨草汤治脂溢性脱发	皮肤	治脱发
治疗脱发的偏方5	皮肤	治脱发
治疗脱发的偏方6	皮肤	治脱发
治疗脱发的偏方4	皮肤	治脱发
治疗脱发的偏方3	皮肤	治脱发
治疗脱发的偏方8	皮肤	治脱发
治疗脱发的偏方7	皮肤	治脱发
治疗脱发的偏方9	皮肤	治脱发
治疗白发的偏方5	皮肤	治白发
治疗白发的偏方6	皮肤	治白发
治疗白发的偏方4	皮肤	治白发
治疗白发的偏方9	皮肤	治白发
治疗白发的偏方7	皮肤	治白发
治疗白发的偏方8	皮肤	治白发
治疗白发的偏方10	皮肤	治白发
治疗白发的偏方12	皮肤	治白发
治疗白发的偏方11	皮肤	治白发
治疗白发的偏方13	皮肤	治白发
治疗白发的偏方15	皮肤	治白发
白发方十八	皮肤	治白发
白发方十七	皮肤	治白发
白发方二十	皮肤	治白发
白发偏方	皮肤	治白发
白发的验方偏方	皮肤	治白发
治疗白发的偏方14	皮肤	治白发
白发方十三	皮肤	治白发
白发方十五	皮肤	治白发
白发方十六	皮肤	治白发
白发方十九	皮肤	治白发
治疗白发的偏方32	皮肤	治白发
治疗白发的偏方16	皮肤	治白发
桑叶防治少白头	皮肤	治白发
治疗白发的验方、偏方	皮肤	治白发
治疗白发的偏方18	皮肤	治白发
中医治白发的方法	皮肤	治白发
白发方二	皮肤	治白发
治疗白发的偏方19	皮肤	治白发
白发方四	皮肤	治白发
白发方三	皮肤	治白发
白发方五	皮肤	治白发
治疗白发的偏方20	皮肤	治白发
白发方六	皮肤	治白发
治疗白发的偏方17	皮肤	治白发
治疗白发的偏方33	皮肤	治白发
治疗白发的偏方21	皮肤	治白发
治疗白发的偏方22	皮肤	治白发
治疗白发的偏方25	皮肤	治白发
治疗白发的偏方31	皮肤	治白发
白发方七	皮肤	治白发
白发方九	皮肤	治白发
白发方二十一	皮肤	治白发
白发方十	皮肤	治白发
治疗白发的偏方26	皮肤	治白发
白发方八	皮肤	治白发
白发方十一	皮肤	治白发
白发方十二	皮肤	治白发
白发方十四	皮肤	治白发
白发方二十五	皮肤	治白发
治疗白发的偏方23	皮肤	治白发
治疗白发的偏方24	皮肤	治白发
白发方二十六	皮肤	治白发
治疗白发的偏方27	皮肤	治白发
治疗白发的偏方29	皮肤	治白发
白发方二十三	皮肤	治白发
白发方二十四	皮肤	治白发
白发方二十七	皮肤	治白发
治疗白发的偏方1	皮肤	治白发
中医治疗白发	皮肤	治白发
治疗白发的偏方2	皮肤	治白发
治疗白发的偏方28	皮肤	治白发
治疗白发的偏方30	皮肤	治白发
治疗白发的偏方3	皮肤	治白发
五加皮酒治脚气	皮肤	其他类
皮肤瘙痒	皮肤	其他类
牛皮癣、头癣、顽癣	皮肤	其他类
各种皮炎	皮肤	其他类
疥疮、恶疮、无名疮	皮肤	其他类
湿疹	皮肤	其他类
蛇胆疮	皮肤	其他类
汗斑癣	皮肤	其他类
扁平疣	皮肤	其他类
白癜风	皮肤	其他类
风疹块、痱子	皮肤	其他类
脚气、手气	皮肤	其他类
手、足多汗	皮肤	其他类
手足开裂	皮肤	其他类
鹅掌风、灰指甲	皮肤	其他类
疔、疖、痈	皮肤	其他类
鸡眼、瘊子	皮肤	其他类
蚊虫咬伤	皮肤	其他类
治疗红眼病有偏方	五官	眼病类
视网膜色素变性中药方剂	五官	眼病类
眼角膜溃疡中药方剂	五官	眼病类
眼前房出血中药方剂	五官	眼病类
五倍子治倒睫毛	五官	眼病类
眼睑痉挛中药方剂	五官	眼病类
视神经萎缩中药方剂	五官	眼病类
眼球挫伤中药方剂	五官	眼病类
沙眼中药方剂	五官	眼病类
老年性白内障中药方剂	五官	眼病类
绿豆皮眼病有药医	五官	眼病类
慢性单纯性青光眼中药方剂	五官	眼病类
泪囊炎中药方剂	五官	眼病类
急性中心性视网膜炎中药方剂	五官	眼病类
红色盲中药方剂	五官	眼病类
眼病方	五官	眼病类
明目方十四	五官	眼病类
风眼后白晴赤色偏方	五官	眼病类
麦粒肿四	五官	眼病类
烧伤眼睛的偏方	五官	眼病类
麦粒肿五黄连乳汁方	五官	眼病类
麦粒肿三针眼消毒方	五官	眼病类
急性结膜炎中药方剂	五官	眼病类
麦粒肿偏方	五官	眼病类
眼睑下垂中药方剂	五官	眼病类
枸杞子酒治老年白内障	五官	眼病类
眼损伤后出血中药方剂	五官	眼病类
原发性青光眼中药方剂	五官	眼病类
麦粒肿方一龙胆岑连汤	五官	眼病类
麦粒肿二蒲公野菊方	五官	眼病类
早期视神经萎缩中药方剂	五官	眼病类
电光性红眼病	五官	眼病类
结膜炎	五官	眼病类
流泪眼、沙眼	五官	眼病类
视力衰退	五官	眼病类
偷针眼	五官	眼病类
白内障	五官	眼病类
青光眼	五官	眼病类
耳痛、耳鸣药方	五官	耳病类
耳病偏方1	五官	耳病类
耳病的偏方	五官	耳病类
蒲公英治中耳炎	五官	耳病类
石榴花治中耳炎	五官	耳病类
神经性耳聋中药方剂	五官	耳病类
百合散治耳鸣	五官	耳病类
耳道瘙痒可以这样治	五官	耳病类
银杏干叶治耳鸣	五官	耳病类
渗出性中耳炎中药方剂	五官	耳病类
急性中耳炎中药方剂	五官	耳病类
急性卡他性中耳炎中药方剂	五官	耳病类
急性化脓性中耳炎中药方剂	五官	耳病类
航空性中耳炎中药方剂	五官	耳病类
急性外耳道湿疹中药方剂	五官	耳病类
慢性化脓性中耳炎中药方剂	五官	耳病类
中耳炎	五官	耳病类
耳鸣、耳聋	五官	耳病类
虫入耳	五官	耳病类
过敏性鼻炎的疗法	五官	鼻病类
治副鼻窦炎外用方	五官	鼻病类
化脓性鼻窦炎中药方剂	五官	鼻病类
慢性鼻窦炎中药方剂	五官	鼻病类
萎缩性鼻炎中药方剂	五官	鼻病类
鼻炎	五官	鼻病类
止鼻流血	五官	鼻病类
治鼻流血	五官	鼻病类
柿霜治口疮	五官	口腔病
治疗鹅口疮便方	五官	口腔病
白胡椒治牙痛	五官	口腔病
西洋参片治口腔溃疡	五官	口腔病
慢性牙周炎中药方剂	五官	口腔病
牙痛偏方	五官	口腔病
急性扁桃体炎偏方	五官	口腔病
双花麦冬治声哑	五官	口腔病
治化脓性扁桃体炎	五官	口腔病
巧治声音嘶哑	五官	口腔病
白喉小偏方	五官	口腔病
慢性咽炎中药方剂	五官	口腔病
急性咽喉炎中药方剂	五官	口腔病
慢性单纯性咽炎中药方剂	五官	口腔病
溃疡性咽峡炎中药方剂	五官	口腔病
急性咽炎中药方剂	五官	口腔病
急性喉炎中药方剂	五官	口腔病
慢性咽喉炎中药方剂	五官	口腔病
慢性扁桃体炎中药方剂	五官	口腔病
急性扁桃体炎中药秘方	五官	口腔病
化脓性扁桃体炎中药方剂	五官	口腔病
急性化脓性扁桃体炎中药方剂	五官	口腔病
扁桃腺炎验方	五官	口腔病
核桃树根治牙龈肿痛	五官	口腔病
过敏性唇炎中药方剂	五官	口腔病
牙齿松动方	五官	口腔病
牙痛中药方剂	五官	口腔病
牙髓炎中药方剂	五官	口腔病
急性牙槽感染中药方剂	五官	口腔病
慢性唇炎中药方剂	五官	口腔病
牙槽脓肿中药方剂	五官	口腔病
牙病方	五官	口腔病
溃疡性口腔炎中药方剂	五官	口腔病
牙齿松动方	五官	口腔病
洁齿方十三	五官	口腔病
民间方治疗牙痛	五官	口腔病
口腔溃疡中药方剂	五官	口腔病
含蒜按摩治牙龈肿	五官	口腔病
花椒白酒液治压疼	五官	口腔病
丁香粉速治牙疼	五官	口腔病
西瓜汁治口腔炎	五官	口腔病
神经性牙痛	五官	口腔病
风火牙痛	五官	口腔病
牙周炎、牙龈炎	五官	口腔病
牙出血	五官	口腔病
口疮	五官	口腔病
音哑、咽喉炎	五官	口腔病
扁桃体炎	五官	口腔病
口臭	五官	口腔病
月经量过少的治疗方法	妇科	月经病
月经过多各种治疗方法	妇科	月经病
经期延长治疗方法四则	妇科	月经病
痛经常用有效治疗方法	妇科	月经病
经间期出血的治疗方法	妇科	月经病
月经崩漏各种治疗方法	妇科	月经病
闭经常用有效治疗偏方	妇科	月经病
月经病方十一	妇科	月经病
月经病方十三	妇科	月经病
月经病方十	妇科	月经病
月经病方十二	妇科	月经病
月经病方十四	妇科	月经病
经期饮食自疗法	妇科	月经病
月经期验方自疗法	妇科	月经病
月经病方十五	妇科	月经病
月经期成药自疗法	妇科	月经病
月经病的各种治疗方法	妇科	月经病
月经不调小验方	妇科	月经病
血崩小验方	妇科	月经病
闭经小验方2	妇科	月经病
痛经小验方2	妇科	月经病
红糖白酒治痛经	妇科	月经病
月经先期小验方	妇科	月经病
崩漏小验方	妇科	月经病
功能性子宫出血秘方	妇科	月经病
月经过多小验方	妇科	月经病
更年期功能失调性子宫出血病方三	妇科	月经病
闭经小验方	妇科	月经病
更年期功能失调性子宫出血病方四	妇科	月经病
更年期功能失调性子宫出血病方二	妇科	月经病
阴痒小验方	妇科	杂症类
更年期功能失调性子宫出血病方一	妇科	月经病
痛经小验方	妇科	月经病
治疗痛经单方	妇科	月经病
民间方治疗崩漏	妇科	月经病
月经先后无定期小验方	妇科	月经病
月经过少小验方	妇科	月经病
月经后期小验方	妇科	月经病
经行呕吐中药方剂	妇科	月经病
绝经过早中药方剂	妇科	月经病
治妇女经血不止	妇科	月经病
妇女痛经中药方剂	妇科	月经病
月经过多中药方剂	妇科	月经病
排卵期子宫出血方三温经三棱煎	妇科	月经病
月经不调中药方剂	妇科	月经病
月经病方二	妇科	月经病
排卵期子宫出血方二补肾清热方	妇科	月经病
月经病方三	妇科	月经病
月经病方五	妇科	月经病
排卵期子宫出血方一杨氏调冲汤	妇科	月经病
月经先期中药方剂	妇科	月经病
经前期综合征-四组方	妇科	月经病
月经病方九	妇科	月经病
月经后期中药方剂	妇科	月经病
经前期综合征-经前癫狂汤	妇科	月经病
经前期综合征方-妇宁方	妇科	月经病
月经期为何两眼发红	妇科	月经病
经前期综合征方-柴黄汤	妇科	月经病
经前期综合征方一唐氏疏解方	妇科	月经病
经行泄泻中药方剂	妇科	月经病
月经病方四	妇科	月经病
经行身痛中药方剂	妇科	月经病
经行发热中药方剂	妇科	月经病
如何摆脱痛经困扰	妇科	月经病
经期延长中药方剂	妇科	月经病
宫外孕中药方剂	妇科	妊娠病
经期水肿中药方剂	妇科	月经病
妇科闭经中药方剂	妇科	月经病
月经病方八	妇科	月经病
倒经的偏验方	妇科	月经病
倒经治疗偏验方	妇科	月经病
痛经方	妇科	月经病
女性倒经中药方剂	妇科	月经病
月经病方七	妇科	月经病
治痛经首辨虚实寒热瘀	妇科	月经病
治滴虫性阴道炎方	妇科	杂症类
带下病的偏验方	妇科	带下病
月经病方一	妇科	月经病
月经病方六	妇科	月经病
月经后期病的治疗方法	妇科	月经病
妇女赤白带中药方剂	妇科	带下病
妇女黄带中药方剂	妇科	带下病
带下病小验方	妇科	带下病
妇女崩露中药方剂	妇科	带下病
女性白带过多中药方剂	妇科	带下病
带下偏方2	妇科	带下病
带下偏方1	妇科	带下病
白果蒸鸡蛋治带下	妇科	带下病
腐皮银杏粥治带下	妇科	带下病
腐竹白果粥治带下	妇科	带下病
茯苓车前子粥治带下	妇科	带下病
白果功肉粥治带下	妇科	带下病
金樱子粥治带下	妇科	带下病
山萸肉粥治带下	妇科	带下病
白果莲肉粥治带下病	妇科	带下病
妇女白带	妇科	带下病
妊娠腹胀中药方剂	妇科	妊娠病
妊娠腹痛中药方剂	妇科	妊娠病
妊娠便秘中药方剂	妇科	妊娠病
中医治疗产褥感染有哪些方法	妇科	妊娠病
妊娠鼻出血中药方剂	妇科	妊娠病
妊娠羊水过多中药方剂	妇科	妊娠病
生姜能缓解孕妇晨吐症状	妇科	妊娠病
席汉氏综合症中药方剂	妇科	妊娠病
习惯性流产中药方剂	妇科	妊娠病
妊娠堕胎、小产、滑胎方	妇科	妊娠病
妊娠眩晕中药方剂	妇科	妊娠病
先兆流产中药秘方	妇科	妊娠病
妊娠腰痛中药方剂	妇科	妊娠病
妊娠异位中药方剂	妇科	妊娠病
妊高症的自我保健	妇科	妊娠病
妊娠心烦各种治疗方法	妇科	妊娠病
警惕妊娠肝内胆汁淤积症	妇科	妊娠病
妊娠病方五	妇科	妊娠病
妊娠心烦中药方剂	妇科	妊娠病
妊娠外感中药方剂	妇科	妊娠病
妊娠病方三	妇科	妊娠病
妊娠胃痛中药方剂	妇科	妊娠病
妊娠腹痛各种治疗秘方	妇科	妊娠病
妊娠高血压综合征治疗	妇科	妊娠病
妊娠小便不通治疗方法	妇科	妊娠病
妊娠胎漏胎动不安治疗	妇科	妊娠病
妊娠腹痛各种治疗方法	妇科	妊娠病
妊娠病方一	妇科	妊娠病
妊娠水肿中药方剂	妇科	妊娠病
妊娠痢疾中药方剂	妇科	妊娠病
妊娠呕吐中药方剂	妇科	妊娠病
妊娠水肿各种治疗方法	妇科	妊娠病
妊娠黄疸中药方剂	妇科	妊娠病
妊娠病方二	妇科	妊娠病
妊娠咳嗽中药方剂	妇科	妊娠病
妊娠恶阻各种治疗方法	妇科	妊娠病
妊娠腹泻中药方剂	妇科	妊娠病
产后断乳	妇科	产后病
产后缺乳	妇科	产后病
产后病方七	妇科	产后病
产后病方八	妇科	产后病
产后病方十四	妇科	产后病
产后血崩中药方剂	妇科	产后病
山楂治产后腹痛	妇科	产后病
产后病方十二	妇科	产后病
产后病方十三	妇科	产后病
产后外感中药方剂	妇科	产后病
产后头痛中药方剂	妇科	产后病
产后病方九	妇科	产后病
产后病方十	妇科	产后病
妇人妊娠病脉证并治第二十	妇科	产后病
妇人产后病脉证治第二十一	妇科	产后病
治疗产后腹痛偏方2	妇科	产后病
产后缺乳中药方剂	妇科	产后病
产后尿潴留中药方剂	妇科	产后病
产后惊悸中药方剂	妇科	产后病
产后腹痛中药方剂	妇科	产后病
产后祛斑的治疗	妇科	产后病
产后大便难的治疗方法	妇科	产后病
产后缺乳各种治疗方法	妇科	产后病
妇人杂病脉证并治第二十二	妇科	产后病
产后奇病妙治	妇科	产后病
产后自汗、盗汗的治疗	妇科	产后病
产后病方	妇科	产后病
产后血晕的综合治疗	妇科	产后病
治疗产后腹痛偏方1	妇科	产后病
产后烦渴中药方剂	妇科	产后病
产后发热中药方剂	妇科	产后病
产后病方一	妇科	产后病
产后病方二	妇科	产后病
产后腹痛各种治疗方法	妇科	产后病
产后病方三	妇科	产后病
产后病方五	妇科	产后病
产后排尿异常治疗方法	妇科	产后病
产后恶露不绝治疗方法	妇科	产后病
产后病方四	妇科	产后病
产后病方六	妇科	产后病
治疗不孕症的偏方25	妇科	不孕症
治疗不孕症的偏方20	妇科	不孕症
治疗不孕症的偏方19	妇科	不孕症
治疗不孕症的偏方18	妇科	不孕症
治疗不孕症的偏方17	妇科	不孕症
治疗不孕症的偏方14	妇科	不孕症
治疗不孕症的偏方16	妇科	不孕症
治疗不孕症的偏方13	妇科	不孕症
治疗不孕症的偏方9	妇科	不孕症
治疗不孕症的偏方15	妇科	不孕症
治疗不孕症的偏方12	妇科	不孕症
治疗不孕症的偏方8	妇科	不孕症
治疗不孕症的偏方7	妇科	不孕症
治疗不孕症的偏方11	妇科	不孕症
治疗女不孕的小偏方	妇科	不孕症
不孕症方九	妇科	不孕症
不孕症方十七	妇科	不孕症
不孕症方十	妇科	不孕症
不孕症方十一	妇科	不孕症
不孕症方十八	妇科	不孕症
女性不孕症中药方剂	妇科	不孕症
不孕之症验方	妇科	不孕症
不孕症的各种秘方之五	妇科	不孕症
不孕症的各种秘方之四	妇科	不孕症
不孕症方十二	妇科	不孕症
不孕症方二十一	妇科	不孕症
不孕症方十三	妇科	不孕症
不孕症的各种秘方之三	妇科	不孕症
不孕症的各种秘方之二	妇科	不孕症
不孕症的各种秘方之一	妇科	不孕症
不孕症方十四	妇科	不孕症
不孕症方十六	妇科	不孕症
不孕症方十五	妇科	不孕症
治疗不孕症的偏方3	妇科	不孕症
治疗不孕症的偏方1	妇科	不孕症
不孕症方十九	妇科	不孕症
不孕症方二十	妇科	不孕症
不孕症方二十二	妇科	不孕症
不孕症方二十三	妇科	不孕症
治疗不孕症的偏方5	妇科	不孕症
不孕症方一	妇科	不孕症
不孕症方二	妇科	不孕症
不孕症方三	妇科	不孕症
不孕症方二十四	妇科	不孕症
不孕症方四	妇科	不孕症
治疗不孕症的偏方4	妇科	不孕症
不孕症方八	妇科	不孕症
不孕症方五	妇科	不孕症
治疗不孕症的偏方2	妇科	不孕症
不孕症方六	妇科	不孕症
不孕症方七	妇科	不孕症
不孕症方二十五	妇科	不孕症
治疗不孕症的偏方23	妇科	不孕症
治疗不孕症的偏方24	妇科	不孕症
治疗不孕症的偏方21	妇科	不孕症
乳腺癌方二十九	妇科	乳腺癌
乳腺癌的临床表现	妇科	乳腺癌
乳腺癌的病因及高危因素	妇科	乳腺癌
乳腺癌的治疗方12	妇科	乳腺癌
乳腺癌的治疗方6	妇科	乳腺癌
乳腺炎、小叶增生	妇科	乳腺癌
乳腺癌方十九	妇科	乳腺癌
乳腺癌方二十一	妇科	乳腺癌
乳腺癌方九	妇科	乳腺癌
乳腺癌方十	妇科	乳腺癌
乳腺癌中药方剂	妇科	乳腺癌
乳腺癌方十一	妇科	乳腺癌
急性乳腺炎的秘方	妇科	乳腺癌
乳腺癌方十三	妇科	乳腺癌
乳腺癌方十四	妇科	乳腺癌
乳腺癌方十六	妇科	乳腺癌
崩漏治疗偏验方	妇科	带下病
乳腺癌方一	妇科	乳腺癌
乳腺癌方十二	妇科	乳腺癌
乳腺癌方十五	妇科	乳腺癌
乳腺癌方十七	妇科	乳腺癌
乳腺癌方十八	妇科	乳腺癌
乳腺癌方二十	妇科	乳腺癌
乳腺癌方二十三	妇科	乳腺癌
乳腺癌方二十二	妇科	乳腺癌
乳腺癌方二十七	妇科	乳腺癌
乳腺癌方二十四	妇科	乳腺癌
乳腺癌方二十五	妇科	乳腺癌
乳腺癌方三	妇科	乳腺癌
乳腺癌方四	妇科	乳腺癌
乳腺癌的治疗方8	妇科	乳腺癌
乳腺癌方五	妇科	乳腺癌
乳腺癌方二十六	妇科	乳腺癌
乳腺癌方二	妇科	乳腺癌
乳腺癌方六	妇科	乳腺癌
乳腺癌方七	妇科	乳腺癌
乳腺癌方八	妇科	乳腺癌
乳腺癌方二十八	妇科	乳腺癌
乳腺癌方三十	妇科	乳腺癌
乳头乳晕瘙痒意味什么	妇科	乳腺癌
哪些因素导致乳腺癌？	妇科	乳腺癌
乳腺癌的治疗方7	妇科	乳腺癌
乳腺癌的治疗方3	妇科	乳腺癌
乳头抬高或回缩意味着	妇科	乳腺癌
乳腺癌的治疗方11	妇科	乳腺癌
乳腺癌的治疗方2	妇科	乳腺癌
治疗乳腺病的偏方3	妇科	乳腺癌
治疗乳腺病的偏方4	妇科	乳腺癌
乳腺纤维瘤和不孕相关	妇科	乳腺癌
乳腺癌的治疗方1	妇科	乳腺癌
月经先后无定期的治疗	妇科	月经病
乳腺癌的治疗方9	妇科	乳腺癌
乳腺癌的治疗方10	妇科	乳腺癌
乳腺癌的治疗方5	妇科	乳腺癌
乳头溢液是怎么回事?	妇科	乳腺癌
不疼的乳房肿块要紧吗	妇科	乳腺癌
乳头痒痒需要看医生吗	妇科	乳腺癌
乳头血性溢液定是癌吗	妇科	乳腺癌
什么是乳腺纤维腺瘤？	妇科	乳腺癌
乳房红肿热痛怎么办？	妇科	乳腺癌
乳腺纤维腺瘤鉴别诊断	妇科	乳腺癌
乳腺纤维腺瘤病理表现	妇科	乳腺癌
乳腺疾病自我检测方法	妇科	乳腺癌
乳腺癌的治疗方4	妇科	乳腺癌
治疗乳腺病的偏方1	妇科	乳腺癌
乳痛症究竟是怎么回事	妇科	乳腺癌
急性乳腺炎与炎性乳癌	妇科	乳腺癌
怎样诊断乳腺纤维腺瘤	妇科	乳腺癌
乳腺纤维腺瘤临床表现	妇科	乳腺癌
副乳会不会变成乳癌?	妇科	乳腺癌
乳腺纤维腺瘤会癌变吗	妇科	乳腺癌
乳腺纤维腺瘤要手术吗	妇科	乳腺癌
乳腺病月经不调的调理	妇科	乳腺癌
乳腺纤维腺瘤治疗原则	妇科	乳腺癌
中医治疗乳腺纤维腺瘤	妇科	乳腺癌
乳腺癌的各种治疗方法	妇科	乳腺癌
治疗乳腺病的偏方2	妇科	乳腺癌
预防乳腺癌的经典食谱	妇科	乳腺癌
如何减少患乳腺癌危险	妇科	乳腺癌
导管内乳头状瘤的诊断标准	妇科	乳腺癌
什么是乳腺导管内乳头状瘤	妇科	乳腺癌
乳腺纤维瘤的临床特点	妇科	乳腺癌
哪些人易患乳腺癌？	妇科	乳腺癌
导管内乳头状瘤的临床特点	妇科	乳腺癌
哪些因素可导致乳腺癌	妇科	乳腺癌
乳腺增生以及乳腺癌	妇科	乳腺癌
宫颈癌方七	妇科	子宫癌
宫颈癌方十四	妇科	子宫癌
宫颈癌方八	妇科	子宫癌
宫颈癌方十六	妇科	子宫癌
子宫内膜异位症中药方剂	妇科	子宫癌
子宫颈癌的多种治疗方法	妇科	子宫癌
子宫颈癌各种治疗偏方五	妇科	子宫癌
子宫肌瘤中药方剂	妇科	子宫癌
宫颈癌方六	妇科	子宫癌
宫颈癌方九	妇科	子宫癌
子宫颈癌各种治疗偏方四	妇科	子宫癌
子宫颈癌各种治疗偏方三	妇科	子宫癌
治疗宫颈癌的偏方31	妇科	子宫癌
宫颈癌方十	妇科	子宫癌
宫颈癌方十二	妇科	子宫癌
治疗宫颈癌的偏方33	妇科	子宫癌
治疗宫颈癌的偏方5	妇科	子宫癌
宫颈癌方十七	妇科	子宫癌
治疗宫颈癌的偏方4	妇科	子宫癌
治疗宫颈癌的偏方2	妇科	子宫癌
治疗宫颈癌的偏方28	妇科	子宫癌
治疗宫颈癌的偏方3	妇科	子宫癌
子宫颈癌各种治疗偏方二	妇科	子宫癌
子宫颈癌各种治疗偏方一	妇科	子宫癌
治疗宫颈癌的偏方1	妇科	子宫癌
妇女子宫脱垂治疗方法	妇科	子宫癌
宫颈癌方三	妇科	子宫癌
宫颈癌方十八	妇科	子宫癌
治子宫脱垂方	妇科	子宫癌
治疗宫颈癌的偏方32	妇科	子宫癌
宫颈癌方一	妇科	子宫癌
宫颈癌方二	妇科	子宫癌
治疗宫颈癌的偏方29	妇科	子宫癌
宫颈癌方五	妇科	子宫癌
宫颈癌方四	妇科	子宫癌
治疗宫颈癌的偏方27	妇科	子宫癌
治疗宫颈癌的偏方26	妇科	子宫癌
子宫脱垂	妇科	子宫癌
子宫肌瘤	妇科	子宫癌
治疗宫颈癌的偏方25	妇科	子宫癌
治疗宫颈癌的偏方23	妇科	子宫癌
治疗宫颈癌的偏方24	妇科	子宫癌
治疗宫颈癌的偏方21	妇科	子宫癌
治疗宫颈癌的偏方19	妇科	子宫癌
治疗宫颈癌的偏方22	妇科	子宫癌
治疗宫颈癌的偏方18	妇科	子宫癌
治疗宫颈癌的偏方17	妇科	子宫癌
治疗宫颈癌的偏方16	妇科	子宫癌
治疗宫颈癌的偏方15	妇科	子宫癌
治疗宫颈癌的偏方14	妇科	子宫癌
治疗宫颈癌的偏方13	妇科	子宫癌
治疗宫颈癌的偏方12	妇科	子宫癌
治疗宫颈癌的偏方11	妇科	子宫癌
治疗宫颈癌的偏方10	妇科	子宫癌
治疗宫颈癌的偏方6	妇科	子宫癌
治疗宫颈癌的偏方9	妇科	子宫癌
治疗宫颈癌的偏方7	妇科	子宫癌
治疗宫颈癌的偏方8	妇科	子宫癌
子宫癌秘方	妇科	子宫癌
子宫内膜异位方-内异消散方	妇科	杂症类
更年期综合症中药方剂	妇科	杂症类
子宫内膜异位方-内异方	妇科	杂症类
经期杂病小验方	妇科	杂症类
子宫内膜异位方-异位汤	妇科	杂症类
外阴非典型增生中药方剂	妇科	杂症类
房事腰痛中药方剂	妇科	杂症类
妇女子宫脱垂的秘方	妇科	杂症类
输卵管卵巢炎的中医疗法	妇科	杂症类
乳腺炎偏方	妇科	乳腺癌
跟骨痛的秘方	外科	骨症类
乳房硬块验方	妇科	乳腺癌
女子性欲亢进中药方剂	妇科	杂症类
房事头痛中药方剂	妇科	杂症类
子宫脱垂中药方剂	妇科	杂症类
霉菌性阴道炎中药方剂	妇科	杂症类
盆腔瘀血综合征方复方丹参液	妇科	杂症类
盆腔结缔组织炎方四理冲汤	妇科	杂症类
盆腔结缔组织炎方五慢盆灌肠方	妇科	杂症类
盆腔结缔组织炎方二盆腔解毒汤	妇科	杂症类
妇科阴道炎中药方剂	妇科	杂症类
非特异性阴道炎中药方剂	妇科	杂症类
阴道松驰中药方剂	妇科	杂症类
盆腔结缔组织炎方三盆腔灵	妇科	杂症类
多囊孵巢综合征方二中药人工周期组方	妇科	杂症类
盆腔结缔组织炎方一三黄虎杖汤	妇科	杂症类
女子性欲低下中药方剂	妇科	杂症类
阴道干枯中药方剂	妇科	杂症类
外阴萎缩性硬化性苔藓中药方剂	妇科	杂症类
慢性盆腔炎中药方剂	妇科	杂症类
卵巢囊肿中药方剂	妇科	杂症类
女子梦交中药方剂	妇科	杂症类
妇女风湿痛秘方	妇科	杂症类
多囊孵巢综合征方一俞氏温补方	妇科	杂症类
子宫内膜异位方-克痛汤	妇科	杂症类
慢性附件炎中药方剂	妇科	杂症类
子宫内膜异位方-温宫散结方	妇科	杂症类
妇女更年期综合征秘方	妇科	杂症类
子宫内膜异位方-育肾化瘀汤	妇科	杂症类
外阴痒	妇科	杂症类
子宫出血	妇科	杂症类
膀胱炎、尿道炎	妇科	杂症类
磁石浸酒治阳痿	男科	阳痿类
按摩法治阳痿	男科	阳痿类
善攻能补――蛇床子	男科	阳痿类
中药外治阳痿数则	男科	阳痿类
阳痿的治疗偏方29	男科	阳痿类
男子阳痿中药方剂	男科	阳痿类
阳痿的偏方治方1	男科	阳痿类
阳痿的治疗偏方4	男科	阳痿类
阳痿的偏方治方3	男科	阳痿类
阳痿的偏方治方2	男科	阳痿类
阳痿的治疗偏方8	男科	阳痿类
阳痿的治疗偏方7	男科	阳痿类
阳痿的治疗偏方6	男科	阳痿类
阳痿的治疗偏方5	男科	阳痿类
阳痿的治疗偏方9	男科	阳痿类
阳痿的治疗偏方11	男科	阳痿类
阳痿的治疗偏方10	男科	阳痿类
阳痿的治疗偏方12	男科	阳痿类
阳痿的治疗偏方14	男科	阳痿类
阳痿的治疗偏方13	男科	阳痿类
阳痿的治疗偏方15	男科	阳痿类
阳痿的治疗偏方19	男科	阳痿类
阳痿的治疗偏方20	男科	阳痿类
阳痿的治疗偏方18	男科	阳痿类
阳痿的治疗偏方21	男科	阳痿类
阳痿的治疗偏方22	男科	阳痿类
阳痿的治疗偏方23	男科	阳痿类
阳痿的治疗偏方24	男科	阳痿类
阳痿的治疗偏方25	男科	阳痿类
阳痿的治疗偏方26	男科	阳痿类
阳痿的治疗偏方28	男科	阳痿类
阳痿的治疗偏方27	男科	阳痿类
韭菜籽治早泄	男科	早泄类
治疗早泄的偏方11	男科	早泄类
五蛇汤外洗治早泄	男科	早泄类
早泄的治疗偏方10	男科	早泄类
早泄的治疗偏方9	男科	早泄类
早泄中药方剂	男科	早泄类
治疗早泄的常用中成药与验方	男科	早泄类
中西医如何治疗早泄？	男科	早泄类
早泄常见有效治疗方法	男科	早泄类
早泄常用食疗方	男科	早泄类
早泄的治疗偏方5	男科	早泄类
早泄的治疗偏方1	男科	早泄类
早泄的治疗偏方2	男科	早泄类
早泄的治疗偏方3	男科	早泄类
早泄的治疗偏方4	男科	早泄类
早泄的治疗偏方6	男科	早泄类
早泄的治疗偏方8	男科	早泄类
猪腰子治遗精	男科	遗精类
治疗遗精的偏方11	男科	遗精类
治疗遗精的偏方12	男科	遗精类
治精液不液化验方	男科	遗精类
治疗遗精的偏方6	男科	遗精类
治疗遗精的偏方15	男科	遗精类
治疗遗精的偏方7	男科	遗精类
常用有效治疗遗精偏方	男科	遗精类
治疗遗精的偏方8	男科	遗精类
治疗遗精的偏方10	男科	遗精类
男子遗精中药方剂	男科	遗精类
治疗遗精的偏方9	男科	遗精类
治疗遗精的偏方13	男科	遗精类
五白散可治遗精	男科	遗精类
补肺益精话蛤蚧	药膳	
莲子鸡丁	男科	遗精类
药膳调治遗精病	男科	遗精类
治疗遗精的偏方17	男科	遗精类
治疗遗精的偏方18	男科	遗精类
治疗遗精的偏方20	男科	遗精类
治疗遗精的偏方19	男科	遗精类
治疗遗精的偏方21	男科	遗精类
治疗遗精的偏方22	男科	遗精类
治疗遗精的偏方23	男科	遗精类
虫草红枣炖甲鱼	药膳	
治疗遗精的偏方14	男科	遗精类
常吃核桃好处多	药膳	
治疗遗精的偏方16	男科	遗精类
治疗遗精的偏方1	男科	遗精类
遗精共30方	男科	遗精类
治疗遗精的偏方2	男科	遗精类
治疗遗精的偏方3	男科	遗精类
治疗遗精的偏方4	男科	遗精类
治疗遗精的偏方5	男科	遗精类
治疗遗精的偏方29	男科	遗精类
治疗遗精的偏方25	男科	遗精类
治疗遗精的偏方27	男科	遗精类
治疗遗精的偏方26	男科	遗精类
治疗遗精的偏方28	男科	遗精类
治疗遗精的偏方24	男科	遗精类
治疗遗精的偏方30	男科	遗精类
治疗遗精的偏方31	男科	遗精类
治疗遗精的偏方32	男科	遗精类
治疗遗精的偏方33	男科	遗精类
两则药膳调治遗精病	男科	遗精类
男子性功能减退	男科	壮阳类
男子性欲激素	男科	壮阳类
治疗性欲低下的偏方4	男科	壮阳类
治疗性欲低下的偏方14	男科	壮阳类
中医熏洗治疗男科病	男科	壮阳类
治疗性欲低下的偏方10	男科	壮阳类
治疗性欲低下的偏方9	男科	壮阳类
男子性欲减退中药方剂	男科	壮阳类
治疗性欲低下的偏方8	男科	壮阳类
治疗性欲低下的偏方11	男科	壮阳类
治疗性欲低下的偏方7	男科	壮阳类
治疗性欲低下的偏方12	男科	壮阳类
老年性机能低下中药方剂	男科	壮阳类
治疗肾虚药方一则	男科	壮阳类
强中中药方剂	男科	壮阳类
房事昏厥中药方剂	男科	壮阳类
男子性欲过亢中药方剂	男科	壮阳类
男子性交疼痛中药方剂	男科	壮阳类
治疗性欲低下的偏方13	男科	壮阳类
治疗性欲低下的偏方16	男科	壮阳类
治疗性欲低下的偏方15	男科	壮阳类
性功能减退的食疗方	男科	壮阳类
治疗男性性欲低下的食疗方	男科	壮阳类
男性性欲低下治疗方法	男科	壮阳类
治疗性欲低下的偏方1	男科	壮阳类
治疗性欲低下的偏方2	男科	壮阳类
治疗性欲低下的偏方3	男科	壮阳类
治疗性欲低下的偏方5	男科	壮阳类
治疗性欲低下的偏方6	男科	壮阳类
麻雀治疗男不育	男科	男不育
治疗男性不育的偏方1	男科	男不育
治疗男性不育的偏方6	男科	男不育
男性不育症方二增精散	男科	男不育
治疗男性不育的偏方8	男科	男不育
治疗男性不育的偏方2	男科	男不育
治疗男性不育的偏方18	男科	男不育
治疗男性不育的偏方3	男科	男不育
男性不育症方一补肾益精汤	男科	男不育
治无精子症	男科	男不育
治疗男性不育的偏方4	男科	男不育
治疗男性不育的偏方5	男科	男不育
男性病验方两则	男科	男不育
治精液异常方	男科	男不育
治疗男性不育的偏方7	男科	男不育
男子不育症中药方剂二	男科	男不育
男性不育中药方剂一	男科	男不育
治疗男性不育的偏方12	男科	男不育
治疗男性不育的偏方11	男科	男不育
治疗男性不育的偏方15	男科	男不育
治疗男性不育的偏方14	男科	男不育
中医如何治病男性不射精症？	男科	男不育
饮食治疗男性少精	男科	男不育
治疗男性不育的偏方16	男科	男不育
如何针灸治疗不育症	男科	男不育
中医如何治疗死精子症？	男科	男不育
男子不育方	男科	男不育
治疗男性不育的偏方17	男科	男不育
治疗男性不育的偏方10	男科	男不育
治疗男性不育的偏方19	男科	男不育
治疗男性不育的偏方9	男科	男不育
治疗男性不育的偏方13	男科	男不育
中医如何治疗无精子症	男科	男不育
中医如何治疗精液不化	男科	男不育
男子不育症的治疗方法	男科	男不育
前列腺肥大	男科	前列腺
小便混浊、乳糜尿	男科	前列腺
急性前列腺炎中药方剂	男科	前列腺
前列腺炎中药方剂	男科	前列腺
治前列腺增生方	男科	前列腺
治老年前列腺肥大一法	男科	前列腺
慢性前列腺炎中药方剂	男科	前列腺
前列腺增生中药方剂	男科	前列腺
前列腺肥大中药方剂	男科	前列腺
阴囊湿疹中药方剂	男科	阴囊病
多发性疖肿中药方剂	男科	阴囊病
过敏性阴囊水肿中药方剂	男科	阴囊病
阴囊皮炎中药方剂	男科	阴囊病
阴茎硬结症中药方剂	男科	阴囊病
阴茎癌方二十	男科	阴茎癌
阴茎癌的各种治疗方法	男科	阴茎癌
治疗阴茎癌的偏方1	男科	阴茎癌
治疗阴茎癌的偏方2	男科	阴茎癌
治疗阴茎癌的偏方3	男科	阴茎癌
治疗阴茎癌的偏方4	男科	阴茎癌
治疗阴茎癌的偏方6	男科	阴茎癌
阴茎癌方二	男科	阴茎癌
阴茎癌方四	男科	阴茎癌
阴茎癌方三	男科	阴茎癌
阴茎癌方六	男科	阴茎癌
阴茎癌方七	男科	阴茎癌
阴茎癌方八	男科	阴茎癌
阴茎癌方九	男科	阴茎癌
治疗阴茎癌的偏方7	男科	阴茎癌
治疗阴茎癌的偏方8	男科	阴茎癌
阴茎癌的气功疗法	男科	阴茎癌
阴茎癌方十	男科	阴茎癌
阴茎癌的果蔬疗法	男科	阴茎癌
阴茎癌方十二	男科	阴茎癌
阴茎癌方十三	男科	阴茎癌
阴茎癌方十一	男科	阴茎癌
阴茎癌方十四	男科	阴茎癌
阴茎癌方十五	男科	阴茎癌
阴茎癌方十六	男科	阴茎癌
阴茎癌方十七	男科	阴茎癌
阴茎癌方十九	男科	阴茎癌
阴茎癌方十八	男科	阴茎癌
小儿腹泻	儿科	消化类
小儿消化不良	儿科	消化类
小儿厌食	儿科	消化类
误食杂物	儿科	消化类
小儿腹泻中药方剂	儿科	消化类
小儿肠炎中药方剂	儿科	消化类
呕吐方十一	儿科	消化类
治呕吐方1	儿科	消化类
呕吐方十	儿科	消化类
佝偻病方七	儿科	神经类
小儿消化不良中药方剂	儿科	消化类
食欲不佳并不等于厌食	儿科	消化类
小儿厌食的原因及治疗	儿科	消化类
幼儿的秋季厌食	儿科	消化类
小儿急性黄疸性肝炎中药方剂	儿科	传染病
小儿急性黄疸肝炎中药方剂	儿科	传染病
小儿黄疸性肝炎中药方剂	儿科	传染病
小儿缺铁性贫血的治疗	儿科	神经类
婴幼儿腹泻的治疗方法	儿科	消化类
呕吐方九	儿科	消化类
厌食方九	儿科	消化类
佝偻病方十	儿科	神经类
呕吐方八	儿科	消化类
厌食方八	儿科	消化类
大山楂冲剂	儿科	消化类
佝偻病方九	儿科	神经类
苦瓜根	儿科	消化类
如何治疗佝偻病？	儿科	神经类
小儿佝偻病的治疗方法	儿科	神经类
治疗呕吐方3	儿科	消化类
单纯补钙治疗佝偻病	儿科	神经类
柞树皮能治小儿腹泻	儿科	消化类
治疗呕吐方4	儿科	消化类
治疗呕吐方2	儿科	消化类
香砂六君子汤	儿科	消化类
健脾糕片	儿科	消化类
小儿消积丸	儿科	消化类
小儿喜食片	儿科	消化类
厌食的饮食疗法	儿科	消化类
小儿厌食各种治疗方法	儿科	消化类
小儿呕吐各种治疗方法	儿科	消化类
治疗小儿厌食的偏方1	儿科	消化类
治胃痛方	儿科	消化类
治疗小儿厌食的偏方2	儿科	消化类
一贯煎	儿科	消化类
西医药治疗	儿科	消化类
香砂枳术丸	儿科	消化类
小儿呕吐的食疗有：	儿科	消化类
小儿厌食的偏方	儿科	消化类
小儿厌食的偏方2	儿科	消化类
呕吐方二	儿科	消化类
小儿厌食的偏方3	儿科	消化类
厌食方一	儿科	消化类
呕吐方一	儿科	消化类
佝偻病方二	儿科	神经类
小儿腹泻偏方3	儿科	消化类
佝偻病方一	儿科	神经类
大黄甘草散治小儿厌食	儿科	消化类
佝偻病方四	儿科	神经类
治消化不良方	儿科	消化类
呕吐方三	儿科	消化类
厌食方三	儿科	消化类
佝偻病方三	儿科	神经类
婴幼儿便秘的治疗偏方1	儿科	泌尿类
婴幼儿便秘的治疗偏方2	儿科	泌尿类
呕吐方七	儿科	消化类
小儿腹泻偏方4	儿科	消化类
小儿腹泻偏方2	儿科	消化类
呕吐方六	儿科	消化类
肥儿饼治小儿厌食	儿科	消化类
厌食方五	儿科	消化类
小儿腹泻的偏方1	儿科	消化类
山楂汤治小儿厌食	儿科	消化类
厌食方二	儿科	消化类
佝偻病方五	儿科	神经类
止吐解酒	内科	消化类
佝偻病方八	儿科	神经类
呕吐方五	儿科	消化类
小儿中毒性消化不良中药方剂	儿科	消化类
厌食方四	儿科	消化类
小儿营养不良中药方剂	儿科	消化类
呕吐方四	儿科	消化类
小儿厌食症中药方剂	儿科	消化类
小儿佝偻病的秘方	儿科	神经类
小儿积滞中药方剂	儿科	消化类
萝卜葱白汁治小儿厌食	儿科	消化类
小儿厌食的偏方4	儿科	消化类
拿什么“拯救”厌食宝宝	儿科	消化类
小儿厌食方	儿科	消化类
佝偻病方六	儿科	神经类
山药治疗小儿秋季腹泻	儿科	消化类
厌食方六	儿科	消化类
呕吐方十二	儿科	消化类
厌食方七	儿科	消化类
小儿呕吐如何食疗？	儿科	消化类
鱼刺卡喉	儿科	消化类
小儿支气管炎中药方剂	儿科	呼吸类
小儿喘息性支气管炎中药方剂	儿科	呼吸类
百日咳食疗方	儿科	呼吸类
小儿咳喘的偏方	儿科	呼吸类
百日咳方二	儿科	呼吸类
百日咳方一	儿科	呼吸类
小儿咳喘的偏方3	儿科	呼吸类
核桃治百日咳	儿科	呼吸类
鲈鱼鳃治百日咳	儿科	呼吸类
罗汉果治百日咳	儿科	呼吸类
治疗咳嗽小方	儿科	呼吸类
小儿咳喘偏方4	儿科	呼吸类
小儿咳喘的偏方2	儿科	呼吸类
百日咳方六	儿科	呼吸类
治疗百日咳偏方1	儿科	呼吸类
小儿发热的偏方4	儿科	呼吸类
蛋黄油治百日咳	儿科	呼吸类
百日咳方五	儿科	呼吸类
百日咳方三	儿科	呼吸类
百日咳方四	儿科	呼吸类
治百日咳方	儿科	呼吸类
百日咳茶	儿科	呼吸类
小儿哮喘中药方剂	儿科	呼吸类
小儿发热的偏方3	儿科	呼吸类
百日咳方八	儿科	呼吸类
百日咳方七	儿科	呼吸类
百日咳方十	儿科	呼吸类
百日咳方十二	儿科	呼吸类
百日咳方九	儿科	呼吸类
百日咳方十一	儿科	呼吸类
小儿感冒	儿科	呼吸类
小儿百日咳偏方4	儿科	呼吸类
小儿百日咳偏方5	儿科	呼吸类
百日咳小偏方	儿科	呼吸类
小儿百日咳的偏方2	儿科	呼吸类
小儿百日咳的偏方1	儿科	呼吸类
小儿百日咳的偏方3	儿科	呼吸类
麻雀治小儿百日咳	儿科	呼吸类
小儿百日咳的治疗方法	儿科	呼吸类
小儿感冒偏方	儿科	呼吸类
小儿发热的偏方2	儿科	呼吸类
小儿发热的治疗偏方	儿科	呼吸类
急性扁桃体炎中药方剂	儿科	呼吸类
小儿扁桃体炎治疗方法	儿科	呼吸类
小儿感冒的偏方4	儿科	呼吸类
小儿感冒的偏方2	儿科	呼吸类
小儿感冒的偏方	儿科	呼吸类
治疗百日咳偏方8	儿科	呼吸类
治疗百日咳偏方7	儿科	呼吸类
治疗百日咳偏方2	儿科	呼吸类
治疗百日咳偏方5	儿科	呼吸类
治疗百日咳偏方9	儿科	呼吸类
治疗百日咳偏方4	儿科	呼吸类
治疗百日咳偏方3	儿科	呼吸类
小儿肺炎秘方	儿科	呼吸类
治小儿久咳方	儿科	呼吸类
小儿急性支气管炎中药方剂	儿科	呼吸类
小儿哮喘的病因及食疗方法	儿科	呼吸类
花生茶	儿科	呼吸类
采福茶	儿科	呼吸类
黄豆芽茶	儿科	呼吸类
罗汉果茶	儿科	呼吸类
治百日咳的中药方	儿科	呼吸类
百日咳食疗方1	儿科	呼吸类
百日咳食疗方2	儿科	呼吸类
百日咳食疗方3	儿科	呼吸类
百日咳食疗方4	儿科	呼吸类
百日咳食疗方6	儿科	呼吸类
百日咳食疗方5	儿科	呼吸类
百日咳食疗方7	儿科	呼吸类
百日咳食疗方8	儿科	呼吸类
小儿黄疸的偏方3	儿科	皮肤病
水痘的偏方1	儿科	皮肤病
小儿水痘的偏方	儿科	皮肤病
小儿水痘的偏方5	儿科	皮肤病
小儿水痘的偏方2	儿科	皮肤病
婴儿湿疹外洗方	儿科	皮肤病
新生儿硬皮症中药方剂	儿科	皮肤病
小儿黄疸的偏方2	儿科	皮肤病
新生儿黄疸中药方剂	儿科	皮肤病
小儿水痘中药方剂	儿科	皮肤病
婴儿湿疹验方	儿科	皮肤病
痄腮	儿科	皮肤病
小儿黄疸的偏方	儿科	皮肤病
小儿急性肾炎中药方剂	儿科	泌尿类
小儿慢性肾炎方剂	儿科	泌尿类
治小儿遗尿方2	儿科	泌尿类
小儿遗尿各种治疗方法	儿科	泌尿类
小儿遗尿的治疗偏方	儿科	泌尿类
小儿遗尿偏方3	儿科	泌尿类
黑胡椒散治遗尿	儿科	泌尿类
小儿脱肛验方	儿科	泌尿类
治小儿龟头炎方	儿科	泌尿类
小儿遗尿简易外治法	儿科	泌尿类
治顽固性遗尿方	儿科	泌尿类
小儿肾病综合症中药方剂	儿科	泌尿类
小儿肾炎中药方剂	儿科	泌尿类
昆虫治病小方	皮肤	其他类
猪肚治小儿遗尿	儿科	泌尿类
小儿遗尿的偏方4	儿科	泌尿类
小儿遗尿偏方2	儿科	泌尿类
遗尿方剂6	儿科	泌尿类
遗尿方剂1	儿科	泌尿类
遗尿方剂5	儿科	泌尿类
遗尿方剂4	儿科	泌尿类
遗尿方剂3	儿科	泌尿类
遗尿方剂2	儿科	泌尿类
疝气	儿科	泌尿类
小儿遗尿	儿科	泌尿类
小儿疝气	儿科	泌尿类
韭菜籽治小儿遗尿	儿科	泌尿类
遗尿方剂8	儿科	泌尿类
治小儿遗尿方1	儿科	泌尿类
遗尿偏方方剂7	儿科	泌尿类
治疗遗尿的偏方2	儿科	泌尿类
鸡蛋白胡椒治小儿遗尿	儿科	泌尿类
鸡肠治小儿遗尿	儿科	泌尿类
治小儿遗尿方3	儿科	泌尿类
治疗夜啼的偏方15	儿科	神经类
治疗夜啼的偏方20	儿科	神经类
治疗夜啼的偏方19	儿科	神经类
治疗夜啼的偏方18	儿科	神经类
肋间神经痛药膳20	内科	神经类
治疗夜啼的偏方6	儿科	神经类
治疗夜啼的偏方9	儿科	神经类
治疗夜啼的偏方7	儿科	神经类
小儿惊厥中药方剂	儿科	神经类
风湿性脑病偏方	内科	神经类
小儿癫痫中药方剂	儿科	神经类
小儿夜啼的偏方2	儿科	神经类
小儿夜啼的偏方1	儿科	神经类
治疗夜啼的偏方8	儿科	神经类
小儿惊痫的治疗偏方	儿科	神经类
饮食自疗法3	儿科	神经类
治疗夜啼的偏方10	儿科	神经类
治疗夜啼的偏方11	儿科	神经类
治疗夜啼的偏方13	儿科	神经类
黄芪验方	内科	神经类
治疗夜啼的偏方1	儿科	神经类
夜啼方二	儿科	神经类
小儿惊痫的偏方2	儿科	神经类
治疗夜啼的偏方2	儿科	神经类
肋间神经痛药膳19	内科	神经类
治疗夜啼的偏方4	儿科	神经类
治疗夜啼的偏方3	儿科	神经类
肋间神经痛药膳4	内科	神经类
肋间神经痛药膳18	内科	神经类
肋间神经痛药膳16	内科	神经类
肋间神经痛药膳17	内科	神经类
夜啼方	儿科	神经类
肋间神经痛药膳15	内科	神经类
肋间神经痛药膳13	内科	神经类
饮食自疗法1	儿科	神经类
肋间神经痛药膳14	内科	神经类
验方自疗法3	儿科	神经类
饮食自疗法2	儿科	神经类
肋间神经痛药膳12	内科	神经类
肋间神经痛药膳11	内科	神经类
肋间神经痛药膳9	内科	神经类
肋间神经痛药膳10	内科	神经类
小儿多动症中药方剂	儿科	神经类
验方自疗法1	儿科	神经类
夜啼良方	儿科	神经类
外治自疗法	儿科	神经类
肋间神经痛药膳7	内科	神经类
肋间神经痛药膳5	内科	神经类
肋间神经痛药膳8	内科	神经类
肋间神经痛药膳6	内科	神经类
小儿多涎症中药方剂	儿科	神经类
治偏头痛方	内科	神经类
小儿脑积水中药方剂	儿科	神经类
小儿疝气中药方剂	儿科	神经类
饮食自疗法4	儿科	神经类
小儿舞蹈病中药方剂	儿科	神经类
治疗夜啼的偏方5	儿科	神经类
肋间神经痛药膳2	内科	神经类
夜啼	儿科	神经类
盗汗	儿科	神经类
磨牙	儿科	神经类
流口水	儿科	神经类
缺钙	儿科	神经类
小儿抽风	儿科	神经类
夜啼方八	儿科	神经类
夜啼方七	儿科	神经类
夜啼方六	儿科	神经类
夜啼方九	儿科	神经类
小儿夜啼各种治疗方法	儿科	神经类
夜啼方一	儿科	神经类
止啼汤治夜啼	儿科	神经类
夜啼方系列	儿科	神经类
治疗夜啼的偏方16	儿科	神经类
治疗夜啼的偏方21	儿科	神经类
大黄甘草散治小儿夜啼	儿科	神经类
治疗夜啼的偏方17	儿科	神经类
夜啼方五	儿科	神经类
夜啼方三	儿科	神经类
夜啼方四	儿科	神经类
治疗夜啼的偏方14	儿科	神经类
治神经衰弱方	儿科	神经类
肋间神经痛药膳3	内科	神经类
打蛔虫	儿科	寄生虫
蛲虫	儿科	寄生虫
小儿蛔虫病中药方剂	儿科	寄生虫
治小儿蛲虫偏方4	儿科	寄生虫
治小儿蛲虫偏方5	儿科	寄生虫
治小儿蛲虫偏方2	儿科	寄生虫
治小儿蛲虫偏方3	儿科	寄生虫
小儿蛲虫病中药方剂	儿科	寄生虫
小儿蛲虫各种治疗方法	儿科	寄生虫
小儿蛔虫治疗偏方4	儿科	寄生虫
驱虫治疗	儿科	寄生虫
小儿蛔虫治疗偏方5	儿科	寄生虫
小儿蛔虫治疗偏方6	儿科	寄生虫
蛔虫方三	儿科	寄生虫
蛔虫方五	儿科	寄生虫
蛔虫方一	儿科	寄生虫
小儿蛔虫治疗偏方7	儿科	寄生虫
胆道蛔虫病治疗	儿科	寄生虫
生使君子方	儿科	寄生虫
苦楝根白皮方	儿科	寄生虫
蛔虫方二	儿科	寄生虫
蛔虫方七	儿科	寄生虫
蛔虫方四	儿科	寄生虫
蛔虫方六	儿科	寄生虫
化虫除梗汤	儿科	寄生虫
囊虫散	儿科	寄生虫
驱虫止泻方	儿科	寄生虫
治疗胆道蛔虫偏方1	儿科	寄生虫
常用中成药	儿科	寄生虫
治疗胆道蛔虫偏方3	儿科	寄生虫
常用西药	儿科	寄生虫
治疗胆道蛔虫偏方2	儿科	寄生虫
治疗胆道蛔虫偏方4	儿科	寄生虫
治疗胆道蛔虫偏方5	儿科	寄生虫
治小儿蛲虫偏方1	儿科	寄生虫
如何治疗蛔虫病	儿科	寄生虫
驱蛔虫方	儿科	寄生虫
小儿蛔虫治疗偏方1	儿科	寄生虫
小儿蛔虫治疗偏方2	儿科	寄生虫
驱虫验方	儿科	寄生虫
小儿蛔虫各种治疗方法	儿科	寄生虫
小儿蛔虫治疗偏方3	儿科	寄生虫
香油蒜泥治蛲虫	儿科	寄生虫
小儿蛔虫性肠梗阻中药方剂	儿科	寄生虫
孩子得了猩红热的治疗	儿科	传染病
百日咳	儿科	传染病
肺炎、咳嗽	儿科	传染病
流行性腮腺炎小偏方	儿科	传染病
流行性腮腺炎中药方剂	儿科	传染病
腮腺炎的偏方	儿科	传染病
腮腺炎的偏方2	儿科	传染病
腮腺炎偏方	儿科	传染病
流行性脑膜炎小偏方	儿科	传染病
内服外敷治腮腺炎	儿科	传染病
小儿猩红热中药方剂	儿科	传染病
小儿夏季热的治疗方法	儿科	传染病
小儿口疮中药方剂	儿科	口腔病
黄瓜霜治口疮	儿科	口腔病
云南白药治复发性口疮	儿科	口腔病
泻心饮	儿科	口腔病
口疮验方	儿科	口腔病
口疮的自治疗法	儿科	口腔病
小儿口疮的分型食疗	儿科	口腔病
口疮方四	五官	口腔病
口疮方五	五官	口腔病
口疮方一	五官	口腔病
温中除火汤	儿科	口腔病
清胃泻火汤	儿科	口腔病
口疮方二	五官	口腔病
复方连术汤	儿科	口腔病
口疮方三	五官	口腔病
口疮方六	五官	口腔病
口疮方七	五官	口腔病
养阴清热汤	儿科	口腔病
牛黄珍珠散	儿科	口腔病
玉竹封髓丹	儿科	口腔病
小儿口疮各种治疗方法	儿科	口腔病
蔡氏溃疡散	儿科	口腔病
白矾治口腔溃疡	儿科	口腔病
治疗小儿口腔溃疡	儿科	口腔病
红糖治鹅口疮	儿科	口腔病
口疮偏方	五官	口腔病
鸡内金治口疮	儿科	口腔病
清化散	儿科	口腔病
口疮方八	五官	口腔病
治疗小儿口疮的偏方3	儿科	口腔病
甘露饮	儿科	口腔病
口疮治疗系列	儿科	口腔病
口疮方十	五官	口腔病
新加三才封髓汤	儿科	口腔病
口疮方九	五官	口腔病
治疗小儿口疮的偏方2	儿科	口腔病
治疗小儿口疮的偏方1	儿科	口腔病
口腔溃疡简方14则	儿科	口腔病
大脑需要葡萄糖	保健	安神健脑
常吃大蒜健脑益智	保健	安神健脑
美专家推荐十种健脑食品	保健	安神健脑
哪些人容易发生中风	保健	安神健脑
健脑之道	保健	安神健脑
瑶池金母菜单之夏季	保健	安神健脑
不良习惯使大脑迟钝	保健	安神健脑
别让流脑流行	保健	安神健脑
按摩健脑小方法	保健	安神健脑
给职业女性大脑“加加油”	保健	安神健脑
坚决抵抗大脑死机	保健	安神健脑
保护你的大脑	保健	安神健脑
什么是“脑萎缩――痴呆”	保健	安神健脑
成人脑细胞能再生	保健	安神健脑
生姜有利大脑发育	保健	安神健脑
用脑也需讲卫生	保健	安神健脑
益脑保健法	保健	安神健脑
防脑衰要点	保健	安神健脑
运动手指有利健脑	保健	安神健脑
脑动脉硬化的早期信号	保健	安神健脑
减缓大脑退化有方法	保健	安神健脑
简简单单消除大脑疲劳	保健	安神健脑
10个方法让你的大脑更灵光	保健	安神健脑
有损大脑的十大不良习惯	保健	安神健脑
健脑莫过于运动（运动健康）	保健	安神健脑
对付失眠的办法	保健	安神健脑
莫把流脑当感冒	保健	安神健脑
冬春季节流脑多发辨清症状严防疾病入侵	保健	安神健脑
动脑多吃葱和蒜	保健	安神健脑
安神助眠方10	保健	安神健脑
常用的安神助眠方	保健	安神健脑
良药苦口话黄连	保健	安神健脑
安神助眠方7	保健	安神健脑
安神助眠方6	保健	安神健脑
安神助眠方9	保健	安神健脑
安神助眠方12	保健	安神健脑
安神助眠方11	保健	安神健脑
安神助眠方8	保健	安神健脑
安神助眠方13	保健	安神健脑
安神滋补方10	保健	安神健脑
安神滋补方9	保健	安神健脑
安神滋补方8	保健	安神健脑
安神滋补方7	保健	安神健脑
安神滋补方6	保健	安神健脑
安神滋补方5	保健	安神健脑
安神滋补方4	保健	安神健脑
僵蚕和姜黄	保健	安神健脑
治补两益话黄芪	保健	安神健脑
安神滋补方3	保健	安神健脑
安神滋补方2	保健	安神健脑
安神助眠方	保健	安神健脑
绿茶	保健	安神健脑
民间常用的安神助眠方	保健	安神健脑
安神助眠方1	保健	安神健脑
养心安神白醋蛋	保健	安神健脑
安神助眠方2	保健	安神健脑
安神助眠方5	保健	安神健脑
安神助眠方3	保健	安神健脑
安神助眠方14	保健	安神健脑
安神助眠方4	保健	安神健脑
医食两用话核桃	保健	安神健脑
芙蓉出水话夏荷	保健	安神健脑
饮茶的妙处	保健	安神健脑
万年琥珀是良药	保健	安神健脑
安神补心丸	保健	安神健脑
秋季养生法	保健	安神健脑
安神药粥五方	保健	安神健脑
养血生发胶囊	保健	安神健脑
安神剂	保健	安神健脑
双瓜菜窝头	保健	健体活血
糖醋山药块	保健	健体活血
槟榔糯米粥	保健	健体活血
茯苓饼	保健	健体活血
桑椹蜜膏	保健	健体活血
胡桃龙眼鸡丁	保健	健体活血
归地烧羊肉	保健	健体活血
麦芽山楂饮	保健	健体活血
姜韭牛奶汁	保健	健体活血
双麻猪肠火锅	保健	健体活血
豆腐素蒸包	保健	健体活血
人参蜂蜜粥	保健	健体活血
养心三丝汤	保健	健体活血
五九玄胡鸭	保健	健体活血
甘蔗生姜汁	保健	健体活血
姜汁炒糯米	保健	健体活血
冬瓜肉蒸包	保健	健体活血
姜糖苏叶饮	保健	健体活血
二豆粥	保健	健体活血
白萝卜炖猪排骨	保健	健体活血
莲子奶糊	保健	健体活血
藿香	保健	健体活血
柚子皮健胃化痰	保健	健体活血
九里香	保健	健体活血
刀豆	保健	健体活血
胃痛	内科	消化类
钟乳石	保健	健体活血
补阳还五汤的配方及功用	保健	滋阴补阳
山萸肉	保健	健体活血
肉苁蓉的功效与主治等!	保健	健体活血
鹿角霜	保健	健体活血
仙灵脾	保健	健体活血
鹿肾	保健	健体活血
鹿角胶	保健	健体活血
鹿胎	保健	健体活血
鹿尾	保健	健体活血
鹿血	保健	健体活血
驴肾	保健	健体活血
雪莲花	保健	健体活血
补肾的几种常用中药	保健	健胃补肾
沙参	保健	健体活血
滋阴补阳法	保健	滋阴补阳
桑螵蛸	保健	健体活血
楮实子	保健	健体活血
海马（海龙）	保健	健体活血
左归丸	保健	健体活血
白果功肉粥	保健	健体活血
大枣	保健	健体活血
熟地黄	保健	健体活血
麦门冬	保健	健体活血
补阴方谈	保健	滋阴补阳
沙参粥	保健	健体活血
小麦粥	保健	健体活血
山茱萸粥	保健	健体活血
甘蔗粥	保健	健体活血
黄精粥	保健	健体活血
脂麻	保健	健体活血
桑甚	保健	健体活血
旱连草	保健	健体活血
别甲	保健	健体活血
枸杞	保健	健体活血
山萸肉粥	保健	健体活血
腐竹白果粥	保健	健体活血
茯苓车前子粥	保健	健体活血
白果蒸鸡蛋	保健	健体活血
腐皮银杏粥	保健	健体活血
姜枣花椒汤	保健	健体活血
刘寄奴	保健	健体活血
手、脚酸麻药方	保健	健体活血
虎仗	保健	健体活血
常用的能活血理气中药	保健	健体活血
马钱子粉	保健	健体活血
干漆	保健	健体活血
玄胡	保健	健体活血
五灵肢	保健	健体活血
三梭	保健	健体活血
羊肾馄饨	保健	健体活血
V虫	保健	健体活血
凌霄花	保健	健体活血
常用的能活血理气的偏方	保健	健体活血
糖饯红枣	保健	健体活血
双手酸痛妙方	保健	健体活血
笋烧海参	保健	健体活血
羊骨粥	保健	健体活血
红枣黑木耳汤	保健	健体活血
猪蹄汤	保健	健体活血
鸡冠花鸡蛋汤	保健	健体活血
猪骨汤	保健	健体活血
活血止血类食物	保健	健体活血
片姜黄	保健	健体活血
急性子	保健	健体活血
党参生鱼	保健	健体活血
蛋清羹	保健	健体活血
银杏养生茶、丹参茶、清馨茶	保健	健体活血
荔枝干大枣汤	保健	健体活血
黄芪鸡汁粥	保健	健体活血
健体滋补方7	保健	健体活血
健体滋补方1	保健	健体活血
健体滋补方2	保健	健体活血
健体滋补方6	保健	健体活血
健体滋补方4	保健	健体活血
桂皮山楂饮	保健	健体活血
常用增力健体方6	保健	健体活血
荷叶减肥茶	保健	健体活血
健体滋补方3	保健	健体活血
花椒粥的作用与做法还有所用的原料等!	保健	健体活血
鸡蛋壳补钙	保健	健体活血
健骨强腰方12	保健	健体活血
健骨强腰方9	保健	健体活血
夏天喝老姜汤保肠胃	保健	健体活血
常用增力健体方3	保健	健体活血
吸蒸气治声音嘶哑	保健	健体活血
风湿痛秘方	保健	健体活血
常用增力健体方2	保健	健体活血
常用的能够丰形健身方	保健	健体活血
产后腹部的健美秘诀	保健	健体活血
健骨强腰方1	保健	健体活血
健骨强腰方18	保健	健体活血
健骨强腰方2	保健	健体活血
常用增力健体方4	保健	健体活血
健骨强腰方4	保健	健体活血
健体滋补方10	保健	健体活血
健体滋补方8	保健	健体活血
健体滋补方9	保健	健体活血
捍卫免疫系统中医有妙方	保健	健体活血
健体滋补方5	保健	健体活血
健骨强腰方5	保健	健体活血
能够补脾益气的食物	保健	健体活血
健骨强腰方13	保健	健体活血
民间常用的增力健体方	保健	健体活血
能够大补元气的食物	保健	补气补血
健骨强腰方8	保健	健体活血
松鼠桂鱼	保健	健体活血
健骨强腰方11	保健	健体活血
民间常用的健骨强腰方	保健	健体活血
健骨强腰方3	保健	健体活血
健骨强腰方6	保健	健体活血
健骨强腰方14	保健	健体活血
健骨强腰方17	保健	健体活血
健骨强腰方15	保健	健体活血
健骨强腰方7	保健	健体活血
常用增力健体方5	保健	健体活血
健骨强腰方10	保健	健体活血
健骨强腰方19	保健	健体活血
常用增力健体方1	保健	健体活血
猪肠汤	保健	健胃补肾
附子粥	保健	健胃补肾
黑芝麻山药何首乌粉	保健	健胃补肾
冰糖炖香蕉	保健	健胃补肾
白木耳粥	保健	健胃补肾
茯苓大枣山药粥	保健	健胃补肾
鸭粥	保健	健胃补肾
民间常用的消食健胃药	保健	健胃补肾
乌梅粥	保健	健胃补肾
紫苏麻仁粥	保健	健胃补肾
野苋汤	保健	健胃补肾
凉拌三片	保健	健胃补肾
蜜饯山楂	保健	健胃补肾
山楂粥	保健	健胃补肾
茶叶煮粥	保健	健胃补肾
酥炸月季花	保健	健胃补肾
海带炖鲫鱼	保健	健胃补肾
黄芪鲫鱼火锅	保健	健胃补肾
参山鹌鹑汤	保健	健胃补肾
健胃粥3	保健	健胃补肾
健胃药粥类2	保健	健胃补肾
炖二宝腰花可润燥嫩肤	保健	健胃补肾
瑶池金母青果药方一	保健	补气补血
常用有补气作用的中药	保健	补气补血
补中益气汤治疗气虚发热	保健	补气补血
当参	保健	补气补血
青木香	保健	补气补血
扁豆	保健	补气补血
饴糖	保健	补气补血
枸橘	保健	补气补血
陈皮	保健	补气补血
川练子	保健	补气补血
甘松	保健	补气补血
娑罗子	保健	补气补血
八月扎	保健	补气补血
玫瑰花	保健	补气补血
太子参	保健	补气补血
党参补气生血	保健	补气补血
补气血类食谱	保健	补气补血
绿萼梅	保健	补气补血
S芪u汁粥	保健	补气补血
补气益气片	保健	补气补血
当归补血汤	保健	补气补血
民间的补血方法二	保健	补气补血
猪蹄	保健	补气补血
四季保健奇效蔬菜单之春季	保健	补气补血
四季保健奇效蔬菜单之夏季	保健	补气补血
瑶池金母菜单之秋季	保健	补气补血
大枣汤	保健	补气补血
瑶池金母青果药方二	保健	补气补血
猪骨头	保健	补气补血
土大黄	保健	补气补血
白芍和百合	保健	补气补血
人参和山药	保健	补气补血
首乌	保健	补气补血
当归方	保健	补气补血
美颜补血粥	保健	补气补血
四季保健奇效蔬菜单之冬季	保健	补气补血
四季保健奇效蔬菜单之秋季	保健	补气补血
瑶池金母青果药方九	保健	补气补血
瑶池金母菜单之冬季	保健	补气补血
蚂蟥能使人的血液通畅	保健	补气补血
补血方九	保健	补气补血
补血方八	保健	补气补血
民间的补血方法3	保健	补气补血
民间的补血方法5	保健	补气补血
民间的补血方法4	保健	补气补血
民间的补血方法	保健	补气补血
民间的补血方法6	保健	补气补血
民间的补血方法10	保健	补气补血
民间的补血方法1	保健	补气补血
补血养颜牛展汤	保健	补气补血
四物汤	保健	补气补血
常用的有补血作用中药	保健	补气补血
归脾汤	保健	补气补血
天冬红糖饮可补血悦色	保健	补气补血
枸杞牛肉方	保健	补气补血
三七蒸鸡	保健	补气补血
干蒸鹿胎	保健	补气补血
香酥参归鸡	保健	补气补血
小米花生粥	保健	补气补血
食盐炒芝麻	保健	补气补血
花生米皮煮红枣可补血	保健	补气补血
小麦饭	保健	补气补血
秋天吃藕润肺补血	保健	补气补血
民间的补血方法二十则	保健	补气补血
云片银耳汤	保健	补气补血
炒葱籽烛羊肝	保健	补气补血
炒脂麻	保健	补气补血
枸杞滑溜里脊片	保健	补气补血
枸杞桂圆炖猫	保健	补气补血
花生衣	保健	补气补血
炒芝麻盐	保健	补气补血
民间补血方法2	保健	补气补血
虾子海参	保健	补气补血
大蒜泥	保健	补气补血
波莱粥	保健	补气补血
枸杞汁大排	保健	补气补血
民间补血方法3	保健	补气补血
枸杞地黄酒	保健	补气补血
枸杞蒸蛋	保健	补气补血
民间补血方法6	保健	补气补血
民间补血方法4	保健	补气补血
民间补血方法5	保健	补气补血
民间补血方法7	保健	补气补血
民间补血方法9	保健	补气补血
民间补血方法10	保健	补气补血
民间补血方法8	保健	补气补血
一味核桃汤	保健	补气补血
补血抗衰黑大豆	保健	补气补血
民间补血方法11	保健	补气补血
民间补血方法12	保健	补气补血
定风酒	保健	补气补血
枸杞芽煎鸡蛋	保健	补气补血
九月鸡片	保健	补气补血
九月肉片	保健	补气补血
大米榛仁粥	保健	补气补血
补气养血吃党参	保健	补气补血
补气方	保健	补气补血
民间的补气方法十五则	保健	补气补血
补气药	保健	补气补血
民间常用的气血双补方	保健	补气补血
健脾方茯苓大枣山药粥	保健	补气补血
瑶池金母菜单之春季	保健	补气补血
补气方六	保健	补气补血
补气方一	保健	补气补血
补气方三	保健	补气补血
补气方四	保健	补气补血
常用有补气作用的偏方	保健	补气补血
一味薯蓣饮	保健	补气补血
人参米酒	保健	补气补血
生脉散（生脉饮）	保健	补气补血
补气方五	保健	补气补血
补气方二	保健	补气补血
人参汤	保健	补气补血
补气方八	保健	补气补血
补气方七	保健	补气补血
补气方九	保健	补气补血
补气方十	保健	补气补血
人参猪肚	保健	补气补血
补中益气汤	保健	补气补血
常见的气虚症	保健	补气补血
一醉散	保健	补气补血
白术	保健	补气补血
四君子汤	保健	补气补血
山药	保健	补气补血
人参粥	保健	补气补血
五味子	保健	补气补血
人参团鱼	保健	补气补血
补气养阴的西洋参	保健	补气补血
西洋参	保健	补气补血
春盘面	保健	补气补血
人参莲肉汤	保健	补气补血
人参果散	保健	补气补血
补虚正气粥	保健	补气补血
牛肚枳壳砂仁汤	保健	补气补血
升麻芝麻炖猪大肠	保健	补气补血
人参升麻粥	保健	补气补血
牛肚苡米汤	保健	补气补血
人参大枣粥	保健	补气补血
黄芪汽锅鸡	保健	补气补血
乌龟肉煲猪肚	保健	补气补血
补气药膳	保健	补气补血
补气方系列一	保健	补气补血
乌贼骨炖猪皮	保健	补气补血
乌贼骨炖鸡	保健	补气补血
人参胡桃饮	保健	补气补血
人参茯苓汤	保健	补气补血
人参黄芪粥	保健	补气补血
人参淮药糕	保健	补气补血
人参鸽蛋汤	保健	补气补血
人参蒸乌鸡	保健	补气补血
人参燕窝汤	保健	补气补血
人参旱莲草粥	保健	补气补血
太子乌梅饮	保健	补气补血
人参茉莉花茶	保健	补气补血
五彩野兔丝	保健	补气补血
太子参烧羊肉	保健	补气补血
牛乳粥	保健	补气补血
牛肚补胃汤	保健	补气补血
常用的有补阳作用中药	保健	滋阴补阳
常用的有补阴作用中药	保健	滋阴补阳
民间常用的抗衰防老方	保健	抗防衰老
红苋肉片增容光	保健	抗防衰老
多吃西红柿能抗衰老	保健	抗防衰老
乌发美容药膳方	保健	抗防衰老
水果护肤拼盘	保健	抗防衰老
嫩肤去皱橘皮水	保健	抗防衰老
菊花山楂茶延寿	保健	抗防衰老
莲花美容方	保健	抗防衰老
葡萄的美肤作用	保健	抗防衰老
治疗老花眼	保健	抗防衰老
白嫩肌肤莲实羹	保健	抗防衰老
食物去皱在早晚	保健	抗防衰老
滑嫩肌肤玉竹膏	保健	抗防衰老
药浴美容的机理	保健	抗防衰老
民间常用的抗衰防老方一	保健	抗防衰老
民间常用的抗衰防老方二	保健	抗防衰老
抗衰老滋补方9	保健	抗防衰老
抗衰老滋补方10	保健	抗防衰老
抗衰老滋补方8	保健	抗防衰老
抗衰老滋补方6	保健	抗防衰老
抗衰老滋补方7	保健	抗防衰老
然美肤好果汁	保健	抗防衰老
药浴养颜增神润	保健	抗防衰老
抗衰老滋补方3	保健	抗防衰老
抗衰老滋补方1	保健	抗防衰老
抗衰老滋补方2	保健	抗防衰老
抗衰老滋补方5	保健	抗防衰老
润肤抗皱妙方一例	保健	抗防衰老
抗衰老滋补方4	保健	抗防衰老
三娘秘方采飞杨	保健	抗防衰老
美容蜜膏润肌肤	保健	抗防衰老
抗衰防老方	保健	抗防衰老
抗衰防老方2	保健	抗防衰老
抗衰防老方5	保健	抗防衰老
抗衰防老方4	保健	抗防衰老
抗衰防老方6	保健	抗防衰老
抗衰防老方8	保健	抗防衰老
抗衰防老方7	保健	抗防衰老
抗衰防老方9	保健	抗防衰老
抗衰防老方10	保健	抗防衰老
抗衰防老方11	保健	抗防衰老
抗衰防老方13	保健	抗防衰老
抗衰防老方12	保健	抗防衰老
抗衰防老方16	保健	抗防衰老
抗衰防老方15	保健	抗防衰老
抗衰防老方14	保健	抗防衰老
抗衰防老方17	保健	抗防衰老
抗衰防老方18	保健	抗防衰老
抗衰防老方19	保健	抗防衰老
抗衰防老方20	保健	抗防衰老
抗衰老食谱	保健	抗防衰老
六种娱乐抗衰老	保健	抗防衰老
喝骨头汤可抗衰老	保健	抗防衰老
抗衰防老方22	保健	抗防衰老
润肤方十二	保健	美容减肥
润肤方十七	保健	美容减肥
宫廷洗面秘方	保健	美容减肥
减肥食疗秘方	保健	美容减肥
每天一杯葡萄酒	保健	美容减肥
润肤方三	保健	美容减肥
润肤方十六	保健	美容减肥
常用的润肤方2	保健	美容减肥
常用的润肤方12	保健	美容减肥
健康使用化妆品	保健	美容减肥
润肤方二	保健	美容减肥
润肤方四	保健	美容减肥
中药消脂茶	保健	美容减肥
润肤方十八	保健	美容减肥
润肤方五	保健	美容减肥
润肤方七	保健	美容减肥
健康肤色抹出来	保健	美容减肥
保湿偏方	保健	美容减肥
中药护扶	保健	美容减肥
润肤悦颜各种偏方秘方	保健	美容减肥
山楂首乌消脂茶	保健	美容减肥
警惕痘痘的帮凶	保健	美容减肥
国奇妙美容新法	保健	美容减肥
剩茶洗脚治愈足跟裂	保健	美容减肥
润肤方二十二	保健	美容减肥
润肤方二十一	保健	美容减肥
中医消瘢方	保健	美容减肥
八个简单美容养颜秘方	保健	美容减肥
药物美容	保健	美容减肥
润肤方二十	保健	美容减肥
水果美容	保健	美容减肥
鲜姜去疤痕	保健	美容减肥
美容十六忌	保健	美容减肥
使皮肤细嫩	保健	美容减肥
番茄汁美容	保健	美容减肥
防晒知识知多少	保健	美容减肥
切莫胡乱“战痘”	保健	美容减肥
秋季护肤自制面膜	保健	美容减肥
美容课堂:植物润颜时尚手册	保健	美容减肥
美容药膳	保健	美容减肥
食谱美容	保健	美容减肥
耳部美容操	保健	美容减肥
妊娠斑和妊娠纹能否消失？	保健	美容减肥
润肤方	保健	美容减肥
食盐美容	保健	美容减肥
常用的润肤方10	保健	美容减肥
中医美容方	保健	美容减肥
常用的润肤方9	保健	美容减肥
常用的润肤方8	保健	美容减肥
常用的润肤方6	保健	美容减肥
常用的润肤方7	保健	美容减肥
常用的润肤方5	保健	美容减肥
常用的润肤方3	保健	美容减肥
常用的润肤方4	保健	美容减肥
常用的润肤方1	保健	美容减肥
常用的润肤方11	保健	美容减肥
水漱法	保健	美容减肥
茶漱法	保健	美容减肥
洁齿方五	保健	美容减肥
护牙洁齿小窍门	保健	美容减肥
淡盐水	保健	美容减肥
杏仁牙膏	保健	美容减肥
美齿五法	保健	美容减肥
洁齿方四	保健	美容减肥
洁齿方三	保健	美容减肥
洁齿方二	保健	美容减肥
洁齿方一	保健	美容减肥
洁齿方七	保健	美容减肥
洁齿方六	保健	美容减肥
洁齿方八	保健	美容减肥
洁齿方九	保健	美容减肥
洁齿方十	保健	美容减肥
洁齿方十一	保健	美容减肥
常用的有效洁齿牢牙方	保健	美容减肥
洁齿方十六	保健	美容减肥
牙粉	保健	美容减肥
洁齿漱口方	保健	美容减肥
鼓漱法	保健	美容减肥
盐漱法	保健	美容减肥
防皱方十五	保健	美容减肥
抗皱方十四	保健	美容减肥
一世容颜长不老方	保健	美容减肥
抗皱方十七	保健	美容减肥
抗皱方十六	保健	美容减肥
抗皱方十三	保健	美容减肥
如花娇颜草药中来	保健	美容减肥
抗皱方十八	保健	美容减肥
男人青春永驻之－有关皱纹	保健	美容减肥
皱纹的“饮食疗法”内容	保健	美容减肥
舒展面部皮肤运动操	保健	美容减肥
抗皱方五	保健	美容减肥
抗皱方四	保健	美容减肥
抗皱驻颜民间秘方锦集	保健	美容减肥
甘麦饮可养颜	保健	美容减肥
海参粥养颜方法	保健	美容减肥
服维生素可美颜	保健	美容减肥
炖白木耳的讲究	保健	美容减肥
抗皱方七	保健	美容减肥
抗皱方三	保健	美容减肥
抗皱方八	保健	美容减肥
番薯粥养颜乌发	保健	美容减肥
佛手丸的制作	保健	美容减肥
抗皱方二	保健	美容减肥
当归生姜羊肉汤的妙用	保健	美容减肥
抗皱方十	保健	美容减肥
抗皱方十一	保健	美容减肥
抗皱方九	保健	美容减肥
地黄羊肉粥可黑发养颜	保健	美容减肥
抗皱方十二	保健	美容减肥
莱菔子粥的制法	保健	美容减肥
冰糖百合养颜妙方	保健	美容减肥
参橘汤可美容	保健	美容减肥
橙子煎美容的方法	保健	美容减肥
赤小豆内金粥可美容	保健	美容减肥
大麦、羊肉乌发养颜粉	保健	美容减肥
百合杏仁粥可抗衰老	保健	美容减肥
槟榔饮可美容	保健	美容减肥
栗子桂圆可抗衰老	保健	美容减肥
菠菜粥美容法	保健	美容减肥
百合枇杷羹可润白皮肤	保健	美容减肥
白米杏仁粥可嫩肤	保健	美容减肥
白菊羊肝汤可养血驻颜	保健	美容减肥
阿胶粥而养颜	保健	美容减肥
胖人减肥验方	保健	美容减肥
面部按摩美容技巧	保健	美容减肥
缩小眼袋美容颜	保健	美容减肥
慈禧太后美容方	保健	美容减肥
抗皱方一	保健	美容减肥
抗皱方六	保健	美容减肥
民间乌须黑发方法锦集	保健	美容减肥
生黑发方十八	保健	美容减肥
生黑发方六	保健	美容减肥
可生发茂发的一些方法	保健	美容减肥
生黑发方十七	保健	美容减肥
香发	保健	美容减肥
生黑发方十六	保健	美容减肥
简单易行的护发秘诀	保健	美容减肥
呵护秀发的3个良方	保健	美容减肥
护发的家庭秘方	保健	美容减肥
生发汤	保健	美容减肥
生黑发方五	保健	美容减肥
生黑发方四	保健	美容减肥
生黑发方十九	保健	美容减肥
生黑发方二十	保健	美容减肥
h油：给头发养分	保健	美容减肥
生黑发方二	保健	美容减肥
生黑发方三	保健	美容减肥
男人青春永驻之－有关头发	保健	美容减肥
洁发止痒各种方法锦集	保健	美容减肥
润发香发各种方法锦集	保健	美容减肥
有哪些乌法秘方？	保健	美容减肥
中医乌发方	保健	美容减肥
生黑发_头发稀疏有良方	保健	美容减肥
生黑发方一	保健	美容减肥
生黑发方八	保健	美容减肥
生黑发方七	保健	美容减肥
生黑发方九	保健	美容减肥
生黑发方十一	保健	美容减肥
生黑发方十五	保健	美容减肥
生黑发方十二	保健	美容减肥
生黑发方十	保健	美容减肥
生黑发方十三	保健	美容减肥
明目方九	保健	美容减肥
明目方十八	保健	美容减肥
临床常用的明目益睑方	保健	美容减肥
桑椹酒	保健	美容减肥
明目方十一	保健	美容减肥
明目方十六	保健	美容减肥
明目方十七	保健	美容减肥
玄参炖猪肝	保健	美容减肥
常用的明目益睑方1	保健	美容减肥
明目方五	保健	美容减肥
治疗眼疲劳验方	保健	美容减肥
当归肝可明目	保健	美容减肥
黄花菜马齿苋饮可明目	保健	美容减肥
猪肝炒胡萝卜	保健	美容减肥
明目方二十	保健	美容减肥
沙苑子白菊花茶	保健	美容减肥
明目方十九	保健	美容减肥
苦瓜泥可利肝明目	保健	美容减肥
菊花鱼丸火锅	保健	美容减肥
羊肝粥明目小妙方	保健	美容减肥
治白内障方	保健	美容减肥
杞子炖羊脑	保健	美容减肥
粳米凤头粥可明目	保健	美容减肥
明目	保健	美容减肥
炖蚌肉可润肤、明目	保健	美容减肥
常用的明目益睑方4	保健	美容减肥
明目方六	保健	美容减肥
常用的明目益睑方2	保健	美容减肥
常用的明目益睑方3	保健	美容减肥
银杞明目汤	保健	美容减肥
四补膏	保健	美容减肥
明目方四	保健	美容减肥
明目方三	保健	美容减肥
常用的明目益睑方5	保健	美容减肥
明目方二	保健	美容减肥
明目方一	保健	美容减肥
明目方七	保健	美容减肥
明目方八	保健	美容减肥
明目方十	保健	美容减肥
增白方十六	保健	美容减肥
牛乳粥增白窍门	保健	美容减肥
增白方六	保健	美容减肥
增白方二十二	保健	美容减肥
增白方二十一	保健	美容减肥
增白方二十	保健	美容减肥
芋头白米粥增白的妙法	保健	美容减肥
可增白莹面的各种方法	保健	美容减肥
皮肤美容	保健	美容减肥
增白方五	保健	美容减肥
增白方四	保健	美容减肥
增白方三	保健	美容减肥
增白方二	保健	美容减肥
三鲜汁可增白皮肤	保健	美容减肥
麦冬粥润肤法	保健	美容减肥
秫米饭可美容	保健	美容减肥
胡萝卜粥可增白	保健	美容减肥
人参胡桃煎可养颜	保健	美容减肥
山楂麦芽饮可美容	保健	美容减肥
薯蓣饮可润肤	保健	美容减肥
增白方一	保健	美容减肥
桃仁墨鱼可乌发养颜	保健	美容减肥
山莲葡萄粥美白妙法	保健	美容减肥
增白方七	保健	美容减肥
天门冬粥可润肤	保健	美容减肥
增白方八	保健	美容减肥
增白方十四	保健	美容减肥
增白方十	保健	美容减肥
增白方十一	保健	美容减肥
增白方十五	保健	美容减肥
糖卷果可美容	保健	美容减肥
增白方十九	保健	美容减肥
腽肭脐粥养颜妙法	保健	美容减肥
增白方十三	保健	美容减肥
增白方九	保健	美容减肥
沃雪汤可润肤	保健	美容减肥
增白方十八	保健	美容减肥
增白方十七	保健	美容减肥
除臭偏方11	保健	美容减肥
止汗剂（露）	保健	美容减肥
夏季去腋臭五大秘方	保健	美容减肥
体香剂	保健	美容减肥
有效除臭剂	保健	美容减肥
杏仁膏香口	保健	美容减肥
家用长效除臭剂	保健	美容减肥
除臭偏方10	保健	美容减肥
气溶胶剂型	保健	美容减肥
除臭偏方9	保健	美容减肥
除臭偏方8	保健	美容减肥
膏霜类剂型	保健	美容减肥
常用的有效香身除臭方	保健	美容减肥
洗剂	保健	美容减肥
核桃油方	保健	美容减肥
腋臭灵擦剂	保健	美容减肥
治疗口臭验方口	保健	美容减肥
备急千金治胡臭方	保健	美容减肥
除臭偏方6	保健	美容减肥
除臭偏方7	保健	美容减肥
腋臭粉	保健	美容减肥
除臭偏方2	保健	美容减肥
除臭偏方3	保健	美容减肥
洗浴除臭方	保健	美容减肥
除臭偏方1	保健	美容减肥
除臭偏方4	保健	美容减肥
其它除臭方	保健	美容减肥
除臭偏方5	保健	美容减肥
体香丸	保健	美容减肥
除臭偏方13	保健	美容减肥
除臭偏方12	保健	美容减肥
复方甲醛洗剂	保健	美容减肥
复方氮酮剂	保健	美容减肥
明矾粉治狐臭	保健	美容减肥
西红柿汁治腋臭	保健	美容减肥
萝卜治脚气	保健	美容减肥
口臭、口内发炎、破裂验方	保健	美容减肥
甲醛溶液能治脚臭	保健	美容减肥
瑶池金母青果药方六	保健	美容减肥
香草浴液香身爽体	保健	美容减肥
丁香除口臭	保健	美容减肥
泥鳅消炎治狐臭	保健	美容减肥
醋疗法治狐臭	保健	美容减肥
鲜姜汁治狐臭	保健	美容减肥
迎香穴位按摩	保健	美容减肥
健鼻合剂	保健	美容减肥
健鼻方六	保健	美容减肥
鱼脑石散（经验方）	保健	美容减肥
健鼻方2	保健	美容减肥
碧云散	保健	美容减肥
健鼻养生法	保健	美容减肥
健鼻方4	保健	美容减肥
健鼻方五	保健	美容减肥
健鼻方三	保健	美容减肥
健鼻方二	保健	美容减肥
健鼻方四	保健	美容减肥
健鼻方七	保健	美容减肥
印堂穴按摩	保健	美容减肥
健鼻方1	保健	美容减肥
气功健鼻	保健	美容减肥
鼻外按摩	保健	美容减肥
鼻内按摩	保健	美容减肥
健鼻方九	保健	美容减肥
健鼻方十二	保健	美容减肥
健鼻方八	保健	美容减肥
健鼻方十五	保健	美容减肥
常用的能够健鼻护耳方	保健	美容减肥
拥有漂亮的新鼻子	保健	美容减肥
健鼻方十一	保健	美容减肥
美容方	保健	美容减肥
清鼻合剂	保健	美容减肥
利鼻合剂	保健	美容减肥
润肤方十五	保健	美容减肥
润肤方十四	保健	美容减肥
润肤方六	保健	美容减肥
由内而外的情绪美容处方	保健	美容减肥
润肤方十九	保健	美容减肥
美肤散	保健	美容减肥
几种让你拥有国色天香的秘方	保健	美容减肥
药物美容真的美吗	保健	美容减肥
皮肤为什么要保湿	保健	美容减肥
润肤方一	保健	美容减肥
润肤方九	保健	美容减肥
润肤方八	保健	美容减肥
润肤方十一	保健	美容减肥
润肤方十	保健	美容减肥
猪毛炭粉治皮肤溃疡	保健	美容减肥
润肤方十三	保健	美容减肥
减肥秘方	保健	美容减肥
除面部皱纹	保健	美容减肥
除皮肤粗黑	保健	美容减肥
除雀斑	保健	美容减肥
除褐斑、蝴蝶斑	保健	美容减肥
除面部色素斑	保健	美容减肥
除粉刺	保健	美容减肥
除黑痣	保健	美容减肥
脱发、头屑、头痒	保健	美容减肥
鬼剃头	保健	美容减肥
头发增亮	保健	美容减肥
头发早白	保健	美容减肥
减肥	保健	美容减肥
瘦人增胖	保健	美容减肥
牙变白	保健	美容减肥
酒糟鼻	保健	美容减肥
清蒸海螺	保健	食物解毒
８种中成药治非典有效	保健	食物解毒
金银花的药用	保健	食物解毒
瑶池金母青果药方四	保健	食物解毒
瑶池金母青果药方三	保健	食物解毒
瑶池金母青果药方	保健	食物解毒
秋季宜食养肺果蔬	保健	食物解毒
珠玉二宝粥	保健	食物解毒
秋来莲藕美佳肴	保健	食物解毒
荷叶莲藕炒豆芽	保健	食物解毒
百菜不如白菜	保健	食物解毒
保健强身药膳	保健	食物解毒
野牡丹解毒消肿	保健	食物解毒
验方防治老年斑	保健	食物解毒
常用的能表发散邪的偏方	保健	食物解毒
民间常用的利水除湿的偏方	保健	食物解毒
夏季食疗药膳两款	保健	食物解毒
常用的清热解毒的中药	保健	食物解毒
马齿见	保健	食物解毒
青代	保健	食物解毒
漏芦	保健	食物解毒
豆根	保健	食物解毒
半边连	保健	食物解毒
川心连	保健	食物解毒
山慈菇	保健	食物解毒
蕃茄凤梨汁	保健	食物解毒
水牛角	保健	食物解毒
天葵子	保健	食物解毒
枸杞叶粥	保健	食物解毒
土茯苓炖猪骨	保健	食物解毒
猪脊羹	保健	食物解毒
山慈姑	保健	食物解毒
韭汁牛乳饮	保健	食物解毒
茵陈车前饮	保健	食物解毒
希望之果-芒果	保健	食物解毒
解毒不离忍冬花	保健	食物解毒
菊花炒肉片	保健	食物解毒
除湿解毒的酒炒田螺	保健	食物解毒
桑寄生麦冬蛋茶	保健	食物解毒
天花粉菊花茶	保健	食物解毒
天花粉粥	保健	食物解毒
鲤鱼“吃”豆羹	保健	食物解毒
北豆根	保健	食物解毒
糟茄	保健	食物解毒
地骨皮粥	保健	食物解毒
龙胆	保健	食物解毒
玫瑰花茶	保健	食物解毒
蛇草薏苡仁粥	保健	食物解毒
水牛角浓缩粉	保健	食物解毒
白蔹	保健	食物解毒
白鲜皮	保健	食物解毒
菊花茶	保健	食物解毒
百合红枣粥	保健	食物解毒
泥鳅粉	保健	食物解毒
解毒秘方谈	保健	食物解毒
地锦草	保健	食物解毒
赤芍	保健	食物解毒
决明子	保健	食物解毒
五味猪肚	保健	食物解毒
鲜芦根粥	保健	食物解毒
地黄蒸白鸭	保健	食物解毒
茯苓贝梨	保健	食物解毒
银耳莲蛋汤	保健	食物解毒
解毒药没有毒	保健	食物解毒
山药桂圆炖甲鱼	保健	食物解毒
玉竹粥	保健	食物解毒
海带炖豆腐	保健	食物解毒
糯米粥	保健	食物解毒
香菇西施舌	保健	食物解毒
葫芦双皮汤	保健	食物解毒
罗布麻茶	保健	食物解毒
冬瓜赤豆汤	保健	食物解毒
芹菜蜜汁	保健	食物解毒
菊花山楂茶	保健	食物解毒
柿叶速溶饮	保健	食物解毒
山楂荷叶饮	保健	食物解毒
竹笋米粥	保健	食物解毒
蜜饯百合	保健	食物解毒
银耳雪梨膏	保健	食物解毒
五神汤	保健	食物解毒
北杏炖雪梨	保健	食物解毒
仙枣赤豆粥	保健	食物解毒
无花果粥	保健	食物解毒
丝瓜花蜜饮	保健	食物解毒
笋菇肉丝	保健	食物解毒
清热解毒说银花	保健	食物解毒
米醋萝卜菜	保健	食物解毒
香薷饮	保健	食物解毒
清热解毒的鸦葱	保健	食物解毒
清热解毒酒	保健	食物解毒
地丁	保健	食物解毒
蚤休	保健	食物解毒
常用的清热解毒的秘方	保健	食物解毒
治疗小儿夏热药粥	保健	食物解毒
花生	保健	饮食宜忌
瓜豆	保健	饮食宜忌
鱼虾	保健	饮食宜忌
肝脏	保健	饮食宜忌
乌梅	保健	饮食宜忌
核桃	保健	饮食宜忌
蜂蜜	保健	饮食宜忌
葡萄	保健	饮食宜忌
香蕉	保健	饮食宜忌
苹果	保健	饮食宜忌
海带	保健	饮食宜忌
蘑菇	保健	饮食宜忌
白菜	保健	饮食宜忌
菜花	保健	饮食宜忌
鸡蛋忌糖精	保健	饮食宜忌
豆腐忌蜂蜜	保健	饮食宜忌
葱类忌蜂蜜	保健	饮食宜忌
土豆忌香蕉	保健	饮食宜忌
梨子忌开水	保健	饮食宜忌
蛇肉忌萝卜	保健	饮食宜忌
田螺忌蚕豆	保健	饮食宜忌
羊肉忌西瓜	保健	饮食宜忌
海带忌洋葱	保健	饮食宜忌
西药片忌酒	保健	饮食宜忌
猪肉忌麻花	保健	饮食宜忌
雀肉忌香蕉	保健	饮食宜忌
发芽土豆	保健	饮食宜忌
新鲜金针菜	保健	饮食宜忌
未煮熟四季豆	保健	饮食宜忌
老鸡头	保健	饮食宜忌
嫩炒猪肝	保健	饮食宜忌
皮蛋、爆米花	保健	饮食宜忌
烤焦食物	保健	饮食宜忌
烂姜	保健	饮食宜忌
生豆油	保健	饮食宜忌
久煮的水	保健	饮食宜忌
烫食	保健	饮食宜忌
生豆浆	保健	饮食宜忌
腌物	保健	饮食宜忌
烤肉串	保健	饮食宜忌
空腹柿子	保健	饮食宜忌
人造食物	保健	饮食宜忌
孕妇忌吃羊肝	保健	饮食宜忌
孕妇忌吃羊肉	保健	饮食宜忌
孕妇忌吃鸭肉	保健	饮食宜忌
孕妇忌吃雀肉	保健	饮食宜忌
孕妇忌吃螃蟹	保健	饮食宜忌
孕妇忌吃黄鳝	保健	饮食宜忌
孕妇忌吃酒类	保健	饮食宜忌
孕妇忌吃香烟	保健	饮食宜忌
孕妇忌吃驴肉	保健	饮食宜忌
记忆力差	保健	饮食宜忌
健脑益智方	保健	饮食宜忌
考场镇静方	保健	饮食宜忌
盐醋	保健	饮食宜忌
韭菜	保健	饮食宜忌
萝卜	保健	饮食宜忌
芹菜	保健	饮食宜忌
胡椒	保健	饮食宜忌
葱姜	保健	饮食宜忌
大蒜	保健	饮食宜忌
绿豆	保健	饮食宜忌
梨子	保健	饮食宜忌
红枣	保健	饮食宜忌
蕃茄	保健	饮食宜忌
蛋	保健	饮食宜忌
牛肉忌红糖	保健	饮食宜忌
黄鳝忌狗肉	保健	饮食宜忌
兔肉忌芹菜	保健	饮食宜忌
狗肉忌绿豆	保健	饮食宜忌
螃蟹忌柿子	保健	饮食宜忌
鹅肉忌鸭梨	保健	饮食宜忌
黄瓜忌生花生米	保健	饮食宜忌
甲鱼忌苋菜	保健	饮食宜忌
皮蛋忌红糖	保健	饮食宜忌
人参忌萝卜	保健	饮食宜忌
白酒忌柿子	保健	饮食宜忌
豆腐忌菠菜	保健	饮食宜忌
鸡肉忌菊花	保健	饮食宜忌
鲤鱼忌甘草	保健	饮食宜忌
羊肉忌南瓜	保健	饮食宜忌
牛肉忌栗子	保健	饮食宜忌
鸭肉忌梅子	保健	饮食宜忌
山芋忌白酒	保健	饮食宜忌
春补为孩子助长	药膳	
春季食物的忌宜	药膳	
春日暖养脾肾	药膳	
高血压的春季饮食调理	药膳	
时令食疗：清明时清补益	药膳	
固肾养生美食汤谱	药膳	
“好睡”七道汤	药膳	
健身良方美味补汤	药膳	
推荐几款冬季清润的炖汤	药膳	
职业女性对症喝汤	药膳	
冬令进补煲汤八要	药膳	
四方滋润补肺的家庭食谱	药膳	
四妙方：夏季美容药膳	药膳	
十种天然排毒美容食品	药膳	
食东补西：最益女性的墨鱼	药膳	
防小疾吃点“饭”	药膳	
七种常见水果的吃法	药膳	
风味别致的“保健饭”	药膳	
日常饭食祛病秘笈	药膳	
新鲜蔬菜也是“健康杀手”	药膳	
夏季多吃凉拌菜有讲究	药膳	
凉拌鱼腥草常吃疾病少	药膳	
防暑降温三营养粥	药膳	
究竟一天我们需要多少水果	药膳	
绞股蓝茶	药膳	
枸杞子粥	药膳	
山药炖猪肚	药膳	
土茯苓炖猪骨	药膳	
山药饼	药膳	
冬虫夏草鸡	药膳	
天花粉菊花茶	药膳	
枸杞茯苓茶	药膳	
冬瓜赤豆汤	药膳	
猪骨汤	药膳	
荔枝干大枣汤	药膳	
鸡血藤煲鸡蛋	药膳	
蛋清羹	药膳	
鸡冠花鸡蛋汤	药膳	
蛇草薏苡仁粥	药膳	
灵芝粉蒸肉饼	药膳	
珍珠米糊	药膳	
百合二仁红枣蜜	药膳	
人参鸡火锅	药膳	
莲子桂圆粥	药膳	
地黄乌鸡火锅	药膳	
拔丝蛋块	药膳	
干炸猪脑	药膳	
凉拌马齿苋	药膳	
黑木耳煲红枣	药膳	
白糖炖鱼肚	药膳	
清蒸茄子	药膳	
煮羊血	药膳	
糖饯红枣	药膳	
花生衣	药膳	
红枣黑木耳汤	药膳	
黄芪鸡汁粥	药膳	
黑芝麻山药何首乌粉	药膳	
银花饮	药膳	
葱姜豆鼓饮	药膳	
五神汤	药膳	
杷叶粥	药膳	
葱豉黄酒汤	药膳	
莱菔子粥	药膳	
蜂蜜萝卜汁	药膳	
芫荽黄豆汤	药膳	
香菇薏米饭	药膳	
仙枣赤豆粥	药膳	
人参蜂蜜粥	药膳	
党参百合粥	药膳	
罗汉果烧兔肉	药膳	
鸭粥	药膳	
附子粥	药膳	
乌梅粥	药膳	
槟榔糯米粥	药膳	
蜜饯山楂	药膳	
野苋汤	药膳	
凉拌三片	药膳	
麦芽山楂饮	药膳	
茯苓大枣山药粥	药膳	
白木耳粥	药膳	
枸杞鲫鱼火锅	药膳	
归地烧羊肉	药膳	
羊骨粥	药膳	
药膳的分类	药膳	
什么是药膳	药膳	
药膳的应用原则	药膳	
药膳的特点	药膳	
药膳食品的烹调方法	药膳	
药膳的配伍禁忌	药膳	
笋烧海参	药膳	
虫草炖胎盘	药膳	
乌发汤	药膳	
糟茄	药膳	
菊花茶	药膳	
韭菜鲫鱼汤	药膳	
酒炒田螺	药膳	
黄鳝汤	药膳	
炖银耳肉	药膳	
滋肾固齿八宝鸭	药膳	
扁豆香薷汤	药膳	
田七鸡	药膳	
砂仁粥	药膳	
鲜芦根粥	药膳	
养血止痛粥	药膳	
羊肾馄饨	药膳	
首乌煨鸡	药膳	
麦地粥	药膳	
桃叶茜根饮	药膳	
月季花汤	药膳	
芝麻红糖饮	药膳	
阿胶鸡蛋汤	药膳	
鲤鱼粥	药膳	
阿胶牛肉汤	药膳	
熘炒黄花猪腰	药膳	
火腿烧鸽蛋	药膳	
红糖姜汤	药膳	
归芪鸡	药膳	
丹参去痛酒	药膳	
何首乌山鸡	药膳	
芪烧活鱼	药膳	
芪肝汤	药膳	
黄酒煮蛋黄	药膳	
糯米酒	药膳	
海蜇	药膳	
栗子	药膳	
中医忌口有讲究	药膳	
九种食物可“杀掉”忧郁	药膳	
美食让你跟头发静电拜拜	药膳	
饮食疗法：抗击支气管炎	药膳	
进补，如何应对不良反应	药膳	
服中药该注意的小节	药膳	
食疗调治胃下垂	药膳	
专家解析最佳药膳食物	药膳	
药膳治疗鼻出血	药膳	
药膳辅治老年性白内障	药膳	
陈皮木香烧肉	药膳	
草果豆蔻煲乌骨鸡	药膳	
墨鱼鸡肉饮	药膳	
归芪鲤鱼汤	药膳	
西洋参大枣粥	药膳	
补中益气糕	药膳	
二豆粥	药膳	
糖醋山药块	药膳	
白萝卜炖猪排骨	药膳	
五九玄胡鸭	药膳	
酥炸月季花	药膳	
胡桃龙眼鸡丁	药膳	
莲子奶糊	药膳	
猪肠汤	药膳	
养心三丝汤	药膳	
参山鹌鹑汤	药膳	
黄芪鲫鱼火锅	药膳	
双麻猪肠火锅	药膳	
姜韭牛奶汁	药膳	
双瓜菜窝头	药膳	
豆腐素蒸包	药膳	
冬瓜肉蒸包	药膳	
山楂荷叶饮	药膳	
菊花山楂茶	药膳	
绿豆粥	药膳	
小米粉粥	药膳	
罗布麻茶	药膳	
天麻钩藤茶	药膳	
当归生姜羊肉汤	药膳	
槐花茶	药膳	
山楂桑椹子煎	药膳	
女贞子蜂蜜饮	药膳	
玉竹海参火锅	药膳	
杞菊决明子茶	药膳	
荷花首乌肝片	药膳	
天麻酒	药膳	
红花绿茶饮	药膳	
灵芝甜酒	药膳	
美颜补血粥	药膳	
党参田七炖鸡	药膳	
龟板胎盘膏	药膳	
鹿角胶粥	药膳	
山楂乌梅饮	药膳	
山楂核桃饮	药膳	
山药桂圆炖甲鱼	药膳	
玫瑰花茶	药膳	
枸杞麦冬炒蛋丁	药膳	
泥鳅粉	药膳	
核桃草鱼火锅	药膳	
茯苓粥	药膳	
茵陈车前饮	药膳	
赤豆鲤鱼火锅	药膳	
黑木耳炒猪肝	药膳	
鲤鱼“吃”豆羹	药膳	
虾	药膳	
豆腐	药膳	
柿子汁牛奶方治高血压	药膳	
饮茶养生四季有别	药膳	
送给女性的八款助性食谱	药膳	
脑出血病人进补药膳两款	药膳	
成年男性补肾固精食疗方	药膳	
服中药后饮食有讲究	药膳	
春初食疗治“燥毒”	药膳	
饮食“趋利避害”巧养生	药膳	
春补对郁闷易怒者很有用	药膳	
阿胶滋补用途广	药膳	
吃水果治便秘因人而异	药膳	
时令食疗：春分时祛脚气	药膳	
中医开出“败火”的药方	药膳	
韭菜拌蒲公英壮阳兼强身	药膳	
专家：强身选用哪种灵芝好？	药膳	
春天多吃大枣山药	药膳	
药粥“消灭”“红鼻子”	药膳	
当心胎盘补身越吃越“雌”	药膳	
人参洋参都是药选用进补应对证	药膳	
时令食疗：清明前后清补益	药膳	
专家推荐：鸡汤有助预防感冒	药膳	
药膳食疗：月经不顺多吃丝瓜	药膳	
苦瓜芡实羹	药膳	
苦瓜塞肉	药膳	
莲子赤豆茯苓羹	药膳	
清炖猪蹄膀	药膳	
女贞子酒	药膳	
芝麻核桃仁粉	药膳	
木瓜生姜蜂蜜粥	药膳	
辣椒炖蛇肉	药膳	
白萝卜汁	药膳	
生地螃蟹汤	药膳	
白扁豆粥	药膳	
丁香姜糖	药膳	
肉苁蓉羊肉粥	药膳	
鸽蛋百莲汤	药膳	
双鞭壮阳汤	药膳	
淮药炖猪脑	药膳	
杞子青蒿蒸甲鱼	药膳	
胡桃阿胶膏	药膳	
炖狗肉	药膳	
冰糖乳鸽燕窝羹	药膳	
莲子龙眼汤	药膳	
虾皮卷心菜馅饼	药膳	
狗肉	药膳	
鸡蛋	药膳	
鸡肉	药膳	
鲤鱼	药膳	
鲫鱼	药膳	
牛肉	药膳	
羊肉	药膳	
鸭	药膳	
猪肺	药膳	
猪蹄	药膳	
猪腰	药膳	
甲鱼	药膳	
猪肉	药膳	
猪脊骨	药膳	
羊肾	药膳	
皮蛋	药膳	
乌骨鸡	药膳	
粳米	药膳	
黑豆	药膳	
小米	药膳	
玉米	药膳	
荞麦	药膳	
雪梨	药膳	
桂圆	药膳	
西瓜	药膳	
柿子	药膳	
香蕉	药膳	
桑椹	药膳	
樱桃	药膳	
菠萝	药膳	
枇杷	药膳	
柠檬	药膳	
石榴	药膳	
葫芦粥	药膳	
葫芦双皮汤	药膳	
柿叶速溶饮	药膳	
益肾粥	药膳	
巴戟煲鸡肠	药膳	
二仙烧羊肉	药膳	
知母龙骨炖鸡	药膳	
枸杞黄精炖白鸽	药膳	
常吃甜食易长白发	药膳	
“六多六少”巧吃防病	药膳	
喝玫瑰花茶能美容吗？	药膳	
绿茶加冰糖缓解咽喉炎	药膳	
药用芦荟要小心用	药膳	
看金枝欲孽品中医文化	药膳	
茶绿加冰糖为何缓解咽喉炎	药膳	
相生相克说说怎么搭配	药膳	
爱美女孩两大天然美容法	药膳	
烧汤：三煲四炖五忌	药膳	
春天补肾壮阳食谱	药膳	
凉茶加中药随便喝行吗	药膳	
五种有益熬夜的食物	药膳	
肩关节周围炎食疗药膳	药膳	
饮食让你“性”趣盎然	药膳	
北方人吃辣小心伤眼睛	药膳	
留住女人味的饮食秘诀	药膳	
几种药酒常用制备方法	药膳	
中年多吃大豆强壮女性骨骼	药膳	
蜜蜂制品可产生变态反应	药膳	
适量饮酒防男性肾功衰退	药膳	
白胡椒温胃黑胡椒补肾	药膳	
常吃西红柿提高免疫力	药膳	
食用山楂可治肠炎	药膳	
夏季嫩肤祛斑丝瓜药膳	药膳	
新鲜未必就是安全和营养	药膳	
夏季扁豆妙用善祛暑湿	药膳	
醋饮料保健四海皆准吗？	药膳	
荷叶饭清香开胃	药膳	
宝宝开心：中药下乳回乳方	药膳	
简单药膳治疗神经衰弱	药膳	
肾炎食疗中药18妙方	药膳	
夏食香蕉西瓜苦夏无忧	药膳	
吃辣椒有理此物防衰老	药膳	
烹调得法老人能吃红烧肉	药膳	
哪些食物可防“血稠”	药膳	
女人是“食肉动物”	药膳	
枸杞为啥“强精壮体”？	药膳	
血型择食奇妙原则	药膳	
秋季支气管哮喘病进补方	药膳	
清除人体三个“垃圾场”手脸发	药膳	
药膳白带正常才性福	药膳	
清热还是药膳帮忙快	药膳	
肾虚不妨多吃点西红柿	药膳	
润发泽乌女性乌发食谱	药膳	
五款男性壮阳大补汤	药膳	
“消食壮阳”食韭菜	药膳	
吃掉你身体里的“锈”	药膳	
心血管病者的饮食调节	药膳	
拥有完美乳房食疗秘诀	药膳	
感冒各阶段的食疗方法	药膳	
服用中药留意不适感觉	药膳	
常见食物给你优质睡眠	药膳	
四种水果可以治疗秋病	药膳	
营养师推出食疗补钙方	药膳	
电脑族每天必喝四杯茶	药膳	
食栗补肾方的养生药膳	药膳	
如何能饮酒补肾两不误	药膳	
香菇的营养和药膳做法	药膳	
给你带来好睡眠的食物	药膳	
八种秋天滋润食疗汤水	药膳	
重药膳不如重营养搭配	药膳	
京煮药膳不能简单模仿	药膳	
秋季巧治燥咳的食疗方	药膳	
可养生的灵芝是香菇吗	药膳	
黄瓜和西红柿别一起吃	药膳	
秋燥用餐别忘多点蔬菜	药膳	
多吃酸味水果可以养肺	药膳	
少吃酸甜食预防近视眼	药膳	
前列腺肥大的食疗方法	药膳	
治婴幼儿感冒的食疗方	药膳	
枸杞的养生功效与食用	药膳	
芒果	药膳	
冬瓜	药膳	
生姜	药膳	
韭菜	药膳	
苦瓜	药膳	
西红柿	药膳	
胡萝卜	药膳	
萝卜	药膳	
茄子	药膳	
野苋菜	药膳	
黄花菜	药膳	
葱须	药膳	
葫芦	药膳	
菠菜	药膳	
油菜	药膳	
藕	药膳	
海带	药膳	
香菜	药膳	
海参	药膳	
木耳	药膳	
牛奶	药膳	
花生	药膳	
银耳	药膳	
荷叶	药膳	
仙人掌	药膳	
菱角粉（菱粉）	药膳	
不知食宜者不足以存生	药膳	
养生正负极：中药与糖不相容	药膳	
秋季洗手为何避免过勤过热	药膳	
秋冬防病需知“六字经”	药膳	
舒缓的音乐更有益心肺	药膳	
房室养生学的“动而少泻”	药膳	
腹式呼吸强身延龄	药膳	
秋冬养生啥最为关键	药膳	
日常起居最忌六件事	药膳	
以手代枕午睡三大危害	药膳	
简单养生：缓解秋乏十八法	药膳	
食后养生三法	药膳	
养生：别再懒，动起来！	药膳	
春暖花开养生法	药膳	
久坐不动易得哪些病	药膳	
运动可消解“春困”	药膳	
腰下垫枕好处多多	药膳	
粗粮配细粮营养更合理	药膳	
居里夫人的养生经：生活需要简单	药膳	
多吃青椒能防春困？	药膳	
犯“春困”了吗？滋阴	药膳	
睡到自然醒的七个关键	药膳	
春季养生全方位提醒	药膳	
以气养生之呼吸反盗版	药膳	
百岁寿星养生秘诀	药膳	
健康饮食八分饱	药膳	
天多变上班族要防寒保暖	药膳	
中医改良一日节律钟	药膳	
三月早春防风邪	药膳	
中医调教时尚生活	药膳	
“减口增寿”说养生	药膳	
春季养阳身心安康	药膳	
中医给睡眠摆个POSE	药膳	
养生：起夜不妨喝杯水	药膳	
百岁老人的健康生活	药膳	
解春困七大高招	药膳	
每天第1杯水怎么喝？	药膳	
少吃多动早睡觉	药膳	
以药养生不可取	药膳	
滋阴养血调理月经失调	药膳	
五法养气有益身心	药膳	
养生妙法健脾益胃	药膳	
在养生中应保持思维	药膳	
中医推出舒缓压力3秘方	药膳	
小儿疳积药粥的食疗方	药膳	
浅谈药膳调治“阳萎”	药膳	
治神经衰弱的药膳验方	药膳	
有益女性的抗衰老食物	药膳	
老年人冬季进补食疗方	药膳	
生吃圆白菜更能防发病	药膳	
七种简易汤让你睡得香	药膳	
准妈妈进补人参有讲究	药膳	
羊肉药膳好吃可别贪吃	药膳	
到底哪种男人需要进补	药膳	
冬季老年疾病食疗方案	药膳	
调理月经的十个食疗方	药膳	
关于高血脂的食疗方子	药膳	
红色食物的食疗作用！	药膳	
在家里学做滋补药膳粥	药膳	
食疗长期坚持才能有用	药膳	
少女食疗的清单及禁忌	药膳	
五种天然排毒美容食品	药膳	
汤，究竟该什么时候喝	药膳	
羊肉五汤助您“性”福	药膳	
浅谈白果的药用与食疗	药膳	
食补让女人“挺”好的	药膳	
慢性咳嗽常用食疗方	药膳	
羊肉和醋不能一起食用	药膳	
老人夜尿多食疗方	药膳	
增温御寒吃羊肉	药膳	
今年春节吃药膳	药膳	
皮肤干燥吃点芝麻	药膳	
食疗给眼睛充充电	药膳	
冬季清除燥咳食疗方	药膳	
女性养生药膳	药膳	
感冒食疗对症下“药”	药膳	
中医食疗给你好脸色	药膳	
经常“上火”者的食疗	药膳	
10道食疗助你预防高血压	药膳	
每天吃豆三钱好处多	药膳	
节后歇胃消食化滞方	药膳	
新婚男子的补肾食疗方法	药膳	
春季健脾益气的食疗方	药膳	
芹菜食疗分清种类	药膳	
食疗帮你摆脱春困缠绕	药膳	
吃野菜要挑适合自己的	药膳	
走出误区科学食用药膳	药膳	
女人贫血的经典食疗方	药膳	
药食同疗赶走春季疲乏症	药膳	
春天抗“湿”食疗方	药膳	
滋补药膳吃出美丽	药膳	
特别推荐春夏药膳好养生	药膳	
慢性支气管炎患者保健	药膳	
食疗帮你重塑热烈“性”福	药膳	
食疗清火的简单方法	药膳	
改善肤色的食疗秘方	药膳	
汤汤水水喝掉脸上小斑点	药膳	
祛湿暖胃养生汤	药膳	
养生丰胸佳品－黑木耳	药膳	
土豆的三大特殊食疗功效	药膳	
三九补一冬来年无病痛	药膳	
冬季进补药膳	药膳	
寒冬最好吃点糯米	药膳	
冬天进补别乱补！	药膳	
严冬里怎么吃	药膳	
“小寒”靓汤进补	药膳	
腊月食补强档推荐	药膳	
冬季宜吃温热性食物	药膳	
冬季喝点冬蜜	药膳	
冬令补品，你会保管吗？	药膳	
春季的合理饮食	药膳	
春日药粥	药膳	
不同药膳对待春天上火	药膳	
初春食养要有针对性	药膳	
春天该给宝宝喝什么汤	药膳	
要想脑不老就请来食疗	药膳	
茶叶的31种食疗功用	药膳	
几款降脂的保健好汤	药膳	
二十四节气夏季大暑养生	药膳	
二十四节气秋季寒露养生	药膳	
二十四节气之霜降养生篇	药膳	
二十四节气之立冬养生篇	药膳	
二十四节气之白露养生篇	药膳	
二十四节气之立秋养生篇	药膳	
二十四节气之芒种养生篇	药膳	
二十四节气之大暑养生篇	药膳	
二十四节气之处暑养生篇	药膳	
二十四节气之冬至养生篇	药膳	
二十四节气之小满养生篇	药膳	
二十四节气之谷雨养生篇	药膳	
二十四节气之惊蛰养生篇	药膳	
二十四节气之立春养生篇	药膳	
二十四节气之立夏养生篇	药膳	
二十四节气之夏至养生篇	药膳	
二十四节气之小暑养生篇	药膳	
二十四节气之小雪养生篇	药膳	
二十四节气之大寒养生篇	药膳	
人老为何睡眠也会“老”	药膳	
今天你“裸睡”了吗	药膳	
跑步：一周只需要三次	药膳	
夫妻居然同甘也共“病”	药膳	
秋季养生要“和”为贵	药膳	
夜里总是出汗怎么办？	药膳	
不同体质选择不同辣椒吃	药膳	
男人要如何避免衰老	药膳	
刷刷身提沐浴也养生	药膳	
来看看匈牙利的老人福利院	药膳	
越努力工作的人越易发胖	药膳	
上班族午餐，凑合不得	药膳	
锻炼就是随“性”所欲	药膳	
能助睡眠的8种食物	药膳	
抗衰老蔬果排行榜	药膳	
每天只需五分钟防治鼠标手	药膳	
白开水孩子最佳饮品	药膳	
白领10种危险生活方式	药膳	
口干舌燥来袭勿随意“泻火”	药膳	
华佗长寿经五禽戏	药膳	
男性白领看好了你的肚子	药膳	
运动-胖子的壮阳良方	药膳	
初秋用水果给美丽加分	药膳	
办公室挂镜子缓解视疲劳	药膳	
做菜时调味“四君子”别乱放	药膳	
善假于物与电脑和平相处	药膳	
瞧白领的这一天如何度过？	药膳	
健身忙在处暑后	药膳	
“多事之秋”咋养生？	药膳	
怎样活到100岁	药膳	
初秋为何要防中风	药膳	
酷暑之日如何运动	药膳	
医生提醒：衣袜混洗易致病	药膳	
日饮橙汁预防关节炎	药膳	
立秋后爱车也是养生	药膳	
运动不止减肥不息	药膳	
护好您的脚百病不来找	药膳	
警：老两口分住麻烦多！	药膳	
在单位喝袋泡茶注意几点！	药膳	
药食：核桃补脑又长寿	药膳	
活到百岁不是梦	药膳	
锻炼前最好吃根香蕉	药膳	
心平气和老而不衰	药膳	
想长寿要吃肉	药膳	
量体裁方预防疾病一天一勺简便易服	药膳	
不可不知饮食美容法则	药膳	
冬天更应多出去走走	药膳	
庄周“忘我”寿自长	药膳	
冬季女人养生全宝典！	药膳	
管仲康健论“食”“神”	药膳	
吃完饭最好做这三件事	药膳	
老人养生七字诀	药膳	
蒙头睡觉暖和吗	药膳	
《道德经》养生顺“自然”	药膳	
冬三月别“闻鸡起舞”	药膳	
冬季养生有“八”宜	药膳	
寒冬小心嘴歪眼斜	药膳	
睡觉时，右卧是最佳睡姿吗	药膳	
女人怕冷是怎么回事	药膳	
给阳虚怕冷者加把火	药膳	
秋季养生以“和”为贵	药膳	
“以冷制冷”益处多多	药膳	
入秋养生梨为佳	药膳	
计算机族必喝的健康饮品	药膳	
食疗让中年人拒绝发福	药膳	
鲜菜汁的健康妙饮	药膳	
玉米让你眼睛更漂亮	药膳	
怕冷老人吃点啥	药膳	
“吃走”亚健康	药膳	
给烟民的三款健肺保健汤	药膳	
让你醉酒后不痛苦的食物	药膳	
吃豆角可以补肾	药膳	
麻辣火锅水煮鱼的“清纯伴侣”	药膳	
常吃萝卜有益健康	药膳	
健康牛奶食疗十法	药膳	
食疗防脱发	药膳	
巧吃山楂祛脂降压	药膳	
患病对症吃水果	药膳	
食疗妙治“白带异常”	药膳	
妇女“功血”食疗有方	药膳	
经常“上火”饮食治疗	药膳	
食疗除口臭	药膳	
药膳润润呼吸道	药膳	
糖尿病人食疗方	药膳	
手脚发凉的食疗妙方	药膳	
豆豉：得酒治风，得蒜止血	药膳	
几款食疗药膳方治贫血	药膳	
腹泻喝点胡萝卜汤	药膳	
都市亚健康人的饮食处方	药膳	
水果妙治男性疾病	药膳	
网虫视力保健食谱	药膳	
红枣药膳治顽疾	药膳	
进补防哮喘	药膳	
专家为眼疾患者开出“食疗菜单”	药膳	
蜂蜜疗法对抗感冒	药膳	
习惯便秘食疗有效	药膳	
饮食疗法：秋冬进补	药膳	
冬季火锅吃出健康来	药膳	
初冬食疗抗感冒	药膳	
食疗妙治秋冬病	药膳	
药膳方巧治冬季小病	药膳	
素食也可“冬补”	药膳	
初冬时节儿童怎么“补”	药膳	
各类肝病的冬季食疗配方	药膳	
冬季不妨吃点寒食	药膳	
冬日里的健康饮品	药膳	
冬季进补方推荐	药膳	
冬防瘙痒常饮茶	药膳	
秋冬肿瘤患者的食养	药膳	
春日去湿汤	药膳	
烧汤：三煲、四炖、五忌	药膳	
调整饮食,吃掉“春困”	药膳	
时令食疗：惊蛰时祛湿痹	药膳	
春补对郁闷、易怒者很有用	药膳	
春吃竹笋防过敏	药膳	
春天多吃菠菜	药膳	
春季咳嗽食疗法	药膳	
春季养生	药膳	
宝宝春补5大对策	药膳	
春日养肝药膳―――生地天冬猪肝汤	药膳	
老人春季食补偏方	药膳	
春天护肝多喝粥	药膳	
饮食会为春困雪上加霜	药膳	
人工流产后饮食补养原则	药膳	
春天，当防幼儿百日咳	药膳	
“东坡肉”可健身长寿	药膳	
食疗明目方豆腐烧扁豆	药膳	
道家五荤之香菜益胃	药膳	
准妈妈药补、食补咋取舍	药膳	
孕妇吃鱼多怀孕易足月	药膳	
冬食红薯好处多多	药膳	
六类食物为你“护心”	药膳	
“老慢支”食疗方	药膳	
巧用食物治疗口腔溃疡	药膳	
防癌抗癌食疗妙方	药膳	
减少夜尿食疗方	药膳	
试用汤疗治失眠	药膳	
头发枯黄的饮食防治	药膳	
痛风病患者的食疗方	药膳	
“三高”病人宜选的膳食	药膳	
慢性胃炎的饮食疗法	药膳	
糖尿病的饮食疗法	药膳	
“中年发福”食疗来帮忙	药膳	
治老人足肿食疗方	药膳	
子宫脱垂食疗方	药膳	
流行世界的食疗八法	药膳	
冬令养肾以御寒	药膳	
冬季进补食疗方	药膳	
立冬的药膳养生	药膳	
习惯性便秘食疗方	药膳	
炖羊肉冬季最养人	药膳	
哪种男人需要补?	药膳	
男人健康菜单	药膳	
提高精子质量和数量的食疗方	药膳	
男喝牛奶女喝豆浆	药膳	
老年人饮食七项注意	药膳	
羊肉配豆腐不上火	药膳	
寒饮食可温胃	药膳	
中医中药常用的四大食补法	药膳	
今年冬至阿拉不进补	药膳	
老人节食要有度	药膳	
膳食选择男女有别	药膳	
旅行途中如何进补	药膳	
慢病患者慎吃火锅	药膳	
得了痔疮少喝咖啡可乐	药膳	
春节饮食六法则	药膳	
节后饮食巧安排	药膳	
元宵虽好吃但是莫贪食	药膳	
高血压饮食五宜五忌	药膳	
世界上流行的食疗方法	药膳	
身上长疮别吃发物	药膳	
四气五味食有学问	药膳	
春季吃花选择正确部位	药膳	
要想脑不老请用食来疗	药膳	
男子性福“气”足有药鸡	药膳	
男子性福补血类八大药鸡	药膳	
秋天除燥饮食有方	药膳	
眼有疾病切莫吃蒜	药膳	
苦瓜能治好消渴吗？	药膳	
名贵药材该如何进补?	药膳	
香蕉越熟防病效果越好	药膳	
饮食疗法：吃好菜降血脂	药膳	
食用水果七大禁忌	药膳	
啥时吃水果？何时喝汤？	药膳	
多吃萝卜少吃药	药膳	
为您推荐男人健康菜单	药膳	
流产后如何进补	药膳	
方和谦：食疗也是一种享受	药膳	
韭菜上桌如食“伟哥”	药膳	
中医内润缓解口渴	药膳	
水果、喝汤:餐前?餐后?	药膳	
除燥药膳对症“吃”	药膳	
秋季护肺要这样吃	药膳	
秋凉合理进膳防感冒	药膳	
秋补当时药补宜慎	药膳	
哪些人宜在秋冬养阴	药膳	
八月巧选豆类蔬菜	药膳	
秋季润肺银耳羹	药膳	
秋季汤谱三则	药膳	
秋季宜食养肺果蔬	药膳	
早秋话进补	药膳	
初秋进补食莲藕	药膳	
食梨防燥最宜秋	药膳	
秋天多喝蜜、少吃姜	药膳	
食粥帮你解秋燥	药膳	
靓汤水去秋燥	药膳	
注意饮食对付“秋老虎”	药膳	
入秋食疗补肾正当时	药膳	
芋艿:秋补素食一宝	药膳	
秋食柚子正当时	药膳	
今秋煲汤新“煮”意	药膳	
秋日药粥润肺燥	药膳	
秋天少吃辣多吃酸	药膳	
秋季润燥自制茶	药膳	
汤汤水水防秋燥	药膳	
金秋巧做防燥药膳	药膳	
秋季吃鱼好4类人不宜	药膳	
用天然食物轻松击退雀斑	药膳	
长痘痘者必看的饮食禁忌	药膳	
煲制秋天女人汤	药膳	
喝什么茶减什么脂肪	药膳	
食物中的滋阴养颜佳品	药膳	
呵护完美双峰的饮食法宝	药膳	
深秋滋补的美颜糖水	药膳	
自制美肤蔬果汁	药膳	
防止痘痘和粉刺的食疗法	药膳	
健脾胃补气阴，冬天女人来几味	药膳	
饮食防治黑眼圈	药膳	
女性冬令进补秘笈	药膳	
战“痘”的饮食疗法	药膳	
春季实用丰胸药膳	药膳	
瘦身套餐去肥肉	药膳	
治疗黑眼圈食疗验方	药膳	
养颜延寿苦杏仁	药膳	
秋季4类人对小鱼儿束手无策	药膳	
秋补四种素食更有效	药膳	
日本女性“解秘”食谱派送	药膳	
你会“喝”吗？	药膳	
用什么打开你的胃	药膳	
鸡汤有助预防感冒	药膳	
凉茶加中药，随便喝行吗	药膳	
补肾壮阳爱情药膳	药膳	
食疗妙招轻松祛雀斑	药膳	
乌发：永远的时尚（药膳）	药膳	
清凉祛暑药膳	药膳	
夏季腹泻家庭食疗小验方	药膳	
夏季清粥调你胃口	药膳	
夏日药粥三款	药膳	
做好夏日应暑战	药膳	
清暑食疗方	药膳	
大暑宜食老鸭汤	药膳	
靓汤一煲清暑热	药膳	
暑湿型感冒食疗方	药膳	
西瓜妙吃三法	药膳	
夏秋交替应该如何饮食	药膳	
樱桃美肤绝佳品	药膳	
凉茶防病？防不胜防	药膳	
似茶非茶的神奇虫茶	药膳	
普洱茶也是减肥茶	药膳	
明目又强肾的几种茶！	药膳	
茶虽好，宜淡品	药膳	
常用凉茶简介	药膳	
百合杷藕茶	药膳	
芥蓝吃多了影响性功能	药膳	
治女子性欲低下的药膳	药膳	
美食有助完美的性爱	药膳	
韭菜拌蒲公英，壮阳兼强身	药膳	
滋阴壮阳方：专治女性性冷淡	药膳	
男人春天该如何进补	药膳	
男人最好多吃几种食物	药膳	
夏季：莫为“清淡”误	药膳	
心脏不好少吃西瓜	药膳	
液体面包：哪种适合你？	药膳	
新鲜，未必就是安全和营养	药膳	
贪吃荔枝“妃子难笑”	药膳	
吃完鸡蛋后不要立即饮茶	药膳	
三类人做菜少放醋	药膳	
职业不同吃不同蔬菜	药膳	
为何吃豆腐最好配海带？	药膳	
蔬菜汁多喝多健康	药膳	
夏季吃鸭好处多	药膳	
变着花样吃番茄	药膳	
夏季补虚三方（食疗）	药膳	
夏季吃贝类食物小心中毒	药膳	
健康吃蟹注意七“不”	药膳	
要肺好每天两头大蒜	药膳	
喝粥调养“夏季热”	药膳	
阴气重可多吃鸡增强免疫力	药膳	
一盅两件也要吃的营养	药膳	
苦瓜拌荔枝（夏季食疗）	药膳	
食疗：十大平衡不可缺	药膳	
警惕酒后饮茶的陷井	药膳	
男人吃姜女人吃糖	药膳	
低脂膳食缓解经前乳房胀痛	药膳	
一日之“餐”在乎晨	药膳	
因人因病而异补药膳	药膳	
金秋时节话莲膳	药膳	
进补宜忌：进补话“虫草”	药膳	
有益女性的五味抗衰食物	药膳	
汤艺春秋:靓女喝靓汤	药膳	
乌发药膳两则	药膳	
春天到了多吃点野菜	药膳	
水润女人的四大打造秘诀	药膳	
绿茶多变美颜瘦身	药膳	
把肌肤吃的美美的	药膳	
细腰最佳进食方法	药膳	
日常生活中海带和粥其实最能养生	药膳	
怀孕初期的辨症用膳	药膳	
七大顺气食物要常吃	药膳	
口唇干裂吃啥好？	药膳	
女士冬日进补的关键词	药膳	
自制降脂汤	药膳	
农家有四宝秋冬进补	药膳	
药膳：白带正常才性福	药膳	
男性性福食疗秘籍十全	药膳	
试试餐桌上的“壮阳药”	药膳	
专家推荐:增加精子食疗方	药膳	
谁是七大“败性”食物	药膳	
饮食男女：多食对虾能壮阳	药膳	
爱情菜:滋阴壮阳的食品	药膳	
男性壮阳食谱海味集	药膳	
牡蛎餐男人的滋补盛宴	药膳	
食疗重塑热烈“性”福	药膳	
房事“性”福必备食谱	药膳	
男性壮阳大补汤	药膳	
药膳让女人重现性高潮	药膳	
助“性”的最佳美食	药膳	
男性的蜜月进补调理方案	药膳	
盘点燃烧男女欲火的食物	药膳	
爱情药膳锅引爆热恋火花	药膳	
女性的助性食谱	药膳	
厨房里的“天然伟哥”	药膳	
饮食壮阳法大盘点	药膳	
世界美食为您助“性”	药膳	
色“性”不足膳食补之	药膳	
有助“性福”的补充物	药膳	
菠菜豆腐汤的潜在危害	药膳	
中国五大饮食“误区＂	药膳	
骨折后要多喝骨头汤吗？	药膳	
冬令进补当心食之不益	药膳	
“药膳美食”也害人?	药膳	
药补不如食补膏方不能乱吃	药膳	
膏方不是越贵越好	药膳	
吃羊肉有禁忌	药膳	
茶叶并不是越鲜越好	药膳	
药膳要吃得明明白白	药膳	
放虫草不如多加香菇大补汤不是谁都能喝	药膳	
盲目忌口对疾病治疗不利	药膳	
冬虫夏草此时进补最好？	药膳	
中药和绿豆不一定是“冤家”	药膳	
食补养生“四季粥”（药食同源）	药膳	
四款软化血管粥	药膳	
世间第一大补品:粥	药膳	
几款滋阴补阳的养生粥	药膳	
刚感冒喝生姜大枣粥	药膳	
降脂妙招柴胡降脂粥	药膳	
滋养润喉食药粥	药膳	
巧选药粥补“四虚”	药膳	
中考高考前考生喝点粥	药膳	
养生食疗话百合	药膳	
预防奇兵：葱和蒜	药膳	
水果桑椹补肾养胃入佐餐	药膳	
板栗：每天几粒就滋补	药膳	
不同鱼的不同保健功能	药膳	
樱桃好吃亦疗疾	药膳	
黑木耳祛病的食疗良方	药膳	
花生红衣薄薄一层能补血	药膳	
春吃艾叶增食欲	药膳	
涮羊肉别喝茶（饮食禁忌）	药膳	
豆腐和菠菜不要一起吃	药膳	
感冒了光喝姜汤没有用	药膳	
苦杏仁乱吃惹事端	药膳	
“养人”食物也“伤人”	药膳	
肝癌食疗十二方	药膳	
老人尿频食疗解忧	药膳	
药膳止瘙痒消散不觉中	药膳	
粒粒山楂入药来	药膳	
核桃的食疗作用	药膳	
药膳:让您聪明不“绝顶”	药膳	
蟹黄二冬防老抗衰	药膳	
银耳鸽蛋汤补脑强身	药膳	
中医食疗保肝六款药膳	药膳	
金秋板栗健肾补脾	药膳	
保健名膳补阴阳	药膳	
五汁饮消痰降火	药膳	
蜗牛味美，须防中毒	药膳	
3种咳嗽的饮食宜忌	药膳	
五毒蔬菜要小心！	药膳	
花好月圆时此八人慎吃月饼	药膳	
1个月饼=两碗大米饭	药膳	
真的？鸡蛋生吃坏处多多	药膳	
盲目进补酿大患	药膳	
水果食用不当也患病	药膳	
食蒜当心伤害你的眼睛	药膳	
老人要正确选用滋补药	药膳	
眼疲劳也可用食疗	药膳	
知道最健康水果是哪些吗	药膳	
大蒜捣碎吃才能杀菌	药膳	
食疗觅睡方睡的香	药膳	
丝瓜能调理月经（食疗）	药膳	
痔疮出血吃点银耳粥	药膳	
菟丝子黑芝麻治老花眼	药膳	
愁长夜绵绵难入睡	药膳	
精品失眠饮食疗简单方	药膳	
清热，还得药膳帮忙快	药膳	
眼疲劳可用饮食补	药膳	
老年眼花有食疗	药膳	
就这样把神经衰弱慢慢吃掉	药膳	
疗疾茶疗七法	药膳	
电脑族该喝的茶	药膳	
绿茶配蜂蜜消炎又润喉	药膳	
介绍几款冬季茶饮	药膳	
薄荷茶特别解乏	药膳	
春茶上市，仔细挑	药膳	
茶叶的31种功用	药膳	
春茶刚上市别急着泡	药膳	
绿茶的质量鉴别	药膳	
美研究发现：适量饮酒可预防男性肾功能衰退	药膳	
如何饮酒补肾两不误	药膳	
药酒非万能，十种人忌饮	药膳	
冬季进补如何泡服药酒	药膳	
高血压病人别喝药酒	药膳	
十全大补酒	药膳	
冬饮补酒益处多	药膳	
饮用药酒应走出误区	药膳	
老人进补慎喝“药酒”	药膳	
药膳滋补面面观	药膳	
菜肴加进中药材究竟补啥	药膳	
降糖消脂是苦瓜	药膳	
夏季饮食莫落入陷阱	药膳	
喝酸梅汤都有啥好处？	药膳	
夏天最好多吃黄花鱼	药膳	
吃猕猴桃，清凉一“夏”	药膳	
针对皮肤搔痒症的中医治疗	其他	中医常识
中医辨证论治治疗皮肤过敏	其他	中医常识
中医辩证治疗抑郁症有用吗	其他	中医常识
大承气汤辨证新用验案3则	其他	中医常识
出现青紫舌意味着什么疾病	其他	中医常识
姜艾汤治女人阴痒效果极佳	其他	中医常识
为何药补越补越不见效果？	其他	中医常识
冠心病心绞痛中医辨证论治	其他	中医常识
中医辨证论治老年性白内障	其他	中医常识
古代中医对癌和瘤的认识	其他	中医常识
中医治疗急性胃扩张	其他	中医常识
关于痛风治疗中医辨证论治	其他	中医常识
中西结合治疗犬传染性肝炎	其他	中医常识
中西医结合治疗神经性皮炎	其他	中医常识
中西结合巧妙治疗眼底出血	其他	中医常识
介入疗法开辟癌症治疗新途	其他	中医常识
中西医结合治疗视网膜阻塞	其他	中医常识
中医调理西医治疗共治癌症	其他	中医常识
中西医结合综合治疗痰多症	其他	中医常识
讨论中西医药最主要的差别	其他	中医常识
中西结合治湿热型肠道感染	其他	中医常识
关于中西结合方法论的思考	其他	中医常识
中西结合法解决致命肠梗阻	其他	中医常识
提倡采用中西医结合法抗炎	其他	中医常识
中西医结合治疗糖尿病优势	其他	中医常识
中西药结合使用也存在禁区	其他	中医常识
中西医结合治疗感染性疾病	其他	中医常识
中西医结合治溃疡性结肠炎	其他	中医常识
中西医结合提高肾移植疗效	其他	中医常识
女性更年期潮热症用中西医	其他	中医常识
中西医对于肝脏概念相同吗	其他	中医常识
中西医治疗急性肠道传染病	其他	中医常识
中西医结合治艾滋病有优势	其他	中医常识
可提高肾移植的远期存活率	其他	中医常识
原发性肝癌重视中西医结合	其他	中医常识
用中西医结合法来治疗血压	其他	中医常识
葡萄膜炎的临床中西医疗法	其他	中医常识
胆囊炎、胆囊结石结合治疗	其他	中医常识
中西医结合治肾病、尿毒症	其他	中医常识
多发性硬化症的中西医治疗	其他	中医常识
中西医结合治艾滋病优于西医	其他	中医常识
围手术期用中西医降低并发症	其他	中医常识
辨治腰椎间盘突出症	其他	中医常识
中医辨治慢性口腔溃疡	其他	中医常识
中医内外综合防治白发	其他	中医常识
中医辨治高血压	其他	中医常识
什么叫崩漏中医临床分为几型	其他	中医常识
中医治疗痛经	其他	中医常识
青春期月经失调的中医辨治	其他	中医常识
中医辨证小儿遗尿	其他	中医常识
慢性咳嗽的中医防治	其他	中医常识
肺炎的中医方药治疗	其他	中医常识
中医辨证治疗肺癌	其他	中医常识
阻塞性肺气肿的中医治疗法	其他	中医常识
鼻出血的中医防治	其他	中医常识
唇色的中医辨证简析	其他	中医常识
辨证论治肝源性胃病	其他	中医常识
颈椎病的分型论治	其他	中医常识
中医辨证治疗慢性胰腺炎	其他	中医常识
舌苔厚腻是“上火”?	其他	中医常识
警惕舌苔泄露胃病“隐私”	其他	中医常识
中医药治疗骨质疏松症	其他	中医常识
观三寸之舌晓身体之疾	其他	中医常识
秋季常见病的治疗与防护	其他	中医常识
风湿性心脏病,中医辨治探析	其他	中医常识
肾虚，怎么越补越虚？	其他	中医常识
治疗“类风关”健脾是关键	其他	中医常识
孩子腹痛隐藏什么病？	其他	中医常识
中医巧治老人眩晕	其他	中医常识
哪些病适合看中医	其他	中医常识
痹证是顽疾短期难治愈	其他	中医常识
别给眼睛乱“补水”	其他	中医常识
传统医学防治肿瘤之我见	其他	中医常识
中医观汗知病	其他	中医常识
发挥中医优势根治哮喘	其他	中医常识
中医药治疗高血压误区多	其他	中医常识
看中医需要注意什么	其他	中医常识
别忽视宝宝的“地图舌”	其他	中医常识
急性咽炎不妨试用中医治疗	其他	中医常识
捍卫免疫系统：中医有妙方	其他	中医常识
上火有多种“灭火”要对症	其他	中医常识
运用中医辨证治疗慢性肾炎	其他	中医常识
伤食的病因以及中医治疗法	其他	中医常识
中医辨证治疗夏季感冒病症	其他	中医常识
面对暴饮暴食中医护胃有方	其他	中医常识
用中医方法辨证论治疗冻疮	其他	中医常识
中医辨证论治治疗慢性肾炎	其他	中医常识
如果出现伤食后的中医疗法	其他	中医常识
中医辨证治疗夏季寒热感冒	其他	中医常识
看痰色和量辨证，对症下药	其他	中医常识
小儿过敏性咳嗽的中医治疗	其他	中医常识
痤疮位置各异暗示不同疾病	其他	中医常识
中医辨证治疗盆腔炎有妙招	其他	中医常识
感冒杀到，中医防治有妙招	其他	中医常识
感冒治疗不彻底引发关节炎	其他	中医常识
便秘，要学会培养“便意”	其他	中医常识
牙痛中医应该如何辩证论治	其他	中医常识
中医药在对付流感上有优势	其他	中医常识
中医辩证分型论治糖尿病症	其他	中医常识
治疗便秘应该“对号入座”	其他	中医常识
冠心病中医研究概况	其他	中医常识
红斑狼疮中医研究之二	其他	中医常识
红斑狼疮中医研究之一	其他	中医常识
静悸汤治疗病毒性心肌炎体会	其他	中医常识
肿瘤化疗期如何选择中医药	其他	中医常识
托毒消痈汤治老年慢性萎缩性胃炎的研究	其他	中医常识
柴胡活血汤治疗非醇性脂肪性肝炎的研究	其他	中医常识
加味半夏承气汤治疗胃下垂的研究	其他	中医常识
科学家发现珍珠草可治乙肝	其他	中医常识
当归治疗脑缺血机理研究取得进展	其他	中医常识
中医治癌专家张仁济创办中药“百草”治癌有神效	其他	中医常识
复方鳖甲软肝片抗肝纤维化机制研究获新进展	其他	中医常识
选择中医治疗可以延长癌症病人的寿命	其他	中医常识
中药名四季歌	其他	中医常识
中药“煎”法学问大	其他	中医常识
中药趣名种种	其他	中医常识
药话丹参	其他	中医常识
中医谈“火”	其他	中医常识
天然药物为何称“本草”	其他	中医常识
虫草治百病只是传说	其他	中医常识
中医药文化如何继承与创新	其他	中医常识
世界最古的体疗－导引	其他	中医常识
关公刮骨疗毒	其他	中医常识
孙思邈为虎医伤	其他	中医常识
粢饭团治“怪病”	其他	中医常识
踏雪斋和扫叶庄	其他	中医常识
杏林的由来	其他	中医常识
中医“免疫”思想的由来	其他	中医常识
中医行医的招牌－―葫芦	其他	中医常识
“不为良相，愿为良医”	其他	中医常识
秦汉时期风俗习尚与医药文化	其他	中医常识
唐代诗文中的眼外科手术	其他	中医常识
即论书法亦传人－―名医书法佳话	其他	中医常识
金匾高悬传美名－―名医匾话	其他	中医常识
自撰佳联抒心怀－名医楹联赏析	其他	中医常识
中药店为什么多称“堂”	其他	中医常识
家有三年艾郎中不用来－端午话艾叶	其他	中医常识
从宫廷谋杀案说到附子	其他	中医常识
要从多元性认识中医	其他	中医常识
奇方偏方秘方等之琐谈	其他	中医常识
桃文化与桃在中医药的应用	其他	中医常识
西化管理限制中医正常发展	其他	中医常识
七十年以前的废止中医风波	其他	中医常识
关于李经纬《内经图》全释	其他	中医常识
对中医的别名你们都知道吗	其他	中医常识
所谓风邪致病表示什么意思	其他	中医常识
清代医事制度以及医学教育	其他	中医常识
中医医疗技术的创造与发明	其他	中医常识
几次维护中医药的抗争运动	其他	中医常识
中国原始人类及其卫生活动	其他	中医常识
近代中医史上方剂学的成就	其他	中医常识
汇通派代表医家的学术思想	其他	中医常识
中国古代著名医书简单介绍	其他	中医常识
文化“碰撞”中药如何生存	其他	中医常识
一个医学文化宝藏的探矿者	其他	中医常识
道教哲学与中医药学的发展	其他	中医常识
神农尝百草，传说中的实在	其他	中医常识
南北宋时期我国医学的发展	其他	中医常识
晚清时期我国的中医药教育	其他	中医常识
天然药物为何称为“本草”	其他	中医常识
中医“免疫”思想的由来故	其他	中医常识
古代中医药的志徽－阴阳鱼	其他	中医常识
中西结合治急性颅脑损伤	其他	中医常识
中西结合治异位妊娠	其他	中医常识
冠心病中西合治	其他	中医常识
中西医治疗晚期恶性肿瘤	其他	中医常识
中西药“双管齐下”利与弊	其他	中医常识
中西合治急性颅脑损伤	其他	中医常识
中西药结合治疗抑郁症	其他	中医常识
中西药合用注意ABC	其他	中医常识
中西治疗强直性脊柱炎	其他	中医常识
中西医合治肠道感染	其他	中医常识
中西医如何认识风湿	其他	中医常识
理中汤临床新用	其他	中医常识
双黄连注射液的不良反应及防范	其他	中医常识
中药材－―枸杞子刍议	其他	中医常识
阿胶的临床应用拓展	其他	中医常识
杏仁与桃仁的简易鉴别	其他	中医常识
大蒜的现代药理研究	其他	中医常识
方剂基础研究项目启动	其他	中医常识
中医药科技成果开发转化	其他	中医常识
西安中药治疗股骨头坏死显疗效	其他	中医常识
运用基因钳揭示中药抗心律失常机理	其他	中医常识
科研人员探讨大蒜是否真有益于健康	其他	中医常识
中西医药的主要差别	其他	中医常识
中暑的中西医结合治疗	其他	中医常识
中西医结合治痰多	其他	中医常识
中西医之间的距离	其他	中医常识
中西医结合有效的疾患	其他	中医常识
中调西疗共治癌	其他	中医常识
冠脉再狭窄中药可疏通	其他	中医常识
中西医结合治疗慢性乙型肝炎106例观察	其他	中医常识
伤寒的诊断及治疗	其他	中医常识
哮喘病的中西医结合治疗	其他	中医常识
中西医结合治疗视网膜中央动脉阻塞21例	其他	中医常识
中西药合治抑郁症	其他	中医常识
中西医结合治中风	其他	中医常识
科学辨证法与中医学的发展	其他	中医常识
中西医学理论的根本差异	其他	中医常识
沈自尹院士是怎样对“证”进行研究的？	其他	中医常识
当归芍药散治疗直肠术后综合症	其他	中医常识
中西医综合治疗强直性脊柱炎	其他	中医常识
治疗霉菌阴道炎用中西结合	其他	中医常识
研究中西医的互补性4	其他	中医常识
自制玉屏风散防感冒	其他	中医常识
中西医结合治疗湿热型肠道感染	其他	中医常识
疏通气机治胃瘫	其他	中医常识
有了恐惧找中医“壮胆”	其他	中医常识
哪些病适合看中医？	其他	中医常识
冬天治肾病效果好	其他	中医常识
胃病巧用“心药”医	其他	中医常识
服用核桃可治咳嗽	其他	中医常识
研究中西医的互补性3	其他	中医常识
用百合止咳要分寒热	其他	中医常识
中西医结合治疗急性颅脑损伤	其他	中医常识
男性乳腺增生从肾虚论治	其他	中医常识
中医治疗盆腔炎有妙招	其他	中医常识
感冒杀到，防治有招	其他	中医常识
培土健脾治疗慢性咽炎	其他	中医常识
男性更年期的辨证分型及治疗	其他	中医常识
孩子腹痛隐藏什么病	其他	中医常识
陈宝贵治疗胃脘痛八法	其他	中医常识
秋冬季节话“膏方”	其他	中医常识
中医治疗尿毒症七招	其他	中医常识
痤疮位置暗示不同疾病	其他	中医常识
风热型感冒的食疗	其他	中医常识
痛风之成因及中医治疗	其他	中医常识
中医常识如何防治中风	其他	中医常识
辨治男子免疫性不育四法	其他	中医常识
黄芪组方辨证治疗血液病	其他	中医常识
老年慢性结肠炎如何治疗	其他	中医常识
中成药治疗小儿厌食症	其他	中医常识
先兆流产的中医治疗	其他	中医常识
小儿秋季腹泻的中医辨治	其他	中医常识
从脾论治中医之痹病后期	其他	中医常识
龚廷贤妙用补法治臌胀	其他	中医常识
中医辨证施食与忌口	其他	中医常识
外感咳嗽治疗的几个问题	其他	中医常识
妇人经期外感辨治	其他	中医常识
经方治疗呼吸系疾病	其他	中医常识
中医治疗阿米巴痢疾	其他	中医常识
中医辨证各型便秘	其他	中医常识
阻塞性肺气肿的中医治疗	其他	中医常识
配合中医“望闻问切”有技巧	其他	中医常识
对脾胃病的认识和治疗经验	其他	中医常识
中医的望闻问切（一）	其他	中医常识
中医的望闻问切（二）	其他	中医常识
中医面部辨病术是什么	其他	中医常识
脑外伤后高热临证治验	其他	中医常识
内科急症高热治分三段说	其他	中医常识
中医辨证各类型呕吐	其他	中医常识
中医辨证治疗小儿贫血	其他	中医常识
怎样从笑容观察病情	其他	中医常识
骨折的民间中草药疗法	其他	中医常识
中医辨证分型治疗湿阻证	其他	中医常识
服用乌鸡白凤丸要对症	其他	中医常识
中医药辨证治疗口疮六法	其他	中医常识
中医治疗维生素A缺乏症	其他	中医常识
上火有多种“灭火”要对症	其他	中医常识
阴虚湿热瘀结型痛经证治	其他	中医常识
辨“指纹”识儿病	其他	中医常识
中医治疗胆石症并发胆囊炎	其他	中医常识
从舌觉异常辨治脂肪肝	其他	中医常识
中药内外合治乳腺增生病	其他	中医常识
萎缩性舌炎的中医辨治	其他	中医常识
冠心病心绞痛的中医治疗	其他	中医常识
中医治疗激素依赖性哮喘	其他	中医常识
中医药治疗小儿反复性腹痛	其他	中医常识
仲景通窍祛邪法探究	其他	中医常识
月经不调的中医证治法	其他	中医常识
肾脏病的中医证治	其他	中医常识
肾脏病的中医病因病理	其他	中医常识
论中医学说中的四大病因	其他	中医常识
看痰辨证对症下药	其他	中医常识
中医的辨证施治简析	其他	中医常识
中药也伤肾服用有讲究	其他	中医常识
丹栀逍遥散的临床新用	其他	中医常识
再识防风通圣丸	其他	中医常识
中药葛根治疗骨质疏松	其他	中医常识
滥服中药易致“药性肾病”	其他	中医常识
血管内皮功能障碍研究取得新进展	其他	中医常识
胆结石胆囊炎应适时佐用温中药	其他	中医常识
一贯煎新用	其他	中医常识
抗生素相关性腹泻的辨治	其他	中医常识
经方辨治心脏病三则	其他	中医常识
复发性口疮的辨治	其他	中医常识
哮喘的中医治疗	其他	中医常识
通利疗法在温热病中的应用	其他	中医常识
肿瘤并发症的防治方法	其他	中医常识
中医辨治雷诺氏病	其他	中医常识
病毒性肝炎中医治疗经验探讨	其他	中医常识
放射性肺炎的辨证治疗	其他	中医常识
中医夏季养生之运动保健	其他	中医养生
养生之道贵在健脑	其他	中医养生
调和七情和悦人生	其他	中医养生
中医养生保健简介	其他	中医养生
古人饮食养生经	其他	中医养生
中医养脑培神法	其他	中医养生
养生宜变通	其他	中医养生
养生：当顺其自然	其他	中医养生
看舌苔调整孩子的饮食	其他	中医养生
药膳食疗痛风	其他	中医养生
猪血菠菜汤可缓解便秘	其他	中医养生
药膳让你远离“高危”	其他	中医养生
从外补水湿化空气	其他	中医养生
妙用菊花枸杞茶养生	其他	中医养生
时尚过节谨防食品伤身	其他	中医养生
秋补需忌油腻少辛辣	其他	中医养生
伟人邓小平的20条养生之道	其他	中医养生
中秋吃鸭滋阴养津防秋燥	其他	中医养生
秋食百合解秋燥滋润肺阴	其他	中医养生
旅游归来消除疲劳有方法	其他	中医养生
秋季养生“和”为贵	其他	中医养生
修身养性强调心灵感受的质量	其他	中医养生
医学家陈实功谈养生之道	其他	中医养生
中医秋季养生之运动保健	其他	中医养生
中医秋季养生之药物保健	其他	中医养生
中医秋季养生之防病保健	其他	中医养生
教你七招秋季养生法	其他	中医养生
中医养生防病观点ABC	其他	中医养生
主食不足头发易掉	其他	中医养生
专家：秋燥养肺首选果蔬	其他	中医养生
中医养生学说撮要	其他	中医养生
注意食者身体的阴阳平衡	其他	中医养生
漫谈养生保健谚语	其他	中医养生
中医养生话“七情”	其他	中医养生
巧食清除体内垃圾	其他	中医养生
男性保持性功能食谱	其他	中医养生
药酒壮阳，是真的吗？	其他	中医养生
为什么说“离家千里，勿食枸杞”？	其他	中医养生
男性壮阳食品荟萃	其他	中医养生
女性助性食物	其他	中医养生
饱食禁欲	其他	中医养生
壮阳药膳两种	其他	中医养生
酒后禁欲	其他	中医养生
食物与性保健	其他	中医养生
新婚期的饮食调养	其他	中医养生
家庭怎样安排减肥膳食	其他	中医养生
养生十八法保健康	其他	中医养生
秋燥蠢蠢欲动润燥立即行动	其他	中医养生
科学“秋冻”才健康	其他	中医养生
钱伟长：长寿靠“四自”	其他	中医养生
冷水浴健身从秋天开始	其他	中医养生
健康格言是良药	其他	中医养生
人参当归乳癌患者致命杀手	其他	中医养生
热水泡脚胜吃补药	其他	中医养生
毛泽东的饮食养生之道	其他	中医养生
白领时尚养生七大陷阱	其他	中医养生
肾虚怎么越补越虚？	其他	中医养生
日常生活的3大健康隐患	其他	中医养生
关于脱发的五大误区	其他	中医养生
健康男人拒绝秃顶	其他	中医养生
秋高物燥提防脱发	其他	中医养生
巧梳头：远离脱发的烦恼	其他	中医养生
古代名人养生“九诀”	其他	中医养生
中医养生话	其他	中医养生
秋冬进补并非人人皆宜	其他	中医养生
老中医朱南孙教授谈自我养生	其他	中医养生
秋季养生重养肺	其他	中医养生
齐白石先生的养生七戒	其他	中医养生
老人秋季强身需“四戒”	其他	中医养生
常12种简易养生技法	其他	中医养生
白露时节身不露	其他	中医养生
饮酒讲究四个最佳	其他	中医养生
中青年频频“盗汗”是何因	其他	中医养生
浅谈中医养生术的四大原则	其他	中医养生
中医养生防病中的理论观点	其他	中医养生
能让“精关”牢固的十道菜	其他	中医养生
冬季寒冷时期正是养肾时机	其他	中医养生
养身之道，五脏六腑有人疼	其他	中医养生
中国古代佛家的养生百字诀	其他	中医养生
不良习惯容易让人犯“晕”	其他	中医养生
几款中医养生茶的适应禁忌	其他	中医养生
专家研究成果中医养生七招	其他	中医养生
秋季养生在“收”不在“散”	其他	中医养生
秋季利于调养生机宜补芡实	其他	中医养生
老年人秋季养生有几招妙方	其他	中医养生
生活中几种简易养生技巧法	其他	中医养生
老年养生“七淡”最为适宜	其他	中医养生
中医认为巧食五味科学养生	其他	中医养生
了解秋冬季中医养生的处方	其他	中医养生
秋季要如何保养体内的阴气	其他	中医养生
秋季养生要听听专家的忠告	其他	中医养生
5分钟脸部按摩美容法	其他	中医养生
中药洗发要对症	其他	中医养生
3种自制中药面膜	其他	中医养生
三白汤让你又白又嫩	其他	中医养生
中医美容要全而不偏	其他	中医养生
春令养颜多用药膳	其他	中医养生
美容要先调身心	其他	中医养生
中医美容“花粥”法	其他	中医养生
荷叶茶减肥好帮手	其他	中医养生
猪肉天然的美容品	其他	中医养生
漂亮乳房的健胸秘诀	其他	中医养生
丰胸自我按摩法	其他	中医养生
女生美容流行吃虫	其他	中医养生
温水洗胸部令乳房更漂亮	其他	中医养生
自制鲜花养颜护肤品	其他	中医养生
按摩瘦腰法	其他	中医养生
日本女性敷红糖养颜	其他	中医养生
私家丰胸之按摩篇	其他	中医养生
“排毒”未必养颜	其他	中医养生
女人最爱的美丽汤	其他	中医养生
饭后千万不要立即工作！	其他	中医养生
清嗓的习惯要改改了	其他	中医养生
电脑的“后脑勺”千万别冲人	其他	中医养生
六项注意阻挡电脑伤害	其他	中医养生
白领，别让加班带你进深渊	其他	中医养生
善假于物－与电脑和平相处	其他	中医养生
计算机族护眼诀窍	其他	中医养生
办公室久坐不动的男性易变胖	其他	中医养生
工间锻炼干活效率提高15%	其他	中医养生
工作累了多吃鸡	其他	中医养生
白领男人：你该如何养身	其他	中医养生
白领：爱美别妨碍腰呼吸	其他	中医养生
上班族适用的养生功四式	其他	中医养生
专家：肉要少吃饭要多吃	其他	中医养生
吃素能防冠心病吗？	其他	中医养生
素食者及老人还应补点啥	其他	中医养生
长寿并不难，从豆芽开始	其他	中医养生
“寺院菜”健康清新	其他	中医养生
夏季抗疲劳菜品	其他	中医养生
营养学家：严格食素更健康	其他	中医养生
男到中年要保养	其他	中医养生
猪胰淡菜汤	其他	中医养生
吃鲜香椿最好用开水烫	其他	中医养生
五谷杂粮也治病	其他	中医养生
对症吃鱼药食兼得	其他	中医养生
中餐滋补菜与洋餐滋补粥	其他	中医养生
喝酸奶可以抗流感	其他	中医养生
晚饭吃太饱，用点神曲	其他	中医养生
眼干多喝菊花茶	其他	中医养生
药膳让你“吃”掉燥气	其他	中医养生
家用水果疗病小秘方	其他	中医养生
上火了吃点龟苓膏	其他	中医养生
怀孕前期药膳帮你调营养	其他	中医养生
小儿肛裂家庭治疗	其他	中医养生
五谷杂粮也是药	其他	中医养生
午餐多吃素下午不犯困	其他	中医养生
准妈妈的开胃菜谱	其他	中医养生
家常药膳火锅	其他	中医养生
谁是餐桌上的“伟哥”	其他	中医养生
男子补阳药鸡八大方	其他	中医养生
初秋之时应“设四防”	其他	中医养生
健康食补推荐	其他	中医养生
饭后保健不如饭前养生	其他	中医养生
四招教你摆脱秋乏	其他	中医养生
经期女性饮食禁忌	其他	中医养生
入秋谨防“情绪疲软”	其他	中医养生
心理养生四要素	其他	中医养生
会睡觉的女人美到老	其他	中医养生
男士上班族养生功四式	其他	中医养生
“多事之秋”如何养生？	其他	中医养生
爱情菜：滋阴壮阳佳品	其他	中医养生
日常12种简易养生技法	其他	中医养生
中医养生学说的几点摘要	其他	中医养生
常喝绿茶红茶可防记忆衰退	其他	中医养生
春三月每天早上梳头一百下	其他	中医养生
要善用饮食疗法来降低血压	其他	中医养生
常用的降低血糖的中成药物	其他	中医养生
选用中药来防治流感有奇效	其他	中医养生
清热解毒之良药－―鱼腥草	其他	中医养生
男人趴着睡小心伤“精”	其他	中医养生
吃好喝好活力再现	其他	中医养生
女人肾虚“七宗罪”	其他	中医养生
秋季健身项目慎选	其他	中医养生
冬季洗浴的凉凉热热	其他	中医养生
药王孙思邈的养生妙法	其他	中医养生
四季如何调节房事	其他	中医养生
饭后百步走的讲究	其他	中医养生
强身回春的壮阳术	其他	中医养生
食物里的“救火队员”	其他	中医养生
冬季如何不怕冷	其他	中医养生
养生新说：像猫咪一样睡觉	其他	中医养生
“四不”益寿又延年	其他	中医养生
养生学会“冷处理”	其他	中医养生
“四法”养脾有疗效	其他	中医养生
白露时节好滋阴	其他	中医养生
巧食五味科学养生	其他	中医养生
养生：神补最最不能少	其他	中医养生
乾隆怎样延年益寿	其他	中医养生
大龄准妈妈的养生之道	其他	中医养生
善养生者，必知养气	其他	中医养生
冬病夏治和春捂秋冻	其他	中医养生
长寿之道，动静为妙	其他	中医养生
中医养生之胎孕保健	其他	中医养生
五行生克谈传统养生	其他	中医养生
中医养生应对热象感冒	其他	中医养生
可以防暑降温的保健粥	其他	中医养生
夏季养生全方位提醒	其他	中医养生
养生：阴和阳哪个更重要	其他	中医养生
中医夏季养生中药凉茶	其他	中医养生
老年人中医养生之道	其他	中医养生
降服夏日火气中医有对策	其他	中医养生
养生：苦夏午睡促健康	其他	中医养生
一夏无病三分虚立秋调理有八忌	其他	中医养生
中医饮食养生新发现	其他	中医养生
阳痿房事养生疗法	其他	中医养生
夏日养生须防火	其他	中医养生
中医养生之睡眠保健	其他	中医养生
夏季如何顺时养生	其他	中医养生
中医养生防衰五要旨	其他	中医养生
中医养生之情志保健	其他	中医养生
中医气功养生的机理	其他	中医养生
肾虚应做什么运动	其他	中医养生
太极拳与养生	其他	中医养生
中医养生之夏季养生法	其他	中医养生
夏季养生宜养脾	其他	中医养生
夏季养生“清”为贵	其他	中医养生
夏季养生话食补	其他	中医养生
中医夏季养生之精神调养	其他	中医养生
中医夏季养生之起居保健	其他	中医养生
气功养生常识	其他	中医养生
中风病人药膳三则	其他	中医养生
喝鸡汤治流感	其他	中医养生
治慢性胃炎要会吃	其他	中医养生
老姜茶水炖鸡蛋治咳嗽	其他	中医养生
牙痛食疗方推荐	其他	中医养生
祛口臭食疗方推荐	其他	中医养生
小儿肺炎食疗有方	其他	中医养生
中医推荐4类降脂食物	其他	中医养生
脑出血病人进补有则推荐药膳两款	其他	中医养生
五更泻食疗治	其他	中医养生
男子更年期食疗法多	其他	中医养生
冬补延寿膏延年寿更高	其他	中医养生
自制药蛋治肝病	其他	中医养生
老年性耳聋食疗方	其他	中医养生
药膳赶走感冒咳嗽	其他	中医养生
痔疮食疗方	其他	中医养生
美国医生推荐感冒食疗方	其他	中医养生
食疗治失眠最方便	其他	中医养生
糖尿病人夜尿多，可食疗	其他	中医养生
花生养血别搓皮	其他	中医养生
中医美容的6大特别提示	其他	中医养生
面孔告诉你该吃什么？	其他	中医养生
喝玫瑰花茶，抗抑郁	其他	中医养生
美丽的乳房是吃出来的	其他	中医养生
小龙女刘亦菲瘦身食谱	其他	中医养生
50岁赵雅芝漂亮保养秘方	其他	中医养生
过敏性皮肤慎贴果蔬片	其他	中医养生
用三红汤来治贫血	其他	中医养生
贴层保鲜膜嘴唇鲜又润	其他	中医养生
乌黑秀发在秋天咋保持？	其他	中医养生
润发泽乌-女性乌发食谱	其他	中医养生
豆浆生活之意外瘦身	其他	中医养生
女性增白养颜药膳-茯苓贝梨	其他	中医养生
一至七女性膳食搭配	其他	中医养生
痤疮中药加减方内服	其他	中医养生
减少老年斑妙品就在你身边	其他	中医养生
柔嫩女人吃出来	其他	中医养生
按足底乌白发？简单有效	其他	中医养生
瘦身不那么简单不那么难	其他	中医养生
女人四十如何补	其他	中医养生
夏天不要换肤祛斑	其他	中医养生
山药天然纤体美食	其他	中医养生
木瓜属于美人	其他	中医养生
中医面膜DIY苦瓜美白面膜	其他	中医养生
延缓衰老女人不妨用红塘	其他	中医养生
滥服珍珠粉消化不良	其他	中医养生
小心：芦荟可导致孕妇流产	其他	中医养生
樱桃：最适合女人吃	其他	中医养生
夏季：针灸减肥最佳时	其他	中医养生
杨贵妃美容秘术	其他	中医养生
3种食物告别黯然肤色	其他	中医养生
十五道天然美肤沐浴法	其他	中医养生
有效丰胸的精选小体操	其他	中医养生
跟“黑眼圈”说Byebye!	其他	中医养生
三款白领美体瘦身茶	其他	中医养生
自制鲜花养颜护肤佳品	其他	中医养生
战“痘”试试中医妙方	其他	中医养生
母亲营养状况与胎儿生长发育	其他	中医养生
壮骨“五兄弟”一样不能缺	其他	中医养生
营养丰富的发酵豆制品	其他	中医养生
高考之前话饮食	其他	中医养生
饮食有节	其他	中医养生
不要拒绝食肉	其他	中医养生
五味调和	其他	中医养生
四时宜忌	其他	中医养生
合理调配	其他	中医养生
烹调有方	其他	中医养生
饮食要卫生	其他	中医养生
不同季节宜饮不同的茶	其他	中医养生
饮茶的好处	其他	中医养生
正常人一天饮多少茶为宜	其他	中医养生
饮浓茶好还是饮淡茶好	其他	中医养生
中国茶的种类及其对人体的作用	其他	中医养生
哪些人不宜饮茶	其他	中医养生
茶的泡、煎服法	其他	中医养生
喝茶能抗辐射	其他	中医养生
小孩饮茶有无好处	其他	中医养生
怎样选购茶叶	其他	中医养生
怎样存放茶叶	其他	中医养生
哪些茶叶抗癌效果好	其他	中医养生
饮茶“十忌”	其他	中医养生
保健茶	其他	中医养生
为什么饮茶能抗癌	其他	中医养生
饮酒与健康	其他	中医养生
如何鉴别酒的好坏	其他	中医养生
酒后不宜饮茶	其他	中医养生
醉酒怎么办	其他	中医养生
酒是新的好还是陈的好	其他	中医养生
饮酒禁忌	其他	中医养生
酒对人体的作用	其他	中医养生
中国酒的种类和特性	其他	中医养生
饮酒与服药	其他	中医养生
常用滋补养生延寿的酒、醴、醪	其他	中医养生
多喝橙汁常吃蒜不吃药也降血压	其他	中医养生
男性调节性功能的饮食原则	其他	中医养生
补肾壮阳与饮食的讲究	其他	中医养生
阳痿药膳	其他	中医养生
保健专家翁维健的益寿法	其他	中医养生
坐言起行慎调养护生有道寿而康	其他	中医养生
养生学陆游不妨重“两头”	其他	中医养生
徐志瑛谈秋季养生	其他	中医养生
世界最长寿男人的养生之道	其他	中医养生
肾有阴阳不可盲目乱补	其他	中医养生
《黄帝内经》中养生思想浅析	其他	中医养生
吃枣应该慢吐核	其他	中医养生
腰痛重在预防	其他	中医养生
《泰定养生主论》谈养生	其他	中医养生
天凉好个秋秋冻有讲究	其他	中医养生
养生：顺其自然寿而康	其他	中医养生
文坛泰斗冰心的养生经	其他	中医养生
秋季养生专家有忠告	其他	中医养生
药膳进补当心误入歧途	其他	中医养生
从生活细节中预防痔疮	其他	中医养生
秋季保健“三拒绝”	其他	中医养生
养生：秋季进补八注意	其他	中医养生
张光斗的一二三四养生术	其他	中医养生
养生：适度适量顺其自然	其他	中医养生
秋季养生的四点忠告	其他	中医养生
秋天衣食住行有讲究	其他	中医养生
养生之道与养生之术	其他	中医养生
秋季别中了病毒的埋伏	其他	中医养生
儿童脾胃功能差重在三养	其他	中医养生
秋季养生小心“贼风”	其他	中医养生
初秋暑未消秋冻有讲究	其他	中医养生
中医四季养生的原则	其他	中医养生
食疗健肾补脾板栗香	其他	中医养生
中医：长夏防湿要淡补	其他	中医养生
时至立秋调理有七忌	其他	中医养生
百岁老人尹桂珍养生密要	其他	中医养生
秋季养生多“设防”	其他	中医养生
中医养生之秋季养生法	其他	中医养生
中医秋季养生之饮食调养	其他	中医养生
中医秋季养生之精神调养	其他	中医养生
中医秋季养生之起居保健	其他	中医养生
缺锌吃什么	其他	中医养生
食疗去白发	其他	中医养生
巧食降血压	其他	中医养生
痛风病人的饮食应该注意什么?	其他	中医养生
保护心脑血管多吃燕麦	其他	中医养生
前列腺炎患者多吃苹果汁	其他	中医养生
病人吃水果有哪“六忌”	其他	中医养生
吃“肝”不补“肝”	其他	中医养生
常吃大豆防多病	其他	中医养生
慢性胃炎食物选择	其他	中医养生
月经延后的饮食疗法	其他	中医养生
用蘑菇食疗的药用价值	其他	中医养生
香油鲜为人知的功效	其他	中医养生
十大抗老蔬果吃出青春活力	其他	中医养生
猪肉也能美容	其他	中医养生
饮食疗法降血压	其他	中医养生
调好饮食防黑色素	其他	中医养生
木耳红枣汤给你好脸色	其他	中医养生
春来菠菜是良蔬	其他	中医养生
动脑多吃葱和蒜	其他	中医养生
多食叶酸防中风	其他	中医养生
发酵食品预防肿瘤有奇效	其他	中医养生
春季宜多吃养肝补脾食物	其他	中医养生
身体不适“粥”调理	其他	中医养生
冷开水泡茶可防治糖尿病	其他	中医养生
水漱口可预防流感	其他	中医养生
儿童饮食习惯与胃肠疾患	其他	中医养生
喝脱脂牛奶可防癌	其他	中医养生
饮食保健与性生活	其他	中医养生
天然“性”食品指南	其他	中医养生
茶与咖啡对性功能的影响	其他	中医养生
助性食物与习俗	其他	中医养生
大蒜为何能强精？	其他	中医养生
祛病保健六种汤	其他	中医养生
水果巧治难言之隐	其他	中医养生
海鲜大餐让您心情爽	其他	中医养生
给孩子吃一款“补血菜”	其他	中医养生
饮食养心保健法	其他	中医养生
鱼汤可治腹泻	其他	中医养生
虾皮的食疗功用	其他	中医养生
早春食补：养肝助阳防寒	其他	中医养生
晨起要喝的养生饮料	其他	中医养生
奇妙的美颜食谱	其他	中医养生
中药四茶饮，体内作环保	其他	中医养生
百益果王：木瓜	其他	中医养生
美专家推荐十种健脑食品	其他	中医养生
春令三补法	其他	中医养生
春季养生喝“药粥”	其他	中医养生
吃淀粉类食物抑制肠癌	其他	中医养生
每日一柑橘有助防癌	其他	中医养生
巧吃喝应对血黏稠	其他	中医养生
室内外温差过大易中风	其他	中医养生
食洋葱保护血管	其他	中医养生
生病了该吃什么水果？	其他	中医养生
食物防治疾病最新发现	其他	中医养生
枸杞最适合用来消除疲劳	其他	中医养生
食疗排铅	其他	中医养生
微量元素营养疗法	其他	中医养生
燥咳食疗方四款	其他	中医养生
冬季去火食疗帮忙	其他	中医养生
果蔬可作外敷良药	其他	中医养生
冬食四宝滋补润燥	其他	中医养生
西红柿疗疾六法	其他	中医养生
栗香季节话栗子	其他	中医养生
美味柑橘能防癌	其他	中医养生
自助“食疗”不能太随意	其他	中医养生
体质食养追求个性化	其他	中医养生
多吃食用菌为健康加分	其他	中医养生
秋凉进补菱角	其他	中医养生
调补气色与活力的饮食	其他	中医养生
食疗防治近视眼	其他	中医养生
风湿患者少吃猪牛羊肉	其他	中医养生
这些食物可降压	其他	中医养生
月经期间的饮食	其他	中医养生
现代男人饮食九要素	其他	中医养生
水果与性保健	其他	中医养生
茶与性保健的关系	其他	中医养生
宝宝零食与加餐	其他	中医养生
益肾植物性食品	其他	中医养生
什么是脑黄金，有什么作用？	其他	中医养生
益肾动物性食品	其他	中医养生
学生的课间餐、快餐、零食	其他	中医养生
韭菜可以补肾	其他	中医养生
秋果治病亦致病	其他	中医养生
吃蔬菜不当可致儿童糖尿病	其他	中医养生
每天俩苹果可防血管硬化	其他	中医养生
如何给小儿煎服中药?	其他	中医养生
哪些病人应少喝啤酒	其他	中医养生
甘薯抑制胆固醇功效最大	其他	中医养生
喝牛奶可能减少结肠癌危险	其他	中医养生
用日常食物预防疾病	其他	中医养生
产后血晕的药膳治疗	其他	中医养生
早吃低敏食品可抗过敏	其他	中医养生
几种预防、治疗感冒茶饮料	其他	中医养生
当心！酒徒易染肺结核	其他	中医养生
对付生物武器侵袭有绝招	其他	中医养生
吃猪蹄可防治神经衰弱	其他	中医养生
日学者：啤酒有抗癌效用	其他	中医养生
孩子吃糖多性格易怪僻	其他	中医养生
佳果良药―柑橘	其他	中医养生
每日三杯牛奶可防乳癌	其他	中医养生
美博士：生吃食物可治病	其他	中医养生
别把保健品当药吃	其他	中医养生
食补效果不会实时出现	其他	中医养生
洋快餐引发现代病	其他	中医养生
肠、胃疾病的饮食宜忌	其他	中医养生
润肺止咳话大枣	其他	中医养生
乙肝的饮食治疗与垂直传播	其他	中医养生
苹果西红柿可保肺健康	其他	中医养生
芹菜――治病健身的蔬菜	其他	中医养生
糖尿病人能否吃水果？	其他	中医养生
食盐加铁防贫血	其他	中医养生
防止脂肪肝的八种食物	其他	中医养生
吃南瓜粉可预防糖尿病	其他	中医养生
心血管病人为何忌吃螃蟹？	其他	中医养生
胡萝卜素黄染皮肤？	其他	中医养生
鸡汤虽美有人不宜	其他	中医养生
春节饮食当心鲜蚕蛹	其他	中医养生
蹲着吃饭不利健康	其他	中医养生
人为什么会气得吃不下饭？	其他	中医养生
专家：每天应吃六两米饭	其他	中医养生
十种毒菜请勿食用	其他	中医养生
老年人多吃草莓和菠菜	其他	中医养生
减肥食疗方－燕麦片粥	其他	中医养生
“寒头暖足”胜吃药	其他	中医养生
“春捂秋冻”别过度	其他	中医养生
饮茶的二十一条“军规”	其他	中医养生
高血压食疗方	其他	中医养生
男人不可无姜女人不可无糖	其他	中医养生
专家支招：今年三伏吃点啥	其他	中医养生
鸡蛋壳对溃疡有效	其他	中医养生
手脚冰凉多吃牛羊肉	其他	中医养生
鹌鹑蛋营养与食疗	其他	中医养生
多饮姜茶保健康	其他	中医养生
选择食物预防职业病	其他	中医养生
药食兼优话鱼鳞	其他	中医养生
补冬不如补霜降	其他	中医养生
甘蔗:冬令爽口的“补血果”	其他	中医养生
心脏病患者宜多吃鱼	其他	中医养生
菠萝食疗方	其他	中医养生
秋防感冒“七饮”	其他	中医养生
脑力劳动者的进食法	其他	中医养生
樱桃可治痛风关节炎	其他	中医养生
高脂海鱼益身心	其他	中医养生
常食鲜玉米益寿又健身	其他	中医养生
治便秘果蔬食疗方	其他	中医养生
餐桌上的天然“降脂药”	其他	中医养生
秋分话秋饮	其他	中医养生
芹菜治病验方	其他	中医养生
药食俱佳核桃仁	其他	中医养生
饮酒不妨吃些糖醋菜	其他	中医养生
多吃碱性食品可提高智商	其他	中医养生
少食盐等于补钙	其他	中医养生
酸奶能抑制“火锅病”	其他	中医养生
预防秋季感冒有良汤	其他	中医养生
能让孩子聪明的食物	其他	中医养生
咳嗽药粥三款	其他	中医养生
秋天养生巧食梨	其他	中医养生
吃黑巧克力有益心脏	其他	中医养生
吃牛肉使人更聪明	其他	中医养生
秋季养胃先要吃好早餐	其他	中医养生
以心理影响纠正偏食	其他	中医养生
巧吃水果治疗各种性疾病	其他	中医养生
醉酒后应该喝果汁或糖水	其他	中医养生
饮食五戒	其他	中医养生
降低胆固醇食疗推介	其他	中医养生
熟甘薯防癌最宜	其他	中医养生
菠萝食疗，不妨一试	其他	中医养生
八款降压美味汤	其他	中医养生
菠菜可解酒毒	其他	中医养生
胃癌食疗方	其他	中医养生
蜂蜜能治过敏症	其他	中医养生
喝咖啡可预防胆结石	其他	中医养生
调理膳食保护心血管	其他	中医养生
生姜辣走病魔	其他	中医养生
吃葡萄皮防癌	其他	中医养生
糖尿病食疗方－清蒸茶鲫鱼	其他	中医养生
天然降压药-芹菜	其他	中医养生
对癌症患者有益的药粥	其他	中医养生
饮食疗法治疗月经延后	其他	中医养生
多食干果有助于预防II型糖尿病	其他	中医养生
每天吃胡萝卜有助于防肺癌	其他	中医养生
睡前的准备	其他	中医养生
睡眠保健	其他	中医养生
睡眠的方位	其他	中医养生
穿衣保健	其他	中医养生
老年人按摩助眠法	其他	中医养生
枕头的要求	其他	中医养生
起居养生	其他	中医养生
着装宜忌	其他	中医养生
起床有学问	其他	中医养生
鞋的选择	其他	中医养生
季节着衣学问	其他	中医养生
静心养神	其他	中医养生
什么是神	其他	中医养生
怡情畅神	其他	中医养生
男人肾虚食疗方推荐	其他	中医养生
秋冬进补还是要养阴	其他	中医养生
对老师讲讲“养生之道”	其他	中医养生
香蕉对身体有几大奇效	其他	中医养生
牛奶除疲劳瓜子能安神	其他	中医养生
专家推荐四个菜最健康	其他	中医养生
一些有助于防癌的食品	其他	中医养生
有一些菜不能放辣椒！	其他	中医养生
警惕叶酸吃多记忆减退	其他	中医养生
六大健康饮食助你长寿	其他	中医养生
怎样煮豆浆才能更健康	其他	中医养生
防止秋燥滋阴润肺当道	其他	中医养生
老年人饮食养生十不贪	其他	中医养生
吃烤肉撒柠檬汁可防癌	其他	中医养生
养生警惕酒杯里的陷阱	其他	中医养生
秋风起，老人当心秋燥	其他	中医养生
五种食疗方法抗击疲劳	其他	中医养生
被牛奶拒绝的五种食物	其他	中医养生
养生提示：吃辣更长寿	其他	中医养生
秋高气爽喝粥最最怡神	其他	中医养生
牛肉盘子里的健美教练	其他	中医养生
秋冬季节吃桔子要注意	其他	中医养生
五味饮食中的科学养生	其他	中医养生
有一些水果不宜冰着吃	其他	中医养生
冬令度身进补才能健康	其他	中医养生
妇女秋季养生食疗方法	其他	中医养生
萝卜小人参防癌又养生	其他	中医养生
女性冬令养生因人而异	其他	中医养生
冬季养生健康饮食习惯	其他	中医养生
常喝大米粥不容易感冒	其他	中医养生
鳗鱼是冬季进补的佳品	其他	中医养生
冬季必不可少的六种汤	其他	中医养生
美味番茄的Ｎ种食疗方	其他	中医养生
巧食秋莲藕养生最补人	其他	中医养生
冬季应该合理进补水果	其他	中医养生
老年人别可惜剩饭剩菜	其他	中医养生
巧食五味科学养生	其他	中医养生
补肾生发多吃芝麻	其他	中医养生
橘皮的多种营养新吃法	其他	中医养生
用电脑的人最好吃鸡蛋	其他	中医养生
莲子补骨脂猪腰汤	其他	中医养生
细嚼慢咽的健康意义	其他	中医养生
养生保健话黄豆芽	其他	中医养生
肠胃变干净的酸奶断食法	其他	中医养生
怎样吃辣椒对身体有益	其他	中医养生
春季养生吃什么好？	其他	中医养生
健康养生彩色花草茶	其他	中医养生
喝大米粥不易感冒	其他	中医养生
春季饮食调养宜分三阶段	其他	中医养生
春季养生可以吃点养肝粥	其他	中医养生
海产品的滋补功效	其他	中医养生
胃不会用坏只会宠坏	其他	中医养生
雨水时节适当少食酸味食物	其他	中医养生
鱼和豆腐一起吃最补钙	其他	中医养生
春天养生家常菜	其他	中医养生
换季多吃韭菜少吃黄瓜	其他	中医养生
春季养肝多食菠菜	其他	中医养生
西兰花营养防病属第一	其他	中医养生
食疗养生苹果瘦肉汤	其他	中医养生
春季养生菜谱新鲜出炉	其他	中医养生
吃洋葱保健康	其他	中医养生
做个懂得养生的素食美女	其他	中医养生
春季野菜利养生	其他	中医养生
祛湿暖胃养生汤二款	其他	中医养生
枸杞养生美容滋补功效	其他	中医养生
养生佳品花椰菜	其他	中医养生
养生酱菜风行日本	其他	中医养生
抗癌佳品：香菇薏米饭	其他	中医养生
如何减缓你的更年期症状	其他	中医养生
儿童盗汗不宜进补	其他	中医养生
牛奶加蜂蜜可改善儿童贫血	其他	中医养生
一天半瓣大蒜防肠癌	其他	中医养生
降压防癌猕猴桃	其他	中医养生
喝酒也能喝出精神病	其他	中医养生
巧用豆腐来治病	其他	中医养生
辣椒能预防心脏病	其他	中医养生
养阴润燥食疗方	其他	中医养生
对症食果疾病消	其他	中医养生
儿童常吃西式快餐易患哮喘	其他	中医养生
每日吃维Ｃ降低高血压	其他	中医养生
“吃出健康”误区多	其他	中医养生
避免秋季忧郁症的饮食良方	其他	中医养生
吸烟饮酒与高血压的关系	其他	中医养生
降压食疗－芹菜	其他	中医养生
大蒜可治疗和预防感冒	其他	中医养生
奶制品与前列腺癌相关	其他	中医养生
运动也能治胃病	其他	中医养生
“旱地划船”缓解腰酸背痛	其他	中医养生
运动是把双刃剑过度会变笨	其他	中医养生
夏天：常用运动清清肠	其他	中医养生
要慎重走鹅卵石路健身	其他	中医养生
三一二经络锻炼健身法	其他	中医养生
清晨免疫力低不宜运动	其他	中医养生
如何让大脑变得更年轻	其他	中医养生
秋季最优“养收”运动	其他	中医养生
中年运动年老不易痴呆	其他	中医养生
运动养生因病而异	其他	中医养生
运动养生的经典箴言	其他	中医养生
春季养生运动锻炼	其他	中医养生
职场美女踮脚养生简易运动	其他	中医养生
初春养生五大健康处方	其他	中医养生
养生每晚步行三刻钟	其他	中医养生
养生太极拳：疗心又疗身	其他	中医养生
春季运动三要素	其他	中医养生
走路上下班益处多	其他	中医养生
运动养生需因病而异！	其他	中医养生
“多事之秋”的情志养生法	其他	中医养生
情志养生	其他	中医养生
帽子的保健作用	其他	中医养生
适度用神	其他	中医养生
节欲守神	其他	中医养生
善心养生	其他	中医养生
神的物质基础	其他	中医养生
影响神的因素	其他	中医养生
得神与失神	其他	中医养生
仁者寿	其他	中医养生
注重养德	其他	中医养生
顺时调神	其他	中医养生
养生之根-德与性	其他	中医养生
清静养神	其他	中医养生
解忧五法	其他	中医养生
养生奇方―养德	其他	中医养生
知足常乐	其他	中医养生
保持清心寡欲	其他	中医养生
烹调怡乐	其他	中医养生
调和七情，和悦人生	其他	中医养生
防止乐极生悲	其他	中医养生
乐观何以长寿	其他	中医养生
琴瑟陶情	其他	中医养生
健康在心里	其他	中医养生
出游悦心	其他	中医养生
志存高远	其他	中医养生
养花解闷	其他	中医养生
垂钓能防病治病	其他	中医养生
吟诗纵情	其他	中医养生
钓鱼能磨炼意志	其他	中医养生
怎样选鸟	其他	中医养生
养鱼之乐	其他	中医养生
钓鱼，其乐无穷	其他	中医养生
认识纸上太极	其他	中医养生
旅游养神增寿	其他	中医养生
赏鸟陶冶性情	其他	中医养生
何以说“善弈者长寿”	其他	中医养生
热水浴	其他	中医养生
旅游能陶冶情操增长见识	其他	中医养生
冬日负暄和气生	其他	中医养生
养花使你热爱生活	其他	中医养生
沙浴	其他	中医养生
足浴养生	其他	中医养生
旅游的感受真好	其他	中医养生
环境养生	其他	中医养生
森林浴	其他	中医养生
女性养生五法	其他	中医养生
季节房室养生	其他	中医养生
禁欲有损健康	其他	中医养生
如何固精益肾	其他	中医养生
房事适度以延年	其他	中医养生
房事养生保健五法	其他	中医养生
帮助纠正子宫位置不正及防治痛经的保健操	其他	中医养生
卧式保健功	其他	中医养生
妊娠保健操	其他	中医养生
脑保健操	其他	中医养生
视力保健操	其他	中医养生
上班族床边保健操	其他	中医养生
预防衰老先练腿脚	其他	中医养生
上班族桌边保健操	其他	中医养生
睡前保健八法	其他	中医养生
睡眠的姿势	其他	中医养生
健康中医专家的私家养生细则	其他	中医养生
提示电脑族养生应从养肝开始	其他	中医养生
专家：夏季养生之全方位提醒	其他	中医养生
中医养生：房事养生四季有别	其他	中医养生
中医养生春日进补要恰到好处	其他	中医养生
中医养生：镜子里的健康物语	其他	中医养生
女性白领“时尚养生”有陷阱	其他	中医养生
练太极拳三观哲、伦理、养生	其他	中医养生
注重养生生活规律顺四季而变	其他	中医养生
春光大好办公室的一日养生	其他	中医养生
中医养生：月经期绿茶喝不得	其他	中医养生
又是春好处野菜好吃小心过敏	其他	中医养生
养生特殊补品――葱、姜、蒜	其他	中医养生
养生：女白领的十五杯滋补茶	其他	中医养生
研究提示常吃花生少得胆结石	其他	中医养生
补充营养按年龄吃饭健康养生	其他	中医养生
北齐颜之《颜氏家训》谈养生	其他	中医养生
中国儒家学派：孔子养生之道	其他	中医养生
在花开的时节我们去吃“花”	其他	中医养生
养生：春困，亮起亚健康信号	其他	中医养生
春捂秋冻春捂也要捂对时间	其他	中医养生
中医养生：春令佳蔬首推韭菜	其他	中医养生
注意不“酸”不“静”好养生	其他	中医养生
在练习气功时可以过性生活吗	其他	中医养生
中医:三春不同养生也不同	其他	中医养生
养生：和合之道老人长寿良方	其他	中医养生
春季：吃喝“酸碱”是有讲究	其他	中医养生
养生：老年人春季食补是上选	其他	中医养生
中医养生：清晨散步有益养生	其他	中医养生
中医养生：说说春季的养生粥	其他	中医养生
春季气温渐高早春避风如避箭	其他	中医养生
多喝水可以预防癌症每天八杯	其他	中医养生
睡前炖下粥早晨起来当早饭	其他	中医养生
中医养生祛湿暖胃养生汤二款	其他	中医养生
西兰花营养成份可防病属第一	其他	中医养生
调养身体春季养肝多食菠菜	其他	中医养生
配搭：春季养生菜谱新鲜出炉	其他	中医养生
中医养生“春捂秋冻”不科学	其他	中医养生
穿鞋静电危害健康赤脚抗衰老	其他	中医养生
中医讲春日养生四个辩证法	其他	中医养生
瞧瞧中医专家们的私家养生法	其他	中医养生
别拿生气赌健康导致多种疾病	其他	中医养生
在日常生活中脊柱保健四法	其他	中医养生
养生正负极时间疗法保健脏腑	其他	中医养生
房室养生学的“动而少泻”法	其他	中医养生
中医养生：菊花茶的功效多多	其他	中医养生
养生：老年睡姿应“卧如弓”	其他	中医养生
京城连续扬沙天应该吃点什么	其他	中医养生
据媒体报道养生酱菜风行日本	其他	中医养生
房事养生我国古代养生学特色	其他	中医养生
保精养生法	其他	中医养生
节欲保精，养神养性	其他	中医养生
哮喘病人的房室养生	其他	中医养生
糖尿病人的房室养生	其他	中医养生
病期及初愈禁欲	其他	中医养生
心血管病人的房室养生	其他	中医养生
运用古代房术纠正早泄	其他	中医养生
慢性病患者的房室养生	其他	中医养生
青少年的房室养生	其他	中医养生
中年人的房室养生	其他	中医养生
气功与房室养生	其他	中医养生
更年期调养八法	其他	中医养生
房室养生的起源	其他	中医养生
夏日养生水为先	其他	中医养生
音乐情景跑步	其他	中医养生
治腰椎病试试倒步走	其他	中医养生
让你的肩部更健美	其他	中医养生
晨运别在日出前	其他	中医养生
为什么锻炼后第二天才出现肌肉酸痛？应怎样防止？	其他	中医养生
旋转健身法	其他	中医养生
哪些运动最能减肥？	其他	中医养生
中医健身系列－散步	其他	中医养生
健身球	其他	中医养生
漂亮女性早晚活动操	其他	中医养生
女性健美十大要诀	其他	中医养生
哑铃美我身	其他	中医养生
黄豆滋养最宜人	其他	中医养生
预防颈椎病“七办法”	其他	中医养生
挺胸跷脚有益健康	其他	中医养生
夏练得法身体得益	其他	中医养生
水平运动延年益寿	其他	中医养生
脚跟走路延年益寿	其他	中医养生
锻炼心肺功能怎么走	其他	中医养生
运动疗法可缓解腰痛	其他	中医养生
餐前快步走可以降血脂	其他	中医养生
瑜伽帮你解决肠胃问题	其他	中医养生
练习瑜伽，降低血压	其他	中医养生
改善精神，初练者选择的精选姿势	其他	中医养生
瑜伽对心脑血管和体腺的益处	其他	中医养生
新瑜珈：塑绳吊起来健身	其他	中医养生
瑜伽的起源	其他	中医养生
关于瑜伽的流派	其他	中医养生
瑜伽姿势和体位为什么多取动物的名称？	其他	中医养生
瑜伽是发祥于古印度的一种神秘宗教	其他	中医养生
OL瑜伽六式疲倦一扫而空	其他	中医养生
养生：中医专家谈“补肾壮阳”	其他	中医养生
春季养生三重点:调神活动宽身	其他	中医养生
春日护肝正当时	其他	中医养生
被“春困”缠绕	其他	中医养生
养生就靠一个字：忙	其他	中医养生
春天的皮肤易过敏	其他	中医养生
春天注意自我排毒	其他	中医养生
肾亏悄悄缠上年轻女性	其他	中医养生
养生：阴阳古法为你带来新美丽	其他	中医养生
五谷杂粮也有“药性”	其他	中医养生
推荐：中医夏季养生之精神调养	其他	中医养生
中医话“养神”与养生的关系	其他	中医养生
已故领导人的长寿秘诀	其他	中医养生
盛夏当心孩子患上“暑假病”	其他	中医养生
夏季养生有些讲究可讲	其他	中医养生
中医养生：长夏防湿要淡补	其他	中医养生
中医养生教你如何逃脱亚健康	其他	中医养生
养生之生活起居全攻略	其他	中医养生
美女在思考――排毒，需要吗？	其他	中医养生
准备好了吗？要阳光也要运动	其他	中医养生
夏季养生“挑着”吃水果	其他	中医养生
养生经：吃得对就能睡得好	其他	中医养生
养生：我有我的运动健康随我行	其他	中医养生
养生：运动是把双刃剑过度会变笨	其他	中医养生
高温天谨防“情绪中暑”	其他	中医养生
太极拳：中老年最佳健身之道	其他	中医养生
养生：想要精神好需“敬重”午睡	其他	中医养生
“七少”养生心法	其他	中医养生
常用的安神助眠方	其他	中医养生
女性必学的五大养血法	其他	中医养生
药酒非万能十种人忌饮	其他	中医养生
“以脏补脏”有医学根据吗？？	其他	中医养生
秋季养生多“设防”哪几种疾病	其他	中医养生
秋天嗓子起火嘴唇发干怎么办	其他	中医养生
医生提醒：衣袜混洗易致病!!	其他	中医养生
果酒和水果，哪个最健康？	其他	中医养生
来自彭祖的房事养生诀窍	其他	中医养生
冬天使用热水泡脚有什么讲究	其他	中医养生
《道德经》养生要顺“自然”	其他	中医养生
经常喝大米粥，不容易得感冒	其他	中医养生
民间经常使用的抗衰防老方子	其他	中医养生
中医养生：饭后要做的三件事	其他	中医养生
冬季养生，应该合理进补水果	其他	中医养生
养生：冬天喝点膏方补补身体	其他	中医养生
中医养生：抗衰老“藕”当先	其他	中医养生
男士别以为梳头只是女人的事	其他	中医养生
汤，究竟该什么时候喝才养生	其他	中医养生
中药：冬虫夏草养生十大功效	其他	中医养生
养生：老人不要可惜剩饭菜了	其他	中医养生
养生：男子养生不可百日无姜	其他	中医养生
开启康熙大帝的养生绝密档案	其他	中医养生
养生：燕窝的确有养颜抗衰效	其他	中医养生
养生：柑橘放床头得到好睡眠	其他	中医养生
养生：药王孙思邈的养生妙法	其他	中医养生
传统中药店“礼数茶”很保健	其他	中医养生
养生：用药引送药的点睛之妙	其他	中医养生
专家推荐：冬季中医养生处方	其他	中医养生
中医养生食疗防睡眠障碍	其他	中医养生
十一种简便的萝卜食疗方	其他	中医养生
专家讲养生：立春与养生	其他	中医养生
万物复苏养生有“道”	其他	中医养生
健康：支气管哮喘的饮食调养	其他	中医养生
“骨折”病人的家庭饮食调养	其他	中医养生
传统医学：中医养生话七情！	其他	中医养生
中医养生之简易房事的调摄法	其他	中医养生
爱看电视的人不妨喝点银耳汤	其他	中医养生
调养胃病的三种食疗配方	其他	中医养生
养生保健：冬春转季要防盗汗	其他	中医养生
温馨提示：穿好袜子不感冒！	其他	中医养生
养生：节后要清肠“悠”着点	其他	中医养生
养生：何来春困以及应对方法	其他	中医养生
天多变上班族要注意防寒保暖	其他	中医养生
中医养生：经常熬夜吃点药膳	其他	中医养生
养生：三月早春需要预防风邪	其他	中医养生
中医养生心平气和老而不衰	其他	中医养生
提醒：锻炼前最好先吃根香蕉	其他	中医养生
中医养生：健康饮食如八分饱	其他	中医养生
中医养生春季养生全方位提醒	其他	中医养生
养生：对付亚健康中医有办法	其他	中医养生
关于养生要“说三道四”	其他	中医养生
中医推出舒缓压力3种小秘方	其他	中医养生
对于中医养生防病的面面观	其他	中医养生
选用中药来防治流感很有奇效	其他	中医养生
探讨中医养生学说的几点摘要	其他	中医养生
中医养生防治病中的理论观点	其他	中医养生
几款中医养生茶的适应和禁忌	其他	中医养生
中医养生法 春暖花开养生法	其他	中医养生
春“风”到来时要小心眩晕到	其他	中医养生
养生：别再懒啦赶快动起来！	其他	中医养生
最有创意西式药膳难倒老中医	其他	中医养生
细论养生：生病源于“过用”	其他	中医养生
中医养生久坐不动易得哪些病	其他	中医养生
运用312经络养生是很简单的	其他	中医养生
中医“头北脚南”睡眠更香甜	其他	中医养生
中医：春季养生吃穿睡行秘籍	其他	中医养生
养生之道与养生之术相差很多	其他	中医养生
中医养生：素食能使人长寿吗	其他	中医养生
万物复苏春季降糖宜清热养阴	其他	中医养生
没药酒（产后血晕）	药酒	
关节炎酒	药酒	
爬山虎叶药酒	药酒	
枫荷梨祛风湿酒	药酒	
松节酒	药酒	
虎骨木瓜酒Ⅰ	药酒	
虎骨木瓜酒Ⅱ	药酒	
虎骨龟版酒――原名“虎骨酒	药酒	
参茸木瓜药酒	药酒	
参蛇浸酒	药酒	
金钱白花蛇酒	药酒	
复方炙草乌药酒	药酒	
活血龙药酒	药酒	
散寒除湿―蠲痹宝酒	药酒	
肩关节周围炎―水蛭酒	药酒	
寒湿痹症―六乌酒	药酒	
补气血―顽痹酒	药酒	
通利关节―草乌风湿酒	药酒	
肌肉疼痛―通痹灵酒	药酒	
滋阴益气―龟蛇酒	药酒	
疏通经络―痹必蠲酒	药酒	
温通血脉―桃红酒	药酒	
治疗痹症―蜈蚣酒	药酒	
肌筋膜炎―化瘀逐痹酒	药酒	
风湿关节炎―类风湿中药浸酒	药酒	
脱肛、痔疮、直肠息肉酒	药酒	
褥疮酒	药酒	
软组织炎酒	药酒	
瘿瘤、瘰疬酒	药酒	
疗疮酒	药酒	
痈疽疮疡酒	药酒	
烧伤酒	药酒	
前列腺增生酒	药酒	
肠梗阻酒	药酒	
止嗽定喘药酒	药酒	
健脾理气类药酒	药酒	
益气类药酒	药酒	
低血压治疗偏方	药酒	
感冒水(酊)	药酒	
搐鼻药酒	药酒	
姜蒜柠檬酒（风寒感冒）	药酒	
葱姜盐酒（感冒）	药酒	
荆芥豉酒（外感风寒）	药酒	
葱豉酒（发热头痛）	药酒	
桑菊酒（清热解毒）	药酒	
加味葱豉酒（外感风寒）	药酒	
附于杜仲酒（感冒）	药酒	
肉桂酒（风寒感冒）	药酒	
银蒲羌蒡酒（外感发热）	药酒	
矾石酒（体质虚弱）	药酒	
桂圆和气酒（身体虚弱）	药酒	
参归补虚酒	药酒	
桂圆酒（补气益精）	药酒	
茴香小雀酒	药酒	
桂姜萸酒	药酒	
感冒药酒	药酒	
咳喘药酒	药酒	
肺痨骨蒸酒	药酒	
胃腹疼痛酒	药酒	
恶心呕吐、消化不良酒	药酒	
寄生虫药酒	药酒	
泻痢药酒	药酒	
疟酒	药酒	
黄疸药酒	药酒	
疝酒	药酒	
头痛、眩晕酒	药酒	
失眠、心悸、健忘酒	药酒	
烦躁忧郁酒	药酒	
癫痫、惊狂酒	药酒	
心痛厥脱酒	药酒	
出血酒	药酒	
阳痿不育酒	药酒	
淋症、便秘、溺精酒	药酒	
肿胀酒	药酒	
徵瘕瘤癌酒	药酒	
解毒酒	药酒	
痉酒	药酒	
肩周炎酒	药酒	
心脑血管疾病酒	药酒	
痛症酒	药酒	
耳鸣酒	药酒	
矽肺酒	药酒	
周围神经断裂吻合术	药酒	
癫痫酒	药酒	
囊虫酒	药酒	
复发性口疮酒	药酒	
其他药酒	药酒	
地黄元胡酒（产后恶露）	药酒	
丹参元胡酒（腹痛）	药酒	
延胡索酒（腹内疼痛）	药酒	
加味四物酒（产后中风）	药酒	
寄生黑豆酒（产后中风）	药酒	
僵蚕豆淋酒（产后中风）	药酒	
独活人参酒（产后中风）	药酒	
鸡粪酒（产后中风）	药酒	
黄芪防风酒（中风）	药酒	
海虾酒（产后缺乳）	药酒	
奶浆参酒（跌打损伤）	药酒	
鱼灰酒（乳汁不下）	药酒	
闭经酒	药酒	
痛经酒	药酒	
崩漏酒	药酒	
月经不调、不孕	药酒	
带下酒	药酒	
妊娠诸疾	药酒	
难产酒	药酒	
产后诸疾	药酒	
妇人嫁痛	药酒	
妇人杂病	药酒	
人流综合征	药酒	
外擦药酒方（腮腺炎）	药酒	
七味药酒方（肢麻痹症）	药酒	
艾韭酒（硬皮症）	药酒	
青梅煮酒（食欲不振）	药酒	
二仁酒（急、慢惊风）	药酒	
清肝熄凤酒（急惊风）	药酒	
牛黄酒（小儿惊痫）	药酒	
木防己酒（小儿风病）	药酒	
紫石酒（小儿风病）	药酒	
独活酒（小儿风痛）	药酒	
二姜酒（呕吐）	药酒	
姜醋酒方（呕吐）	药酒	
牛蒡蝉蜕酒（咽喉肿痛）	药酒	
地龙酒（血热毒盛）	药酒	
柑豆叶酒（麻疹）	药酒	
糯米酒（小儿麻疹）	药酒	
芜姜酒（麻疹）	药酒	
牛膝兰草酒（百日咳）	药酒	
葱肠酒（百日咳）	药酒	
外擦药酒方（高效神昏）	药酒	
三味葱白酒（小儿低热）	药酒	
红枣酒（小儿低热）	药酒	
星黄酒（风热感冒）	药酒	
吴茱萸酒（小儿感冒）	药酒	
过敏性阴茎包皮水肿―栀子酒	药酒	
胎寒腹痛―当归猪肉酒	药酒	
惊痫―牛黄酒	药酒	
风痫―木防已酒	药酒	
风痫―独活防己酒	药酒	
风痫―紫石附子酒	药酒	
疟疾―常山桂心酒	药酒	
囟开迟闭―半夏细辛酒山	药酒	
阴茎包皮水肿―栀地酒	药酒	
华山矾酒（狂犬咬伤）	药酒	
草兰根酒（疯犬咬伤）	药酒	
蛇咬伤药酒	药酒	
小红藤酒（毒蛇咬伤）	药酒	
蛇伤治酒	药酒	
复方山扁豆酒（毒蛇咬伤）	药酒	
蛇伤药酒（毒蛇咬伤）	药酒	
蛇伤药酒（蛇咬伤）	药酒	
芪斛酒（鹤膝风）	药酒	
消肥酒（鹤膝风）	药酒	
紫荆皮酒（鹤膝风）	药酒	
解毒消疮酒（杨梅疮）	药酒	
金蟾脱甲酒（杨梅疮）	药酒	
三香酒（止痛）	药酒	
吴萸子酒（寒疝颁发）	药酒	
苦毒酒（脱肛）	药酒	
黄芪酒（气虚脱肛）	药酒	
大黄地榆酒（痔疮肿痛）	药酒	
苦参酒（痔疮肿痛）	药酒	
二甲酒（内痔）	药酒	
觅根酒（跌打损伤）	药酒	
竹酒（痔疮）	药酒	
地瓜藤酒（痔疮）	药酒	
槐酒（五痔）	药酒	
槐枝酒（痔疮）	药酒	
紫菜黄独酒（甲状腺肿大）	药酒	
复方黄药子酒（甲状腺肿大）	药酒	
黄药子酒（痰热）	药酒	
老蛇盘酒（淋巴结结核）	药酒	
玄参酒（瘰疬寒热）	药酒	
首乌酒（瘰疬结核）	药酒	
白头翁酒（瘰疬）	药酒	
海藻乌蛇酒（风毒所攻）	药酒	
海藻昆布浸酒（瘰疬）	药酒	
桑椹醪（瘰疬）	药酒	
鳖甲浸酒方（瘘疮）	药酒	
瘰疬药酒方（结核）	药酒	
蜘蛛浸酒方（结核）	药酒	
内消酒（风热毒气）	药酒	
乳痈酒	药酒	
蛇虫咬伤酒	药酒	
外科虚症酒	药酒	
脱疽酒	药酒	
头虱酒	药酒	
苦百酒（痤疮）	药酒	
去结药水（结节性痒疹）	药酒	
满天星酒（丹毒）	药酒	
复方五加皮酒（烫伤烧伤）	药酒	
鸡蛋清外涂酒（烧伤、烫伤）	药酒	
喜榆酒（烧烫伤）	药酒	
大黄槐角酒（烧伤）	药酒	
复方地茶酒（烧伤）	药酒	
苦参黄柏酒（肿痛欲脱）	药酒	
茵陈酒（关节酸痛）	药酒	
独活浸酒方（脚气）	药酒	
丹参石斛酒(脚气痹弱)	药酒	
牛膝丹参酒方（脚气）	药酒	
金牙酒(脚气屈弱)	药酒	
防治冻伤酒	药酒	
姜椒酒（冻疮）	药酒	
石斛浸酒方（脚气痹挛）	药酒	
牛膝酒方（脚气）	药酒	
生地黄酒（脚气肿满）	药酒	
金牙酒（祛风解毒）	药酒	
酸枣仁酒（脚气疼痛）	药酒	
侧于酒（益气血）	药酒	
侧子酒（温经散寒）	药酒	
侧子酒（活血通络）	药酒	
白癜风药酒	药酒	
麻风药酒	药酒	
皮肤瘙痒药酒	药酒	
治疣药酒	药酒	
疥疮药酒	药酒	
鱼鳞病药酒	药酒	
辣椒陈皮治老年关节炎	药酒	
双乌木瓜酒（大骨节病）	药酒	
松酒（大骨节病）	药酒	
五木皮酒（关节炎）	药酒	
麻根四虫酒（破伤风）	药酒	
天麻四虫酒（破伤风）	药酒	
二乌骨刺酒（骨质增生）	药酒	
崔氏例子酒（脚气）	药酒	
乌药酒（脚气）	药酒	
黑豆酒（脚气）	药酒	
松节酒（脚气）	药酒	
白杨皮酒（风毒脚气）	药酒	
二味独活酒（脚气）	药酒	
蚤休酒（毛囊炎）	药酒	
藤黄苦参酒（毛囊炎）	药酒	
疮、疹、癣药酒	药酒	
牛皮癣药酒	药酒	
梅毒药酒	药酒	
斑秃药酒	药酒	
冻伤药酒	药酒	
复方当归酒（骨质增生）	药酒	
骨质增生酒（关节炎）	药酒	
山虎洋参酒（重型瘫痪）	药酒	
截瘴风湿酒（外伤性痉挛）	药酒	
白背三七酒（外伤出血）	药酒	
接骨草酒（骨折愈合）	药酒	
风伤药酒（骨折）	药酒	
接骨至神酒（跌打损伤）	药酒	
整骨床药酒（跌打损伤）	药酒	
二乌进骨酒（祛风除湿）	药酒	
三度药酒（跌打损伤）	药酒	
风湿痛药酒	药酒	
刘寄奴酒（跌打损伤）	药酒	
红花漫酒（趺打损伤）	药酒	
丢了棒药酒（跌打损伤）	药酒	
跌打损伤酒	药酒	
三七跌打酒	药酒	
颈椎病药酒	药酒	
急性扭挫伤药酒	药酒	
骨折药酒	药酒	
骨质增生药酒	药酒	
半月板损伤药酒	药酒	
颞颌关节功能紊乱药酒	药酒	
骨质疏松药酒	药酒	
软组织损伤药酒	药酒	
腰椎间盘突出药酒	药酒	
网球肘药酒	药酒	
增生性脊椎炎药酒	药酒	
八月札酒（子宫下坠）	药酒	
归芪酒（子宫脱垂）	药酒	
小金樱酒（子宫脱垂）	药酒	
仙改酒（肾阳亏虚）	药酒	
二根茴香酒（痛经）	药酒	
养精种玉酒（妇人身瘦）	药酒	
巴戟天酒（肾无虚寒）	药酒	
延寿扶嗣酒（身体虚弱）	药酒	
排卵酒	药酒	
种玉酒（月经不调）	药酒	
忍冬酒（产后体虚）	药酒	
山莲藕酒（产后血虚）	药酒	
五加皮浸酒方（妇人痹瘦）	药酒	
独活肉桂酒（产后体虚）	药酒	
糯米酒（产后虚弱）	药酒	
杜仲酒（产后脏虚）	药酒	
灵芝桂圆酒（身体虚弱）	药酒	
胡桃酒（产后虚喘）	药酒	
双仁酒（产后津伤）	药酒	
地黄煮酒（瘀血）	药酒	
逐血调中酒（产后血晕）	药酒	
追风药酒	药酒	
海风藤药酒	药酒	
蛇虫酒	药酒	
筋骨疼痛酒	药酒	
慧苡仁醪	药酒	
丝瓜络酒	药酒	
蕲蛇药酒	药酒	
雪莲药酒	药酒	
舒筋活血酒	药酒	
蕲蛇天麻酒――原名“蕲蛇药酒”	药酒	
当归松叶酒	药酒	
芍药生地酒――原名“芍药酒”	药酒	
列节浸酒	药酒	
虎骨牛膝酒	药酒	
松节祛风酒――原名“松节浸酒方”	药酒	
松膏浸酒	药酒	
松节酿酒――原名“松节酒”	药酒	
柏节酒	药酒	
摄风酒	药酒	
草酒	药酒	
野驼脂酒	药酒	
虎骨地黄酒――原名“虎骨酒”	药酒	
大黄芪酒	药酒	
狗骨胶酒	药酒	
虎杖酒	药酒	
臂痛药酒	药酒	
白蛇草乌酒	药酒	
颈腰痛擦酒	药酒	
附子酒	药酒	
泽兰酒	药酒	
复方当归酒	药酒	
火赤链蛇酒	药酒	
双乌花酒	药酒	
漏肩风―漏肩风药酒	药酒	
肩周炎―秦艽木瓜酒	药酒	
祛风除湿―除痹酒	药酒	
温经养血―两乌愈风酒	药酒	
消肿止痛―乌七酒	药酒	
散寒止痛―二乌止痛酒	药酒	
补肾活血―壮酒	药酒	
治疗痹证―三乌酒	药酒	
祛风、散寒―藏医药酒	药酒	
化湿通络―风湿灵药酒	药酒	
清热消肿―马钱乌蛇酒	药酒	
补养肝肾―类风湿药酒	药酒	
中风后遗症―鹿茸二鞭酒	药酒	
活血止痛―七叶莲酒	药酒	
祛风通络―强壮祛风药酒	药酒	
肩周炎―复方忍冬酒	药酒	
风湿性关节炎―加昧风湿灵酒	药酒	
类风湿性关节炎―昆明山海棠酒	药酒	
牙宣―郁李酒	药酒	
龋齿牙痛―止痛酒	药酒	
各类型牙痛―四千茶叶酒	药酒	
止牙痛药酒	药酒	
松香酒（牙痛不止）	药酒	
独活酒（风寒牙痛）	药酒	
山峰酒（牙痛）	药酒	
蜂房酒（牙龈肿痛）	药酒	
齿根松动疼痛―齿痛酒	药酒	
西洋参酒（少气口干）	药酒	
枝枝相（暗哑无声）	药酒	
柏子仁酒（中风失者不语）	药酒	
蜜膏酒（声音嘶哑）	药酒	
丹砂酒方（急喉痹）	药酒	
槐白皮酒（牙疳、喉疾）	药酒	
商鼻液（鼻塞）	药酒	
口齿病药酒	药酒	
咽喉病药酒	药酒	
鼻病药酒	药酒	
耳病药酒	药酒	
眼病药酒	药酒	
丁薄擦剂（毛虫皮炎）	药酒	
恶实根酒（赤游风）	药酒	
枳壳酒（赤游风）	药酒	
当归荆芥酒（伤裂皮肤）	药酒	
杜仲山芋酒――原名“杜仲酒”	药酒	
虎骨羊角酒――原名“虎骨酒”	药酒	
萆薛附子酒――原名“萆Z浸酒”	药酒	
黑豆地黄酒	药酒	
腰痛酒	药酒	
葱子酒	药酒	
强肾活血酒	药酒	
萆薄浸酒方	药酒	
海桐羌活酒	药酒	
虎骨侧子酒	药酒	
复方白蛇酒	药酒	
虎潜酒	药酒	
虎骨酒	药酒	
牛蒡根酒	药酒	
乌黏子浸酒	药酒	
仙灵桂附酒	药酒	
羌独活酒	药酒	
独活参附酒	药酒	
桂术苓甘酒	药酒	
薏苡防风酒	药酒	
蓼木秫米酒	药酒	
加味地黄酒	药酒	
活血止痛―乌蛇灵仙酒	药酒	
坐骨神经炎―乌头地龙酒	药酒	
软坚化骨―化骨健步酒	药酒	
除湿散寒―祛痰通络酒	药酒	
杜仲牛膝酒	药酒	
杜仲独活酒	药酒	
地黄杨皮酒	药酒	
牛膝椒附酒	药酒	
牛膝羌附酒	药酒	
牛膝海桐酒	药酒	
牛膝桂心酒	药酒	
牛膝枣仁酒	药酒	
萆薛酒	药酒	
菊花杜仲酒	药酒	
海桐皮浸酒	药酒	
秦艽牛膝酒	药酒	
青囊药酒	药酒	
虎骨浸酒方	药酒	
杜仲石楠酒	药酒	
花蛇虎骨酒	药酒	
补益黄芪酒	药酒	
石斛牛膝酒	药酒	
石花酒	药酒	
石松酒	药酒	
巴戟羌活酒	药酒	
补益黄芪浸酒	药酒	
五加皮虎骨漫酒	药酒	
牛膝羚羊酒	药酒	
牛膝虎骨酒	药酒	
五加壮腰酒	药酒	
牛蒡杜仲酒	药酒	
天雄杜仲酒	药酒	
骨质增生―骨增酒	药酒	
壮骨止痛―透骨祛风酒	药酒	
壮腰健腿―健腰蠲痹酒	药酒	
通行血脉―复方闹羊花酒	药酒	
强筋健骨―蠲痹酒	药酒	
补肝益肾―四虫雪莲酒	药酒	
温经散寒―去风止痛酒	药酒	
温经通络―仙丹酒	药酒	
疏风散寒―麻双桂酒	药酒	
疏风散寒―海马千年健酒	药酒	
逐瘀活络―蝎王酒	药酒	
温经散寒―独活川芎酒	药酒	
逐寒祛湿―风湿药酒	药酒	
活血通络―独活寄生酒	药酒	
强筋健骨―黑尾胡蜂酒	药酒	
补肾活血―乌龙舒筋酒	药酒	
补肾活血―补肾蕲蛇酒	药酒	
风湿性―颈肩腰腿痛酒	药酒	
活血化瘀―马钱乳香酒	药酒	
治疗腰痛―二乌乳没药酒	药酒	
筋骨痿软―杜威酒	药酒	
通络柔筋―坐骨神经痛酒	药酒	
治腰腿痛―双乌酒	药酒	
止痛消肿―健枫肉桂酒	药酒	
坐骨神经痛―乌头黄芪酒	药酒	
治坐骨神经痛―舒心镇痛酒	药酒	
抗风湿酒	药酒	
半枫荷叶酒	药酒	
九层风酒	药酒	
长宁风湿酒	药酒	
三蛇酒	药酒	
乌蛇浸酒	药酒	
乌鸡桂圆酒	药酒	
六方藤药酒	药酒	
风湿酒	药酒	
风湿酒(部队方)	药酒	
风湿酒Ⅰ	药酒	
风温酒Ⅱ(乙方)	药酒	
风湿骨痛酒Ⅱ	药酒	
风湿酒Ⅱ(甲方)	药酒	
风湿骨痛酒Ⅰ	药酒	
五加皮药酒	药酒	
五加皮酒	药酒	
加味风湿酒	药酒	
玉藤风湿酒	药酒	
白蒺藜药酒	药酒	
风痹脚气―松液酒	药酒	
痹挛掣痛―松节浸酒	药酒	
四肢掣痛―松节缓急酒	药酒	
风毒脚弱―磐石附豉酒	药酒	
脚气病虽愈―侧子附子酒	药酒	
消瘦拘挛―钟乳丹参酒	药酒	
缓风急风―枳壳酒	药酒	
脚气发作―独活地黄酒	药酒	
风毒湿痹―附子独活酒	药酒	
头眩气满―苏恭独活酒	药酒	
语育謇涩―恶实枳壳酒	药酒	
上气腹―野椒根酒	药酒	
头目眩晕―黑豆白芷酒	药酒	
脚气―蒜豉桃仁酒	药酒	
四肢拘急―薏苡羚羊酒	药酒	
脚气―鹭鸶藤酒	药酒	
脚痛痿弱―黄芪钟乳酒	药酒	
九藤酒	药酒	
二圣酒	药酒	
黑豆浸酒方	药酒	
豆淋酒	药酒	
瘫痪腿疼―秘传药酒	药酒	
祛风除湿―蚕沙酒	药酒	
心膈壅闭―消梨饮子	药酒	
短气欲死―深师防风酒	药酒	
活血化瘀―鹿祁酒	药酒	
身体顽麻―黄芪天麻酒	药酒	
皮肤瘙痒―济生黄芪酒	药酒	
头痛颈强―排风缓急酒	药酒	
中风偏瘫―麻子黑豆酒	药酒	
肢体麻木―喇嘛酒	药酒	
麻木瘅痛―喇嘛归芎酒	药酒	
口喁面戾―鼠黏子酒	药酒	
肢体不收―蓖麻酒	药酒	
手足拘挛―窦侍御仙酒	药酒	
手足不遂―黑豆丹参酒	药酒	
口眼喁斜―愈风酒	药酒	
中风后遗症―海蜇愈风酒	药酒	
肌肉干燥―增损茵芋酒	药酒	
偏枯不遂―凝水石酒	药酒	
一切风―牛蒡桑椹酒	药酒	
治风―牛劳根浸酒	药酒	
牛蒡地黄酒	药酒	
偏枯不遂―蛮夷桂心酒	药酒	
祛痰―巴豆酒	药酒	
温经活血―红花肉桂酒	药酒	
化痰熄风―牵正散加桂枝药酒	药酒	
滋补肝肾―敦煌佛赐酒	药酒	
神经麻痹―桂防酒	药酒	
肩背伛偻―茯苓菊花浸酒	药酒	
治中风―茱萸鼓酒	药酒	
九制稀莶草药酒	药酒	
白术菊花酒	药酒	
万应愈风酒	药酒	
牛膝蚕沙酒	药酒	
青松叶浸酒	药酒	
龙手藤酒	药酒	
牛膝细辛酒	药酒	
天麻二蛇酒	药酒	
天寥乌蛇酒	药酒	
天麻地黄酒	药酒	
仙灵天麻酒	药酒	
仙酒方	药酒	
仙传药酒	药酒	
石斛天麻酒	药酒	
地黄附子酒	药酒	
全蝎酒	药酒	
芎羌活酒	药酒	
杏仁酒方	药酒	
夜合枝酝酒	药酒	
祛风酒	药酒	
世传白花蛇酒	药酒	
虎骨愈瘫酒	药酒	
独活南星酒	药酒	
茵芋酒	药酒	
胡麻浸酒	药酒	
牵正独活酒	药酒	
柏子仁酒	药酒	
浸药仙酒	药酒	
茵芋天麻酒	药酒	
痛灵酒	药酒	
首乌苡仁酒	药酒	
风湿药酒(吉林方)	药酒	
风湿骨痛药酒(剧)	药酒	
风湿骨痛酒	药酒	
丁公藤酒	药酒	
三蛇胆汁酒	药酒	
巨胜酒方	药酒	
枫蛇酒	药酒	
狗脊酒	药酒	
狗脊煮酒	药酒	
杜仲酒	药酒	
杜仲乌头酒――原名“杜仲酒”	药酒	
杜仲丹参酒――原名“杜仲酒”	药酒	
杜仲细辛酒――原名“杜仲酒”	药酒	
杜仲壮腰酒――原名“杜仲酒”	药酒	
杜仲地黄酒――原名“杜仲酒”	药酒	
杜仲羌活酒――原名“杜仲酒”	药酒	
杜仲当归酒――原名“杜仲浸酒”	药酒	
养生延年―五香烧酒	药酒	
大补养身―人参姜蜜酒	药酒	
气弱阳衰―周公百岁酒	药酒	
治风虚―乌麻地黄酒	药酒	
壮肾阳―参茸补血酒	药酒	
通血脉―常山太守马灌酒	药酒	
愉悦精神―怡神酒	药酒	
补益延年―黄精酒	药酒	
治疗虚劳―茯苓酒	药酒	
益肾壮阳―琼浆药酒	药酒	
安心神―宜男酒	药酒	
补血熄风―定风酒	药酒	
强身活血―强身药酒	药酒	
散寒止痛―参桂养荣酒	药酒	
调补阴阳―滋阴百补药酒	药酒	
磁石石斛酒―原名“磁石酒”	药酒	
脾肾阳虚―参椒酒	药酒	
滋阴壮阳―魏国公红颜酒	药酒	
补肝肾―虎鹿二仙酒	药酒	
益精血―聚宝酒	药酒	
和气血―固本遐龄酒	药酒	
鹿茸山药酒―原名“鹿茸酒”	药酒	
滋补腰肾―参茸貂鞭药酒	药酒	
益精髓―薯蓣酒	药酒	
益气补血―参茸三七酒	药酒	
祛风补血益气―虎骨苡仁酒	药酒	
神经衰弱―安神酒	药酒	
补肾壮阳―巴戟熟地酒	药酒	
益精固髓―参杞酒	药酒	
温补心脾―桂圆醴	药酒	
安五脏―钟乳酒	药酒	
补益肝肾―首乌酒	药酒	
强身祛病―枸杞桂心酒	药酒	
固肾―春寿酒	药酒	
补益强身―神仙酒	药酒	
治风冷虚劳―枸杞鹿骨酒	药酒	
虚羸黄瘦―神仙枸杞子酒	药酒	
聪耳明目―保命延寿烧酒	药酒	
通顺血脉―钟乳石斛酒	药酒	
理脾胃―种子延龄酒	药酒	
补五脏―神仙乌麻酒	药酒	
补养五脏―钟乳黄芪酒	药酒	
和气血―神仙延寿酒	药酒	
延龄安神―长生药酒	药酒	
延龄轻身―苍耳延龄酒	药酒	
补益―回春仙酒	药酒	
填骨髓，长肌肉―枸杞香豉酒	药酒	
壮肾阳―参茸药酒	药酒	
补益―补心酒	药酒	
治风热羸老―羊桃酒	药酒	
壮阳―鹿药酒	药酒	
益精气―壮元酒	药酒	
健脾补气―保元酒	药酒	
保健强身―九仙酒	药酒	
健脾补肾―三味抗衰酒	药酒	
补气补血―五龙二补酒	药酒	
补肾壮阳―百年春补酒	药酒	
活血补血―阿胶老酒液	药酒	
益寿延年―强身羊肾酒	药酒	
延年益寿―复方红宝酒	药酒	
补肾益气―敬父葆春酒	药酒	
补气健脾―乌杞蝎精酒	药酒	
益气温阳―如意酒(安徽)	药酒	
补肾壮阳―复方海马药酒	药酒	
益精气―石燕酒	药酒	
培补气血―十全大补酒	药酒	
温肾壮阳―长寿药酒	药酒	
滋精养血―疗疾延寿酒	药酒	
精亏血少―雪花酒	药酒	
消化道癌瘤―猕猴桃根酒	药酒	
肾阳不振―期颐酒	药酒	
助阳气―腽肭脐酒	药酒	
延年益寿―精神药酒	药酒	
养生至宝―鹤龄延寿丹浸酒方	药酒	
疲乏神倦―御龙酒	药酒	
香豉酒	药酒	
香豉犀角酒	药酒	
香豉橘皮酒	药酒	
大麻子酒	药酒	
大金牙酒	药酒	
天门冬地黄酒	药酒	
孔子蘖酒	药酒	
牛膝杜仲酒	药酒	
沃实酒	药酒	
乌药酒	药酒	
牛膝丹参酒	药酒	
生地黄酒	药酒	
筋骨疼痛―石斛参芪酒	药酒	
手足拘挛―白杨皮酒	药酒	
脚气弱风虚―术膏酒	药酒	
脚气痹挛―石斛慧苡酒	药酒	
腿脚肿胀―苍术豉酒	药酒	
脚气不随―侧子紫苏酒	药酒	
疼痛无力―侧子仙员脾酒	药酒	
脚气―侧子续断酒	药酒	
脚气―侧子石膏酒	药酒	
手指胀闷―侧子石楠酒	药酒	
惊悸不宁―金牙升麻酒	药酒	
脚气屈弱―金牙酒	药酒	
骨节疼痛―松叶酒	药酒	
跌伤疼痛―河蟹酒	药酒	
恶血蓄瘀―橘子酒	药酒	
跌伤―麻根汁酒	药酒	
打伤―续筋接骨酒	药酒	
跌打损伤―外用扭伤药酒	药酒	
瘀血凝滞―茴香故纸酒――原名“茴香酒”	药酒	
活血化瘀―闪挫止痛酒	药酒	
腹胁腰膝―内伤药酒	药酒	
因疮中风―蚕子酒	药酒	
散瘀止血―菊三七药酒	药酒	
打伤、压伤―痰痛药酒	药酒	
善通经络―紫金酒	药酒	
伤损瘀血―化瘀止痛酒	药酒	
地黄丹皮酒――原名“地黄酒”	药酒	
血滞经闭―苏木红花酒	药酒	
宿血―大黄蚯蚓酒	药酒	
膛痛―鹿角棘针酒	药酒	
舒筋活络―舒活酒	药酒	
活血化瘀―双牛跌打酒	药酒	
跌打损伤―紫金酒(李氏正骨验方)	药酒	
骨折―三角枫酒	药酒	
风湿腰腿痛―见肿消酒	药酒	
外伤疼痛―舒筋乐	药酒	
舒筋活络―舒筋止痛灵	药酒	
消肿止痛―骨伤药酒	药酒	
通十二经脉―通草酒	药酒	
补中益气―人参酒	药酒	
大补元气―人参枸杞酒	药酒	
健步温阳―健步酒	药酒	
面色萎黄―人参茯苓酒	药酒	
除风气―乌麻酒	药酒	
肝肾虚损―益肾明目酒	药酒	
养脏腑，调脾胃―八珍酒	药酒	
补益―归圆酒	药酒	
壮阳固精―仙灵固精酒	药酒	
补精益气―仙灵橘皮酒	药酒	
治虚劳不足―五加杞皮酒	药酒	
大补心神―五加地黄酒	药酒	
滋补，延寿―三仙延寿酒	药酒	
补肾―益肾酒	药酒	
养生保健―山芋酒	药酒	
补肝肾―桑椹酒	药酒	
延年益寿―万寿药酒	药酒	
体质衰弱―养荣酒	药酒	
滋阴养血―延寿瓮头春	药酒	
理脾胃―浸黄酒方	药酒	
强健悦泽―生石斛酒	药酒	
补肾―益智酒	药酒	
补肾助阳―健阳酒	药酒	
补中益气―党参酒	药酒	
桑椹柠檬酒一原名“桑椹酒”	药酒	
补元气、益精神―回春酒	药酒	
明目安神―杞圆酒	药酒	
补益―补酒方	药酒	
补气血―鹿茸酒	药酒	
强壮筋骨―杞圆药酒	药酒	
滋阴补血―秘传三意酒	药酒	
养血明目―杞蓉药酒	药酒	
补益精气―鹿头酒	药酒	
百体受益―百益长春酒	药酒	
补益虚损―吴棹仙精神药酒	药酒	
补虚损不足―菊花酒	药酒	
菊花延年酒―原名“菊花酒”	药酒	
补肝肾―百药长酒	药酒	
治一切风血―羊不吃草酒	药酒	
明目乌须―冬青子酒	药酒	
大补元气―羊羔酒	药酒	
大补元阳―戊戌酒	药酒	
补虚延年―延寿酒	药酒	
轻身明目―崔氏地黄酒	药酒	
添精益髓―延寿获嗣酒	药酒	
益气补血―大补药酒	药酒	
舒筋活血―参茸酒(江苏方)	药酒	
阴虚内热―女贞子酒	药酒	
补虚健腰膝―女贞皮酒	药酒	
祛风除湿―参茸酒Ⅰ	药酒	
牛膝人参酒―原名“牛膝酒”	药酒	
助气固精―参茸酒Ⅱ	药酒	
菊花明目酒―原名“菊花酒”	药酒	
补肾壮腰―康宝补酒	药酒	
治疗筋骨疫痛―菊杞调元酒	药酒	
肝肾不足―康壮酒	药酒	
营卫不充―地黄枸杞酒	药酒	
补肺阴―西洋参酒	药酒	
黄精门冬酒―原名“黄精酒”	药酒	
延年益寿―延龄酒	药酒	
通血脉―菖蒲酒	药酒	
补肝肾―还童酒	药酒	
滋补风虚―长松酒	药酒	
补血活血―鸡血藤酒	药酒	
延年轻身―天门冬酒	药酒	
补肝肾―何首乌酒	药酒	
五劳七伤―扶衰仙凤酒	药酒	
滋补强壮―灵芝酒	药酒	
补益―鸡苏酒	药酒	
壮筋骨―长春酒	药酒	
肝肾虚损―苁蓉强壮酒	药酒	
补气血―补气养血酒	药酒	
肝肾虚损―补益酒	药酒	
调顺血气―虎骨健身养心酒	药酒	
活血祛瘀―云南白药酒	药酒	
养颜药酒五款	药酒	
归芪白芍酒（面色无华）	药酒	
雄鸡酒（补益增白）	药酒	
桂圆和气酒（皮肤粗糙）	药酒	
桃花酒（皮肤老化）	药酒	
猪膏酒（面色无华）	药酒	
桃仁朱砂酒（面色不华）	药酒	
白鸽滋养酒（干血痨）	药酒	
地黄糯米酒（须发早白）	药酒	
逡巡酒（悦色美容）	药酒	
矾石酒（面色无华）	药酒	
玉液酒（肌肤租糙）	药酒	
核桃杜仲酒（面色无华）	药酒	
地杞血藤酒（面容萎黄）	药酒	
三圣酒（久病体虚）	药酒	
参杞酒（皮肤老化）	药酒	
美容酒（容颜憔悴）	药酒	
鸡子美容酒（面色无华）	药酒	
归元酒（皮肤老化）	药酒	
面色无华―猪膏酒	药酒	
润肌泽肤―葡萄酒	药酒	
秃发―蔓荆附子酒	药酒	
发白反黑―五精酒	药酒	
皮肤光润―牛膝大豆酒	药酒	
面肝―鸡子美容酒	药酒	
阴虚肾弱―麇骨酒	药酒	
面黑―白面酒	药酒	
面肝黯―羚胆酒	药酒	
润泽肌肤―熙春酒	药酒	
润肤―酸枣仁酒	药酒	
润泽肌肤―菖蒲白术酒	药酒	
灭瘢痕―商陆门冬酒	药酒	
面黯、面部黑斑―桃花白芷酒	药酒	
美容颜―桃花酒	药酒	
红润肌肤―桃仁朱砂酒	药酒	
延缓衰老―逡巡酒	药酒	
滋润皮肤―换骨酒	药酒	
乌须黑发―乌须黑发药酒	药酒	
乌须黑发―羹髯醑	药酒	
保持容颜―枸杞三仁酒	药酒	
滋润肌肤―养生酒	药酒	
面色无华―圆肉补血酒	药酒	
皮肤光悦红润―桃仁酒	药酒	
须发早白―首乌归地酒	药酒	
皮肉红润―枸杞地黄酒	药酒	
皮肉红润―硫黄药酒	药酒	
洁白肌肤―姜桂酒	药酒	
乌黑头发―固本地黄酒	药酒	
肌肤变白―放杖木酒	药酒	
须发早白―补血顺气药酒	药酒	
容颜无华―却老酒	药酒	
保持容颜―红颜酒	药酒	
白发变黑―地黄酒酥	药酒	
美容、灭瘢―地黄桂心酒	药酒	
益颜色―生薯药酒	药酒	
驻颜色―术酒	药酒	
乌须黑发―一醉散	药酒	
养血乌须黑发―一醉不老丹	药酒	
光泽肌肤―五加泽肤酒	药酒	
乌须黑发―中山还童酒	药酒	
乌须黑发―乌须酒	药酒	
治脱发―外用生发酒	药酒	
生发―治发落酒	药酒	
泽肌肤、美毛发―玉液酒	药酒	
聪耳明目―矾石酿酒	药酒	
冰砂酊（癌肿疼痛）	药酒	
八角莲酒（乳腺癌）	药酒	
地术酒（腰膝酸软）	药酒	
大贝母酒（乳腺癌）	药酒	
血管瘤擦剂（血管瘤）	药酒	
紫杉酒（白血病）	药酒	
鳗鱼酒（白血病）	药酒	
止痛擦剂	药酒	
香寥子酒（癌瘤疼痛）	药酒	
消痪抗癌酒（甲状腺癌）	药酒	
秤砣梨酒（子宫颈癌）	药酒	
三桔酒（乳癌）	药酒	
止痛擦剂（晚期癌瘤）	药酒	
蟹壳酒（乳腺癌）	药酒	
鲜橙酒（乳腺癌）	药酒	
红花浸酒	药酒	
大力药酒	药酒	
三七药酒	药酒	
丢了棒药酒	药酒	
《伤科补要》药酒方	药酒	
擦酒	药酒	
没药鸡子酒	药酒	
杏枝酒	药酒	
地黄桃仁酒――原名“地黄酒”	药酒	
苏木酒	药酒	
复方红花药酒	药酒	
岩龙风湿酒	药酒	
小花五味子酒	药酒	
舒筋活血药酒	药酒	
瘀血肿痛―跌打药酒	药酒	
舒筋活血―跌打损伤酒(1)	药酒	
瘀血凝滞―跌打损伤酒(Ⅱ)	药酒	
补肝肾―跌打万应药酒	药酒	
强筋壮骨―跌打损伤药酒	药酒	
冯了性药酒	药酒	
复方芜花根皮酒	药酒	
骨痛药酒	药酒	
追风虎骨酒	药酒	
梅子酒	药酒	
养血愈风酒	药酒	
草乌酒	药酒	
强肾祛湿酒	药酒	
络石藤酒	药酒	
祛风越痹酒	药酒	
蚁酒	药酒	
活血药酒	药酒	
追风活络酒	药酒	
临汝药酒	药酒	
祛风胜湿酒	药酒	
豹骨酒	药酒	
豹骨木瓜酒	药酒	
豹骨药酒	药酒	
豹骨追风药酒	药酒	
丁公藤风湿药酒	药酒	
伤湿止痛药酒	药酒	
十七味药酒	药酒	
大风引酒	药酒	
三乌一枝梅酒	药酒	
风痛药酒	药酒	
风湿药酒	药酒	
风湿关节酒	药酒	
五加祛湿酒	药酒	
木瓜酒速溶剂	药酒	
去痹药酒	药酒	
三蛇地黄酒	药酒	
国公酒	药酒	
史国公酒	药酒	
史国公药酒	药酒	
寻骨风酒	药酒	
夜交藤酒	药酒	
参茸虎骨药酒	药酒	
祛风活血酒	药酒	
复方虎骨酒	药酒	
侧子酒	药酒	
茵芋乌头酒	药酒	
茵芋萆薜酒	药酒	
巨胜生婪酒	药酒	
天雄独活酒	药酒	
四乌一子酒	药酒	
虎骨追风酒	药酒	
鲁公酒	药酒	
石斛杜仲酒	药酒	
金牙侧子酒	药酒	
茄根牛膝浸酒	药酒	
固春偏方药酒	药酒	
虎骨木瓜酒	药酒	
河间防风酒	药酒	
虎胫骨浸酒	药酒	
芍药酒方	药酒	
独活杜仲酒	药酒	
海桐皮枳壳酒	药酒	
牛膝附子酒	药酒	
风痛酒	药酒	
麻仁酒	药酒	
牛膝肉桂酒	药酒	
槐枝酒	药酒	
九味薏仁酒	药酒	
虎骨羚羊酒	药酒	
乌麻人参酒	药酒	
独活金牙酒	药酒	
复方五味子酒	药酒	
萆薛黄芪酒	药酒	
小黄芪酒	药酒	
茵芋细辛酒	药酒	
薏苡仁牛膝浸酒方	药酒	
肝脏风―茵芋薏苡酒	药酒	
补虚排邪―虎骨狗脊酒	药酒	
风痹―地榆酒	药酒	
疼闷顽痹―松叶独活酒	药酒	
挛急疼痛―花蛇酒	药酒	
腰脚筋骨风―虎骨天麻酒	药酒	
风疾―夏英公酒	药酒	
壮筋骨―松根酒	药酒	
治风―白蔹薏苡酒	药酒	
脚膝痿弱―仙人杖浸酒	药酒	
周身麻木―乌膝酒	药酒	
一切风疾―浸虎骨酒	药酒	
治风―海桐皮天麻浸酒	药酒	
诸风―百灵藤酒	药酒	
治风―五粒松叶漫酒	药酒	
八风十二痹―独活石楠酒	药酒	
一切风―天雄肉桂酒	药酒	
风湿―神应酒	药酒	
治风―桑枝柳枝漫酒	药酒	
治风―乌鸡酿酒方	药酒	
风痛―凤仙酒	药酒	
虚劳湿冷―小金牙酒	药酒	
筋骨挛急―茵陈酒	药酒	
行步不正―枸杞菖蒲酒	药酒	
肢体麻木―茵芋狗脊酒	药酒	
风虚―南藤酒	药酒	
疮疡脚气―苍术酒	药酒	
祛风散寒―马钱子酒	药酒	
通经活络―花蛇三七酒	药酒	
卵巢囊肿	其他	中医方剂
淋巴管瘤	其他	中医方剂
喉癌	其他	中医方剂
唇癌	其他	中医方剂
垂体肿瘤	其他	中医方剂
多发性疖肿	其他	中医方剂
新生儿硬皮症	其他	中医方剂
新生儿黄疸	其他	中医方剂
小儿中毒性消化不良	其他	中医方剂
小儿营养性贫血	其他	中医方剂
小儿营养不良	其他	中医方剂
小儿遗尿症	其他	中医方剂
小儿哮喘	其他	中医方剂
小儿消化不良	其他	中医方剂
小儿夏季热	其他	中医方剂
小儿夏季高热	其他	中医方剂
小儿舞蹈病	其他	中医方剂
小儿水痘	其他	中医方剂
小儿肾炎	其他	中医方剂
小儿肾病综合症	其他	中医方剂
小儿疝气	其他	中医方剂
小儿慢性肾炎	其他	中医方剂
小儿口疮	其他	中医方剂
小儿急性黄疸性肝炎	其他	中医方剂
小儿急性黄疸肝炎	其他	中医方剂
小儿蛔虫性肠梗阻	其他	中医方剂
小儿蛔虫病	其他	中医方剂
小儿黄疸性肝炎	其他	中医方剂
小儿感冒	其他	中医方剂
小儿腹泻	其他	中医方剂
小儿肺炎	其他	中医方剂
小儿多涎症	其他	中医方剂
小儿癫痫	其他	中医方剂
小儿喘息性支气管炎	其他	中医方剂
小儿肠炎	其他	中医方剂
脑积水	其他	中医方剂
麻疹合并肺炎	其他	中医方剂
流行性急性腮腺炎	其他	中医方剂
儿童风湿性脑病	其他	中医方剂
胃结石	其他	中医方剂
头颅外伤后遗症	其他	中医方剂
肾结石	其他	中医方剂
乳腺增生	其他	中医方剂
乳腺炎	其他	中医方剂
乳腺小叶增生	其他	中医方剂
乳糜尿	其他	中医方剂
全身淋巴结肿大	其他	中医方剂
尿路结石	其他	中医方剂
男性乳房发育症	其他	中医方剂
泌尿系结石	其他	中医方剂
横窦栓塞	其他	中医方剂
航空性中耳炎	其他	中医方剂
过敏性唇炎	其他	中医方剂
根尖炎	其他	中医方剂
复发性口腔溃疡	其他	中医方剂
多发性麦粒肿	其他	中医方剂
单疱病毒性角膜炎	其他	中医方剂
剥脱性唇炎	其他	中医方剂
病毒性角膜炎	其他	中医方剂
扁桃体炎	其他	中医方剂
中毒性菌痢	其他	中医方剂
植物神经功能紊乱	其他	中医方剂
支气管扩张咯血	其他	中医方剂
早期肝硬化	其他	中医方剂
血小板减少症	其他	中医方剂
血小板减少性紫癜	其他	中医方剂
阴囊湿疹	其他	中医方剂
阴囊皮炎	其他	中医方剂
遗精	其他	中医方剂
阳痿	其他	中医方剂
血精	其他	中医方剂
强中	其他	中医方剂
前列腺增生	其他	中医方剂
前列腺炎	其他	中医方剂
腰肌劳损	其他	中医方剂
腰部扭挫伤	其他	中医方剂
血栓性脉管炎	其他	中医方剂
血栓性静脉炎	其他	中医方剂
胸腹壁血栓性静脉炎	其他	中医方剂
经行发热	其他	中医方剂
经期延长	其他	中医方剂
经期水肿	其他	中医方剂
宫外孕	其他	中医方剂
功能性子宫出血	其他	中医方剂
更年期综合症	其他	中医方剂
倒经	其他	中医方剂
赤白带	其他	中医方剂
产后外感	其他	中医方剂
扁桃体术后疼痛	其他	中医方剂
鼻前庭疖肿	其他	中医方剂
白塞氏综合症	其他	中医方剂
白内障	其他	中医方剂
拔牙后出血	其他	中医方剂
痔疮	其他	中医方剂
粘连性肠梗阻	其他	中医方剂
卡他性结膜炎	其他	中医方剂
角膜溃疡	其他	中医方剂
急性中心性视网膜炎	其他	中医方剂
急性中耳炎	其他	中医方剂
急性咽炎	其他	中医方剂
急性咽喉炎	其他	中医方剂
急性牙槽感染	其他	中医方剂
急性外耳道湿疹	其他	中医方剂
急性色素膜炎	其他	中医方剂
急性流行性出血性结膜炎	其他	中医方剂
急性卡他性中耳炎	其他	中医方剂
急性结膜炎	其他	中医方剂
急性化脓性扁桃体炎	其他	中医方剂
急性喉炎	其他	中医方剂
急性扁桃体炎	其他	中医方剂
化脓性扁桃体炎	其他	中医方剂
化脓性鼻窦炎	其他	中医方剂
红色盲	其他	中医方剂
泡疹性角结膜炎	其他	中医方剂
美尼尔氏综合症	其他	中医方剂
慢性咽喉炎	其他	中医方剂
慢性牙周炎	其他	中医方剂
慢性睑缘结膜炎	其他	中医方剂
慢性单纯性青光眼	其他	中医方剂
慢性唇炎	其他	中医方剂
慢性鼻窦炎	其他	中医方剂
麻痹性斜视	其他	中医方剂
泪囊炎	其他	中医方剂
溃疡性咽峡炎	其他	中医方剂
溃疡性口腔炎	其他	中医方剂
口腔粘膜白斑	其他	中医方剂
口腔溃疡	其他	中医方剂
顽固性口腔溃疡	其他	中医方剂
急性心肌梗塞	其他	中医方剂
急性细菌性痢疾	其他	中医方剂
急性肾炎	其他	中医方剂
急性尿潴留	其他	中医方剂
急性尿路感染	其他	中医方剂
神经官能症	其他	中医方剂
迁延性肝炎	其他	中医方剂
尿潴留	其他	中医方剂
尿毒症	其他	中医方剂
脑溢血	其他	中医方剂
脑血栓	其他	中医方剂
面神经神炎	其他	中医方剂
面神经麻痹	其他	中医方剂
泌尿系感染	其他	中医方剂
树枝状角膜炎	其他	中医方剂
树枝状角膜溃疡	其他	中医方剂
视网膜色素变性	其他	中医方剂
视网膜静脉阻塞	其他	中医方剂
声带息肉	其他	中医方剂
声带结节	其他	中医方剂
声带肥厚	其他	中医方剂
渗出性中耳炎	其他	中医方剂
神经性耳聋	其他	中医方剂
舌体干燥症	其他	中医方剂
闪辉性暗点	其他	中医方剂
腮腺结石并感染	其他	中医方剂
浅层点状角膜	其他	中医方剂
疱疹性结膜炎	其他	中医方剂
肠癌	其他	中医方剂
膀胱癌	其他	中医方剂
中心性视网膜炎	其他	中医方剂
中心性视网膜脉络膜炎	其他	中医方剂
中心性脉络膜视网膜病变	其他	中医方剂
早期视神经萎缩	其他	中医方剂
原发性青光眼	其他	中医方剂
药物性角结膜干燥症	其他	中医方剂
眼损伤后出血	其他	中医方剂
眼球挫伤	其他	中医方剂
眼前房出血	其他	中医方剂
眼睑下垂	其他	中医方剂
眼睑痉挛	其他	中医方剂
咽喉异物鱼鲠	其他	中医方剂
咽喉部神经官能症	其他	中医方剂
牙痛	其他	中医方剂
牙髓炎	其他	中医方剂
牙槽脓肿	其他	中医方剂
萎缩性鼻炎	其他	中医方剂
小儿急性肾炎	其他	中医方剂
血管瘤	其他	中医方剂
胃癌术后发热	其他	中医方剂
舌下囊肿	其他	中医方剂
乳腺癌化疗反应	其他	中医方剂
脑肿瘤	其他	中医方剂
急性乙型黄疸性肝炎	其他	中医方剂
慢性乙型肝炎	其他	中医方剂
慢性心肌梗塞	其他	中医方剂
慢性萎缩性胃炎	其他	中医方剂
慢性浅表性胃炎	其他	中医方剂
慢性迁延性乙型肝炎	其他	中医方剂
心动过速	其他	中医方剂
胃炎	其他	中医方剂
胃溃疡	其他	中医方剂
胃窦炎	其他	中医方剂
萎缩性胃炎	其他	中医方剂
伪膜性肠炎	其他	中医方剂
室性早搏	其他	中医方剂
十二指肠球部溃疡	其他	中医方剂
十二指肠溃疡	其他	中医方剂
失眠	其他	中医方剂
肾病综合症	其他	中医方剂
急性睾丸炎	其他	中医方剂
化脓性睾丸炎	其他	中医方剂
过敏性阴囊水肿	其他	中医方剂
睾丸鞘膜积液	其他	中医方剂
房事腰痛	其他	中医方剂
房事头痛	其他	中医方剂
房事昏厥	其他	中医方剂
中风的中药治疗	其他	中医方剂
治疗流感验方	其他	中医方剂
蛛网膜下腔出血	其他	中医方剂
前列腺肥大	其他	中医方剂
男子性欲减退	其他	中医方剂
男子性欲过亢	其他	中医方剂
男子性交疼痛	其他	中医方剂
男子不育症	其他	中医方剂
慢性前列腺炎	其他	中医方剂
老年性机能低下	其他	中医方剂
急性前列腺炎	其他	中医方剂
结节性红斑	其他	中医方剂
急性荨麻疹	其他	中医方剂
急性淋茵性尿道炎	其他	中医方剂
黑变病	其他	中医方剂
泛发性神经性皮炎	其他	中医方剂
多形性红斑	其他	中医方剂
扁平疣	其他	中医方剂
白发	其他	中医方剂
指甲剥离症	其他	中医方剂
寻常疣	其他	中医方剂
系统性红斑狼疮	其他	中医方剂
顽固性荨麻疹	其他	中医方剂
松皮癣	其他	中医方剂
全身性硬皮病	其他	中医方剂
全身性皮肤角化症	其他	中医方剂
囊肿性痤疮	其他	中医方剂
面部黑色素沉积症	其他	中医方剂
慢性湿疹	其他	中医方剂
慢性荨麻疹	其他	中医方剂
慢性表浅软组织溃疡	其他	中医方剂
淋巴结结核	其他	中医方剂
阑尾周围脓肿	其他	中医方剂
急性血栓性深静脉炎	其他	中医方剂
蛔虫性肠梗阻	其他	中医方剂
化脓性乳腺炎	其他	中医方剂
颌面部急性化脓性淋巴结炎	其他	中医方剂
蜂窝组织炎	其他	中医方剂
多发性细菌性肝脓肿	其他	中医方剂
胆结石	其他	中医方剂
胆道蛔虫并发胰腺炎	其他	中医方剂
自家敏感性皮炎	其他	中医方剂
中毒性红斑	其他	中医方剂
产后头痛	其他	中医方剂
产后缺乳	其他	中医方剂
产后尿潴留	其他	中医方剂
产后惊悸	其他	中医方剂
产后腹痛	其他	中医方剂
产后烦渴	其他	中医方剂
产后发热	其他	中医方剂
不孕症	其他	中医方剂
闭经	其他	中医方剂
白带过多	其他	中医方剂
妊娠外感	其他	中医方剂
妊娠水肿	其他	中医方剂
妊娠呕吐	其他	中医方剂
妊娠痢疾	其他	中医方剂
妊娠咳嗽	其他	中医方剂
妊娠腹胀	其他	中医方剂
妊娠腹泻	其他	中医方剂
妊娠腹痛	其他	中医方剂
妊娠便秘	其他	中医方剂
妊娠鼻出血	其他	中医方剂
盆腔炎	其他	中医方剂
女子性欲亢进	其他	中医方剂
女子性欲低下	其他	中医方剂
女子梦交	其他	中医方剂
慢性盆腔炎	其他	中医方剂
慢性附件炎	其他	中医方剂
绝经过早	其他	中医方剂
经行泄泻	其他	中医方剂
经行身痛	其他	中医方剂
经行呕吐	其他	中医方剂
月经先期	其他	中医方剂
月经后期	其他	中医方剂
月经过少	其他	中医方剂
月经过多	其他	中医方剂
月经不调	其他	中医方剂
阴道炎	其他	中医方剂
阴道松驰	其他	中医方剂
阴道干枯	其他	中医方剂
先兆流产	其他	中医方剂
席汉氏综合症	其他	中医方剂
习惯性流产	其他	中医方剂
外阴萎缩性硬化性苔藓	其他	中医方剂
外阴非典型增生	其他	中医方剂
妊娠遗尿	其他	中医方剂
妊娠腰痛	其他	中医方剂
妊娠眩晕	其他	中医方剂
妊娠心烦	其他	中医方剂
妊娠胃痛	其他	中医方剂
白细胞减少症	其他	中医方剂
阿米巴痢疾	其他	中医方剂
腰椎骨质增生	其他	中医方剂
胸椎骨结核	其他	中医方剂
膝关节滑膜炎	其他	中医方剂
退行性腰椎管狭窄	其他	中医方剂
肋软骨炎	其他	中医方剂
颈椎增生	其他	中医方剂
结核性关节炎	其他	中医方剂
肩关节周围炎	其他	中医方剂
关节囊积水	其他	中医方剂
骨质增生症	其他	中医方剂
骨髓炎	其他	中医方剂
跟骨骨质增生	其他	中医方剂
非化脓性肋软骨炎	其他	中医方剂
陈旧性骨折	其他	中医方剂
髌骨软骨炎	其他	中医方剂
急性黄疸性病毒肝炎	其他	中医方剂
急性传染性黄疸性肝炎	其他	中医方剂
急性病毒性肝炎	其他	中医方剂
冠心病	其他	中医方剂
高血脂症	其他	中医方剂
高血压	其他	中医方剂
感冒	其他	中医方剂
肝硬化腹水	其他	中医方剂
风湿性心脏病	其他	中医方剂
风湿性关节炎	其他	中医方剂
肺气肿	其他	中医方剂
非特异性溃疡性结肠炎	其他	中医方剂
房性早搏	其他	中医方剂
胆囊炎	其他	中医方剂
大叶性肺炎	其他	中医方剂
病态窦房结综合症	其他	中医方剂
病毒性脑炎	其他	中医方剂
慢性结肠炎	其他	中医方剂
慢性活动性肝炎	其他	中医方剂
慢性肝炎	其他	中医方剂
慢性肠炎	其他	中医方剂
慢性病毒性肝炎	其他	中医方剂
流行性脑膜炎	其他	中医方剂
老年结肠功能紊乱	其他	中医方剂
甲状腺机能亢进	其他	中医方剂
急性支气管炎	其他	中医方剂
脚部按摩的几个禁忌	其他	针灸推拿
针灸治愈末梢神经炎	其他	针灸推拿
人体有两个“长寿穴”	其他	针灸推拿
擦胸揉腹增强免疫力	其他	针灸推拿
青春痘自疗按摩法	其他	针灸推拿
中医推拿减肥法	其他	针灸推拿
美容常用取穴	其他	针灸推拿
耳压疗法能减肥	其他	针灸推拿
瑜伽养生的注意事项	其他	针灸推拿
腹部按揉养生一诀	其他	针灸推拿
敲击手三里，防治颈椎病	其他	针灸推拿
搓揉穴位治好我的鼻炎	其他	针灸推拿
针刺治疗乳腺增生	其他	针灸推拿
针灸治疗原发性痛经	其他	针灸推拿
针灸法治疗尿失禁	其他	针灸推拿
针灸治疗偏头痛	其他	针灸推拿
针灸治疗舌炎	其他	针灸推拿
针灸治疗肩关节周围炎	其他	针灸推拿
支气管炎针灸方法	其他	针灸推拿
醒神开窍针法促醒植物人	其他	针灸推拿
针灸治疗前列腺肥大	其他	针灸推拿
针灸巧治面肌痉挛	其他	针灸推拿
透刺法治疗肩峰下滑囊炎	其他	针灸推拿
神经性皮炎针刺疗法	其他	针灸推拿
一针见效─认识针灸	其他	针灸推拿
坐骨神经痛的针灸治疗分析	其他	针灸推拿
中风后吞咽障碍的针刺治疗	其他	针灸推拿
中暑针灸疗法	其他	针灸推拿
针药结合治结石	其他	针灸推拿
急性胃扭转针刺治疗	其他	针灸推拿
针灸减肥怎样才能“灵”	其他	针灸推拿
中医针刺治疗中暑证	其他	针灸推拿
针灸治假球麻痹	其他	针灸推拿
中医：针刺治疗失眠症	其他	针灸推拿
常识：什么是针灸减肥?	其他	针灸推拿
压力大失眠不妨扎针灸	其他	针灸推拿
穴位刺激消除“水肿”与“脂胖”	其他	针灸推拿
四种点穴法让食欲减退	其他	针灸推拿
一捻一揉治风湿	其他	针灸推拿
捏指疗八疾	其他	针灸推拿
常用人体穴位表	其他	针灸推拿
顺时针揉腹治便秘	其他	针灸推拿
脸部苗条的穴位	其他	针灸推拿
鲜为人知的按摩进补	其他	针灸推拿
孕妇按摩甜蜜蜜	其他	针灸推拿
简易有效的推拿治疗旅途失眠	其他	针灸推拿
“四法”康复腰突症	其他	针灸推拿
针灸也要讲究补和泻	其他	针灸推拿
提醒：胡乱按摩易致伤残	其他	针灸推拿
按摩十术保健康	其他	针灸推拿
推拿瘦身适应人群	其他	针灸推拿
耳部按摩助健康	其他	针灸推拿
常揉“四区”利健康	其他	针灸推拿
按摩治疗神经衰弱	其他	针灸推拿
经络是什么？	其他	针灸推拿
耳针疗法简介	其他	针灸推拿
你知道艾灸疗法吗？	其他	针灸推拿
自我按摩治疗便秘	其他	针灸推拿
在钢针丛林里杀戮脂肪	其他	针灸推拿
双手推开心灵的窗户	其他	针灸推拿
按摩祛除双下巴	其他	针灸推拿
按摩肾俞穴保护肾功能	其他	针灸推拿
中医理论:活动脚趾能健胃	其他	针灸推拿
一根银针让瘫痪议员神奇站立	其他	针灸推拿
自我按摩之牙痛篇	其他	针灸推拿
八步按摩来抚平肌肤皱纹	其他	针灸推拿
奇妙针灸治细菌性感染	其他	针灸推拿
“节气灸”防治病有道理吗	其他	针灸推拿
中风患者什么时候开始针灸好	其他	针灸推拿
八面出击应对肩周炎	其他	针灸推拿
推拿手法之垂直运动手法	其他	针灸推拿
小儿保健推拿四法	其他	针灸推拿
学习做自己的推拿师	其他	针灸推拿
面部按摩常用的穴位	其他	针灸推拿
按摩不当易致伤残	其他	针灸推拿
八步按摩抚平肌肤皱纹	其他	针灸推拿
舒缓肌肤6步按摩法	其他	针灸推拿
按摩的一般手法及禁忌	其他	针灸推拿
祛除视疲劳按摩有法	其他	针灸推拿
中风的按摩治疗处方	其他	针灸推拿
中华一绝针灸治病	其他	针灸推拿
按摩手掌肤色更好	其他	针灸推拿
温针灸“解冻”肩周炎	其他	针灸推拿
按摩经穴预防感冒	其他	针灸推拿
天热按揉两穴消除头昏	其他	针灸推拿
针刺的角度方向深度	其他	针灸推拿
按摩赶跑“偏头疼”	其他	针灸推拿
针灸为何能减轻疼痛？	其他	针灸推拿
健肾强身简易按摩法	其他	针灸推拿
警惕随意按摩可致瘫痪	其他	针灸推拿
两穴按揉消除头昏	其他	针灸推拿
老年家庭保健按摩14法	其他	针灸推拿
长寿秘诀二十九种按摩法	其他	针灸推拿
针灸疗法祛除眼袋	其他	针灸推拿
按摩操“拯救”你的睡眠	其他	针灸推拿
经络按摩创造完美臀型	其他	针灸推拿
按摩“十术”保健康	其他	针灸推拿
偏头痛针灸胜药丸	其他	针灸推拿
按摩越痛越有效吗？	其他	针灸推拿
按摩脚心祛病良方	其他	针灸推拿
按捏腋窝延缓衰老	其他	针灸推拿
小儿“食积”推拿疗法	其他	针灸推拿
灸至阴穴可以矫正胎位	其他	针灸推拿
12种经穴按摩葆青春	其他	针灸推拿
针刺时需要注意什么？	其他	针灸推拿
哪些人不宜做按摩	其他	针灸推拿
三种方法巧疗慢性咽炎	其他	针灸推拿
中医的“捏脊”疗法	其他	针灸推拿
按摩“脚心”祛百病	其他	针灸推拿
耳穴给药治疗下肢溃疡	其他	针灸推拿
针灸治疗中风	其他	针灸推拿
针灸治疗便秘	其他	针灸推拿
疾病的针灸治疗感冒	其他	针灸推拿
针灸治疗的配穴方法	其他	针灸推拿
针灸治疗的取穴原则	其他	针灸推拿
针灸治疗落枕	其他	针灸推拿
针灸治疗失眠	其他	针灸推拿
针灸治疗网球肘	其他	针灸推拿
针灸治疗肥胖症	其他	针灸推拿
针灸治疗戒烟	其他	针灸推拿
针灸治疗近视	其他	针灸推拿
针灸治疗牙痛	其他	针灸推拿
针灸治疗胃炎	其他	针灸推拿
刺激“人中穴”有讲究	其他	针灸推拿
夏季针灸减肥最佳时	其他	针灸推拿
按摩消除你的眼睛疲劳	其他	针灸推拿
巧用点穴法缓解“急症”	其他	针灸推拿
小儿扁桃体炎按摩	其他	针灸推拿
疾病的针灸治疗支气管炎	其他	针灸推拿
针灸治疗痛经	其他	针灸推拿
针灸治疗腰痛	其他	针灸推拿
针灸治疗带状疱疹	其他	针灸推拿
针灸治疗偏头痛	其他	针灸推拿
针灸治疗头痛	其他	针灸推拿
针灸治疗坐骨神经痛	其他	针灸推拿
捏拉耳垂眼明神足	其他	针灸推拿
头晕的足部按摩	其他	针灸推拿
防治便秘按摩法	其他	针灸推拿
自我按摩法防治腰椎病	其他	针灸推拿
腹部按揉能保健养生	其他	针灸推拿
中医自我保健十法	其他	针灸推拿
头皮按摩有助健康	其他	针灸推拿
中医耳针戒烟	其他	针灸推拿
常搓脚心防病健身	其他	针灸推拿
太乙神针灸秘传	其他	针灸推拿
针刺绝技“穿胛热”	其他	针灸推拿
穴位疗法治疗手脚发冷	其他	针灸推拿
眼睛的保健按摩	其他	针灸推拿
针灸戒烟难保长效	其他	针灸推拿
按摩鼻子防感冒	其他	针灸推拿
宝宝不消化，试试捏积法	其他	针灸推拿
按摩耳廓好处多	其他	针灸推拿
晚上捶背睡个好觉	其他	针灸推拿
针刺的角度方向深度	其他	针灸推拿
“揉走”落枕的小秘诀	其他	针灸推拿
针灸可提高精子质量	其他	针灸推拿
针灸也能治细菌性感染	其他	针灸推拿
针灸是怎么治夜盲症的	其他	针灸推拿
“揉走”失枕的小偏方	其他	针灸推拿
流脑的针灸疗法	其他	针灸推拿
按摩腹部治愈肠胃病	其他	针灸推拿
推拿按摩治感冒	其他	针灸推拿
按摩椅一次只坐20分钟	其他	针灸推拿
自我按摩防耳聋	其他	针灸推拿
常按揉迎香穴能防感冒	其他	针灸推拿
随意乱用按摩器惹麻烦	其他	针灸推拿
睡前揉揉身体四个部位	其他	针灸推拿
女儿生病成就了我的业余爱好	其他	针灸推拿
耳穴按摩降血压	其他	针灸推拿
耳朵扎针为何可治全身疾病	其他	针灸推拿
针灸：“雷火灸”治眼病	其他	针灸推拿
就这么简单:搓搓手掌防感冒	其他	针灸推拿
常按耳强身健体	其他	针灸推拿
足底按摩≠医疗按摩	其他	针灸推拿
针灸能除术后呃逆	其他	针灸推拿
针灸疗法治疗阳痿	其他	针灸推拿
防治感冒按摩手法	其他	针灸推拿
腹胀？捏捏肩膀做按摩	其他	针灸推拿
秋季脚部按摩“宝典”	其他	针灸推拿
卵巢按摩能延缓衰老吗？	其他	针灸推拿
手上的“疙瘩”静悄悄地去	其他	针灸推拿
按摩美目自有神	其他	针灸推拿
腰背部家庭保健按摩法	其他	针灸推拿
按摩十术养颜补脑强身	其他	针灸推拿
腰酸背痛勿乱“摩”	其他	针灸推拿
刺激耳廓也能减肥	其他	针灸推拿
揉摩耳廓有益身体健康	其他	针灸推拿
针灸的保肾进补方案	其他	针灸推拿
“循经推拿”教你健康减肥	其他	针灸推拿
按摩巧治过敏性鼻炎	其他	针灸推拿
按摩不当适得其反	其他	针灸推拿
调息按摩治便秘	其他	针灸推拿
简便灵验“隔蒜灸”	其他	针灸推拿
摩鼻洗鼻益健康	其他	针灸推拿
保健推拿有待规范	其他	针灸推拿
“揉走”落枕的偏方	其他	针灸推拿
随意按摩可致瘫痪	其他	针灸推拿
久坐伤腰按摩有方	其他	针灸推拿
针灸减肥适合青年女性	其他	针灸推拿
颈痛切莫“端脖子”	其他	针灸推拿
如何调治前列腺病？	其他	针灸推拿
治疗便秘的运动和按摩方法	其他	针灸推拿
推拿也要讲究手法	其他	针灸推拿
咳嗽的针灸疗法	其他	针灸推拿
关节痛，针灸加热敷	其他	针灸推拿
电子按摩器别乱用	其他	针灸推拿
足底按摩缓解颈椎问题	其他	针灸推拿
巧用点穴法让食欲减退	其他	针灸推拿
肩周炎自我锻炼	其他	针灸推拿
按摩不当“很受伤”	其他	针灸推拿
冬季，针灸减肥正当时	其他	针灸推拿
按摩并非越痛越有效	其他	针灸推拿
中医推拿让痛经远离	其他	针灸推拿
腹部按揉养生一法	其他	针灸推拿
针灸美容的分类和原则	其他	针灸推拿
脚底按摩是保健也是治疗	其他	针灸推拿
冬天是否适合针灸减肥？	其他	针灸推拿
按摩脚心祛百病	其他	针灸推拿
“闪腰”简易疗法	其他	针灸推拿
按摩治疗老花眼	其他	针灸推拿
六法按摩“按走”失眠	其他	针灸推拿
“以指代针”治便秘	其他	针灸推拿
推拿治疗便秘	其他	针灸推拿
自我按摩治失眠	其他	针灸推拿
慢性肝炎的自我推拿	其他	针灸推拿
小儿推拿－食积	其他	针灸推拿
推拿对运动器官、皮肤、外科等疾患的作用	其他	针灸推拿
中国大陆目前六大推拿学术流派	其他	针灸推拿
灸法保健	其他	针灸推拿
针灸保健方法	其他	针灸推拿
针灸养生方法谈	其他	针灸推拿
推拿的作用及特点	其他	针灸推拿
常用推拿保健手法	其他	针灸推拿
推拿按摩养生史	其他	针灸推拿
推拿治愈前列腺病	其他	针灸推拿
自我按摩可防治腰肌劳损	其他	针灸推拿
按摩肚子能治便秘	其他	针灸推拿
手法治疗急性腰扭伤	其他	针灸推拿
如何通过按摩壮阳？	其他	针灸推拿
推拿治疗颈椎病	其他	针灸推拿
胃痛自我推拿法	其他	针灸推拿
足底按摩巧治颈椎病	其他	针灸推拿
强化免疫系统的按摩法	其他	针灸推拿
按摩穴位治尿不净	其他	针灸推拿
四季皆宜“搓脸保健法”	其他	针灸推拿
自我按摩治妇科病	其他	针灸推拿
按摩美容法	其他	针灸推拿
按摩脚能美容	其他	针灸推拿
攀足固肾	其他	针灸推拿
消除大脑疲劳的自我按摩	其他	针灸推拿
足部按摩治疗妊娠呕吐	其他	针灸推拿
按摩外敷治骨刺	其他	针灸推拿
抱膝滚动治腰背痛	其他	针灸推拿
慢性肝炎自我推拿	其他	针灸推拿
香油按摩效果佳	其他	针灸推拿
长寿妙招－老年人家庭保健按摩	其他	针灸推拿
搓搓摩摩快快活活	其他	针灸推拿
按摩有助于延缓肌肤老化	其他	针灸推拿
自我按摩防治高血压	其他	针灸推拿
自行按摩治痔疮	其他	针灸推拿
颈椎病的推拿治疗	其他	针灸推拿
哪些情况不能按摩	其他	针灸推拿
浅谈推拿	其他	针灸推拿
伤科专用手法-捶法	其他	针灸推拿
指压落枕手到病除	其他	针灸推拿
小锤敲出健康来	其他	针灸推拿
一指愈疾痛	其他	针灸推拿
中医手浴缓解疲劳	其他	针灸推拿
巧按摩令胸部更丰满	其他	针灸推拿
一日三做耳朵操	其他	针灸推拿
常挠头有助延年益寿	其他	针灸推拿
失眠练练太极拳	其他	针灸推拿
中医按摩治落枕	其他	针灸推拿
按摩防治冠心病	其他	针灸推拿
活动脚趾可健胃	其他	针灸推拿
按摩头皮助血液循环	其他	针灸推拿
祛病强身小诀窍	其他	针灸推拿
针灸应对偏头痛	其他	针灸推拿
耳穴压豆法治颈椎病	其他	针灸推拿
“颜面针灸”瘦脸	其他	针灸推拿
推拿治疗亚健康状态	其他	针灸推拿
女性漏尿的足部按摩法	其他	针灸推拿
腰部按摩保健法	其他	针灸推拿
腹部养生：养出好体魄	其他	针灸推拿
用搓手摩面法改善睡眠	其他	针灸推拿
怎样延缓皱纹出现	其他	针灸推拿
摩足促健康	其他	针灸推拿
慈禧太后与按摩养生	其他	针灸推拿
自我按摩养生功	其他	针灸推拿
尾椎骨整治法	其他	针灸推拿
按摩和养生	其他	针灸推拿
针灸可能会染病	其他	针灸推拿
失眠久不愈耳穴埋小豆	其他	针灸推拿
脊椎疾病逼近办公一族	其他	针灸推拿
刺激手部穴位:抑食欲减肥	其他	针灸推拿
针灸也能进补吗？	其他	针灸推拿
健康者不必“按摩”	其他	针灸推拿
针灸减肥怎样才能灵	其他	针灸推拿
什么是针灸减肥?	其他	针灸推拿
上班族养生功四式	其他	针灸推拿
足部按摩贴心提示	其他	针灸推拿
腿足保健按摩七法	其他	针灸推拿
“节气灸”防病治病效果好	其他	针灸推拿
晨起十分钟保健有奇功	其他	针灸推拿
按摩疗痛经	其他	针灸推拿
百步走不如抖一抖	其他	针灸推拿
针刺时注意事项	其他	针灸推拿
消除疲劳试“捶龙”	其他	针灸推拿
搓耳美容又健康	其他	针灸推拿
眼部防辐射小花招	其他	针灸推拿
压指养生法巧治病	其他	针灸推拿
准妈妈按摩小秘籍	其他	针灸推拿
洗澡顺便治小病	其他	针灸推拿
健鼻养生巧防病	其他	针灸推拿
长假后两招护肠保胃	其他	针灸推拿
大鱼际揉法	其他	针灸推拿
按摩经穴防感冒	其他	针灸推拿
颈肩部按摩塑身法	其他	针灸推拿
神经衰弱治疗操	其他	针灸推拿
旅游徒手治病八法	其他	针灸推拿
头痛患者自我按摩法	其他	针灸推拿
推拿治疗小儿营养不良	其他	针灸推拿
针灸治疗呃逆	其他	针灸推拿
针灸治疗中风	其他	针灸推拿
针灸治疗产褥感染	其他	针灸推拿
针灸治疗头痛	其他	针灸推拿
针灸治疗便秘	其他	针灸推拿
针灸治疗周围性面神经麻痹	其他	针灸推拿
针灸治疗功血	其他	针灸推拿
针灸治疗面瘫	其他	针灸推拿
粉刺的针灸疗法	其他	针灸推拿
荨麻疹的针灸疗法	其他	针灸推拿
前列腺炎的针灸疗法	其他	针灸推拿
痛经的针灸疗法	其他	针灸推拿
哮喘的针灸疗法	其他	针灸推拿
月经不调的针灸疗法	其他	针灸推拿
灸法治疗尿失禁	其他	针灸推拿
针灸治疗腰痛	其他	针灸推拿
针灸治疗坐骨神经痛	其他	针灸推拿
牙痛的针灸治疗	其他	针灸推拿
肠痈的针灸疗法	其他	针灸推拿
疔疮的针灸疗法	其他	针灸推拿
痄腮的针灸治疗	其他	针灸推拿
痔疮的针灸疗法	其他	针灸推拿
放血疗法治荨麻疹	其他	针灸推拿
耳穴疗法预防人工流产综合征	其他	针灸推拿
针灸治疗绝经后骨质疏松症	其他	针灸推拿
针灸去眼袋	其他	针灸推拿
针灸治疗水肿	其他	针灸推拿
便秘的针灸治疗	其他	针灸推拿
针灸治疗泄泻	其他	针灸推拿
针灸治疗咳嗽	其他	针灸推拿
针灸治疗中暑	其他	针灸推拿
针灸治疗感冒	其他	针灸推拿
月经不调自我按摩	其他	针灸推拿
失眠按摩五法	其他	针灸推拿
循径拍打球摩操促进疾病康复	其他	针灸推拿
自我按摩治感冒	其他	针灸推拿
自我按摩止痛经	其他	针灸推拿
电针治疗肿瘤新疗法	其他	针灸推拿
推拿治疗肠痉挛	其他	针灸推拿
刮痧治疗发热	其他	针灸推拿
小儿保健按摩	其他	针灸推拿
慢性咽炎家庭自疗	其他	针灸推拿
推拿治疗肩胛肋骨综合征	其他	针灸推拿
天灸新用	其他	针灸推拿
老年家庭保健按摩	其他	针灸推拿
推拿治疗小儿痱子	其他	针灸推拿
推拿治疗小儿咳嗽	其他	针灸推拿
推拿治疗小儿贫血	其他	针灸推拿
推拿治疗小儿湿疹	其他	针灸推拿
推拿治疗小儿厌食	其他	针灸推拿
失眠久不愈耳穴埋小豆	其他	针灸推拿
针灸体位选择	其他	针灸推拿
针刺的角度、方向、深度	其他	针灸推拿
小小银针减肥膘	其他	针灸推拿
针灸养生	其他	针灸推拿
针灸能治疗近视吗	其他	针灸推拿
暂定的针灸治疗范围	其他	针灸推拿
男性的自我按摩	其他	针灸推拿
腰背部的保健按摩方法	其他	针灸推拿
脸部按摩	其他	针灸推拿
按摩让你夜夜成眠	其他	针灸推拿
奇妙按摩紧致你的胖胖脸	其他	针灸推拿
按摩三步曲告别手脚冰凉	其他	针灸推拿
“六”字按摩降压法	其他	针灸推拿
胡乱按摩易致伤残	其他	针灸推拿
背部与颈部按摩	其他	针灸推拿
头部按摩	其他	针灸推拿
腿与脚部按摩	其他	针灸推拿
按摩脚心能祛百病	其他	针灸推拿
spa按摩穴道及筋骨	其他	针灸推拿
盲人按摩勿成盲区	其他	针灸推拿
常用的推拿按摩保健手法	其他	针灸推拿
保健按摩二十九法	其他	针灸推拿
春来赤脚搓圆木	其他	针灸推拿
每天三分钟搞定健康	其他	针灸推拿
抗感冒――晨起按摩七分钟	其他	针灸推拿
精油按摩	其他	针灸推拿
捏指疗疾法	其他	针灸推拿
足底按摩治疗颈椎病	其他	针灸推拿
神经衰弱的药膳验方	其他	针灸推拿
健身长寿气功按摩十八法	其他	针灸推拿
按摩紧致你的胖胖脸	其他	针灸推拿
刮痧治疗肩周炎	其他	针灸推拿
高血压推拿	其他	针灸推拿
膝关节炎的自我推拿	其他	针灸推拿
按摩治疗前列腺增生	其他	针灸推拿
按摩预防呼吸道感染	其他	针灸推拿
摩擦胸背可增强免疫力	其他	针灸推拿
快速止住小腿抽筋	其他	针灸推拿
简单易行的中医推拿	其他	针灸推拿
外搽药酒六注意	其他	针灸推拿
捏手指健身治病	其他	针灸推拿
痔疮的简易自我疗法	其他	针灸推拿
面部皮肤健美操	其他	针灸推拿
经穴按摩葆青春	其他	针灸推拿
按摩治疗儿童遗尿35例	其他	针灸推拿
早期白内障的按摩保健	其他	针灸推拿
